Serial,Rank,Word,Type,PositiveNum,NegativeNum,TotalNum,PositiveSerial,NegativeSerial
1,3,話,N,66,88,154,5_41_41_227_227_227_235_245_248_255_258_374_436_481_554_563_584_584_584_786_808_811_815_815_823_832_835_857_866_887_889_889_895_897_897_906_917_921_921_923_931_1039_1040_1040_1088_1115_1115_1197_1200_1257_1311_1311_1315_1315_1338_1350_1410_1415_1423_1423_1423_1429_1472_1479_1486_,2084_2085_2089_2099_2124_2162_2194_2299_2302_2360_2360_2361_2361_2384_2424_2445_2446_2452_2454_2455_2523_2549_2549_2550_2550_2554_2555_2561_2562_2590_2604_2606_2609_2611_2615_2671_2672_2680_2714_2731_2769_2770_2794_2796_2836_2838_2851_2861_2867_2899_2967_2999_3019_3019_3032_3033_3037_3049_3055_3058_3072_3085_3105_3135_3193_3193_3196_3196_3223_3225_3232_3232_3244_3253_3289_3290_3306_3306_3313_3422_3433_3433_3435_3435_3445_3458_3460_
1,3,近,Vi,123,70,193,3_5_7_39_89_98_100_101_103_103_118_126_139_171_216_219_231_232_246_256_278_325_330_335_339_340_363_368_386_392_421_471_475_497_500_503_508_508_512_545_547_551_556_560_582_583_587_607_646_649_652_655_666_668_676_677_711_721_783_804_804_815_819_828_831_833_835_846_848_849_871_875_879_883_888_888_896_896_912_913_917_921_924_932_941_958_962_963_964_999_1029_1052_1068_1075_1081_1084_1088_1231_1259_1261_1267_1281_1288_1311_1315_1328_1362_1369_1385_1430_1431_1433_1435_1440_1445_1450_1463_1468_1473_1495_1496_1496_,2005_2061_2112_2112_2153_2161_2161_2162_2169_2211_2232_2268_2274_2283_2324_2326_2384_2409_2410_2450_2453_2483_2484_2484_2498_2498_2522_2525_2610_2648_2651_2654_2656_2689_2700_2701_2713_2717_2720_2725_2746_2759_2797_2807_2812_2813_2829_2873_2898_2949_2969_3001_3011_3012_3012_3041_3118_3148_3149_3159_3159_3422_3437_3479_3480_3480_3481_3482_3482_
1,3,較,ADV,113,107,220,5_22_30_40_45_45_49_50_57_62_77_83_91_104_116_182_192_242_245_245_245_245_252_255_255_255_255_273_276_276_286_286_308_308_308_312_312_312_350_360_413_420_420_494_498_520_529_540_545_553_562_566_575_587_657_661_727_743_744_748_753_768_790_801_801_801_824_847_856_858_865_867_885_893_901_901_920_957_960_983_983_995_996_1005_1020_1020_1023_1023_1059_1059_1063_1071_1078_1088_1104_1183_1189_1220_1222_1231_1290_1292_1293_1293_1327_1345_1345_1436_1481_1481_1488_1488_,2047_2062_2089_2108_2110_2154_2154_2154_2154_2183_2190_2191_2207_2213_2248_2250_2255_2257_2310_2311_2325_2327_2329_2388_2426_2470_2492_2508_2547_2547_2547_2581_2609_2610_2640_2651_2654_2671_2691_2698_2700_2701_2714_2717_2720_2728_2729_2744_2759_2763_2772_2774_2793_2809_2815_2815_2839_2882_2882_2895_2927_2933_2944_2976_2977_2978_3032_3032_3033_3033_3037_3049_3083_3099_3099_3103_3132_3171_3171_3173_3173_3225_3246_3265_3272_3318_3318_3318_3318_3319_3319_3345_3356_3363_3364_3371_3371_3431_3432_3444_3448_3448_3453_3453_3489_3491_
1,3,不,ADV,958,2205,3163,4_4_5_8_8_9_10_11_15_16_16_16_17_23_23_24_31_31_32_35_35_35_36_37_39_41_41_41_41_41_44_44_48_51_51_52_52_52_65_66_67_67_69_72_73_74_74_76_77_77_77_80_81_83_83_83_86_87_91_91_91_99_100_100_101_101_102_103_103_104_108_108_109_112_116_118_119_119_123_126_127_127_131_140_140_142_144_145_145_145_145_146_148_149_149_150_157_159_162_162_162_162_162_162_163_163_163_163_163_167_167_167_167_167_167_168_168_168_168_168_171_172_172_173_173_174_174_176_177_182_182_182_185_186_186_186_192_192_192_195_196_196_196_212_213_213_217_217_217_218_222_223_224_227_227_227_229_231_235_238_238_239_245_245_247_247_249_255_255_257_257_259_261_266_268_272_274_275_275_275_276_278_279_280_281_281_286_287_287_288_288_288_289_290_298_306_308_312_320_320_320_320_322_328_333_335_335_336_338_338_339_340_341_341_341_342_343_344_348_348_352_353_354_363_365_368_370_373_373_379_379_379_380_383_386_387_388_388_391_393_394_395_395_397_397_397_397_401_401_401_407_408_410_411_412_412_413_415_416_416_417_419_422_422_422_422_424_424_424_427_427_428_429_431_433_433_434_439_445_448_449_449_451_451_453_456_457_457_459_459_460_476_477_478_480_481_483_485_486_487_489_492_494_499_501_501_502_505_505_506_507_508_513_517_520_520_522_522_525_529_529_531_531_534_539_540_540_540_543_543_544_544_545_546_546_546_549_551_554_555_555_555_558_560_563_565_566_572_573_573_573_573_574_575_581_584_587_590_592_593_595_599_600_600_600_601_602_604_608_609_609_609_611_611_611_612_615_617_620_620_620_621_624_626_628_629_630_630_630_631_631_635_636_636_636_637_638_638_638_639_640_641_641_641_643_644_644_649_655_657_657_662_662_662_663_666_668_669_669_670_672_674_674_674_675_677_683_684_699_699_699_699_700_701_701_702_703_704_705_706_707_707_708_710_710_711_713_714_714_717_717_718_720_720_721_723_724_724_733_734_736_736_737_742_742_746_747_747_749_749_750_750_750_751_754_759_762_764_766_766_771_775_779_779_780_782_782_782_782_783_784_786_786_786_786_787_787_787_790_794_797_799_800_802_802_803_803_804_804_804_804_805_806_806_808_813_813_814_814_815_815_816_817_817_819_820_820_825_826_826_830_830_831_834_835_838_841_841_842_842_842_842_843_846_847_847_849_850_851_853_854_855_856_856_857_857_857_857_860_862_863_864_865_865_866_866_866_866_869_870_871_872_872_875_876_876_876_876_877_878_879_880_880_883_884_884_884_884_885_885_886_886_886_886_887_887_887_887_887_887_888_889_889_889_890_890_890_890_890_890_891_893_893_894_894_894_894_895_895_895_895_895_895_896_897_897_897_898_898_898_898_898_898_899_901_901_901_902_902_902_902_910_910_910_910_912_912_915_915_917_917_921_921_921_921_921_923_931_934_935_938_940_943_943_943_944_944_950_955_955_958_959_962_963_965_966_967_968_973_976_977_978_978_980_988_988_989_990_990_992_993_993_995_996_997_1001_1006_1007_1007_1007_1007_1010_1011_1015_1016_1019_1019_1019_1020_1020_1021_1021_1021_1022_1024_1029_1031_1031_1033_1033_1034_1036_1042_1053_1054_1054_1056_1056_1057_1057_1057_1057_1057_1059_1060_1061_1062_1068_1071_1072_1072_1073_1073_1073_1073_1075_1078_1079_1079_1080_1080_1080_1080_1081_1082_1084_1086_1087_1088_1088_1088_1088_1088_1088_1090_1091_1091_1096_1100_1101_1106_1107_1112_1114_1120_1124_1124_1124_1127_1127_1129_1131_1131_1131_1134_1134_1135_1136_1138_1139_1139_1141_1141_1141_1142_1143_1143_1143_1144_1148_1149_1151_1154_1155_1156_1158_1161_1162_1168_1175_1181_1181_1181_1187_1187_1187_1197_1200_1201_1201_1203_1204_1204_1204_1204_1211_1212_1212_1213_1216_1217_1217_1217_1218_1219_1220_1221_1222_1223_1225_1233_1235_1236_1236_1236_1259_1261_1266_1266_1266_1266_1266_1266_1278_1279_1281_1285_1286_1288_1290_1294_1295_1298_1299_1303_1304_1304_1306_1307_1307_1311_1311_1311_1315_1315_1315_1317_1319_1319_1319_1319_1320_1322_1324_1324_1324_1324_1325_1326_1326_1328_1328_1329_1331_1332_1332_1334_1337_1338_1338_1339_1348_1348_1350_1352_1353_1356_1356_1356_1361_1361_1361_1366_1371_1374_1378_1383_1383_1384_1386_1386_1389_1394_1403_1409_1421_1423_1425_1428_1428_1428_1430_1436_1436_1437_1437_1450_1451_1453_1455_1455_1458_1463_1465_1468_1469_1470_1472_1472_1472_1473_1473_1473_1474_1495_1495_1498_,2002_2004_2006_2007_2007_2008_2008_2009_2009_2011_2014_2014_2014_2015_2015_2015_2015_2017_2018_2019_2019_2022_2023_2024_2024_2024_2028_2029_2030_2031_2036_2037_2037_2037_2037_2037_2037_2037_2037_2037_2037_2037_2037_2038_2038_2038_2038_2039_2040_2040_2040_2040_2041_2042_2042_2042_2042_2042_2043_2044_2044_2044_2045_2048_2048_2050_2050_2050_2053_2053_2053_2056_2057_2057_2057_2057_2057_2057_2057_2058_2058_2059_2059_2060_2060_2061_2061_2061_2062_2066_2068_2069_2069_2069_2069_2069_2069_2070_2071_2072_2072_2072_2074_2074_2074_2076_2081_2081_2081_2081_2083_2083_2083_2083_2084_2084_2084_2084_2085_2085_2085_2085_2086_2090_2090_2090_2095_2095_2095_2097_2097_2097_2098_2098_2098_2098_2099_2099_2104_2104_2104_2104_2104_2104_2106_2106_2108_2109_2109_2110_2111_2111_2112_2113_2114_2114_2114_2116_2116_2117_2117_2117_2119_2119_2122_2122_2123_2123_2124_2124_2124_2125_2126_2126_2127_2127_2127_2128_2131_2131_2131_2131_2133_2133_2133_2133_2134_2134_2134_2134_2134_2134_2136_2136_2136_2138_2138_2139_2139_2139_2140_2140_2140_2143_2143_2143_2144_2144_2145_2145_2146_2149_2149_2149_2151_2151_2151_2151_2151_2153_2153_2153_2158_2158_2159_2159_2159_2159_2159_2161_2161_2161_2161_2161_2161_2161_2162_2162_2162_2162_2162_2163_2164_2164_2167_2168_2174_2174_2174_2175_2175_2175_2175_2177_2179_2180_2181_2183_2183_2183_2183_2184_2186_2186_2188_2189_2189_2189_2189_2190_2192_2193_2193_2193_2193_2193_2195_2196_2196_2198_2198_2198_2198_2198_2199_2199_2199_2200_2201_2202_2202_2204_2204_2206_2206_2206_2208_2209_2210_2211_2211_2211_2211_2212_2212_2215_2219_2220_2220_2220_2221_2222_2222_2222_2228_2229_2229_2229_2229_2231_2231_2231_2231_2231_2231_2231_2232_2232_2232_2232_2234_2234_2235_2236_2237_2238_2239_2239_2239_2242_2243_2244_2245_2246_2247_2247_2249_2251_2252_2252_2252_2253_2253_2253_2254_2256_2258_2258_2259_2259_2260_2260_2261_2263_2264_2264_2264_2264_2264_2266_2266_2267_2268_2269_2269_2270_2270_2271_2272_2272_2273_2273_2273_2276_2278_2279_2279_2280_2283_2283_2291_2294_2294_2294_2295_2296_2297_2298_2299_2299_2299_2299_2299_2300_2301_2302_2302_2302_2302_2302_2303_2303_2304_2305_2306_2306_2307_2308_2309_2309_2309_2309_2309_2310_2310_2311_2311_2312_2312_2313_2314_2314_2315_2315_2316_2317_2317_2318_2318_2318_2319_2319_2319_2321_2322_2322_2324_2324_2326_2326_2333_2333_2333_2334_2334_2334_2335_2338_2338_2338_2340_2341_2342_2342_2342_2342_2343_2344_2345_2346_2346_2349_2350_2351_2351_2353_2354_2355_2358_2358_2359_2359_2359_2359_2359_2359_2360_2360_2360_2360_2360_2360_2360_2361_2361_2361_2361_2361_2361_2361_2362_2372_2372_2372_2372_2375_2375_2375_2375_2376_2376_2376_2377_2377_2378_2380_2380_2381_2382_2384_2384_2384_2384_2387_2387_2387_2387_2388_2388_2388_2388_2389_2390_2390_2391_2392_2393_2397_2397_2399_2401_2406_2408_2409_2410_2411_2411_2411_2412_2412_2414_2414_2414_2414_2416_2418_2418_2419_2419_2421_2421_2421_2425_2426_2428_2436_2438_2438_2440_2440_2442_2444_2444_2445_2445_2445_2445_2445_2445_2445_2446_2446_2446_2446_2446_2446_2446_2447_2450_2450_2450_2450_2450_2450_2452_2452_2453_2453_2453_2453_2453_2453_2458_2459_2460_2460_2461_2461_2464_2464_2464_2466_2466_2466_2467_2468_2470_2475_2475_2477_2479_2479_2480_2483_2483_2484_2484_2484_2486_2487_2488_2489_2489_2492_2492_2492_2493_2498_2500_2500_2500_2500_2500_2500_2501_2501_2501_2501_2501_2501_2502_2502_2504_2504_2504_2505_2505_2506_2507_2508_2510_2511_2512_2514_2516_2516_2516_2516_2516_2517_2517_2518_2518_2518_2518_2518_2519_2519_2520_2520_2520_2520_2520_2521_2521_2521_2522_2522_2522_2522_2522_2522_2522_2522_2523_2524_2525_2525_2526_2527_2527_2528_2528_2528_2529_2530_2530_2530_2530_2534_2534_2534_2534_2534_2534_2534_2535_2535_2539_2543_2543_2543_2543_2544_2544_2544_2544_2544_2544_2544_2544_2546_2547_2547_2548_2548_2548_2549_2549_2549_2549_2549_2549_2549_2549_2549_2549_2550_2550_2550_2550_2550_2550_2550_2550_2550_2550_2551_2551_2551_2551_2553_2554_2554_2555_2555_2556_2556_2559_2560_2561_2561_2561_2562_2562_2562_2565_2565_2566_2566_2567_2568_2571_2572_2573_2574_2576_2578_2578_2582_2585_2585_2587_2587_2587_2587_2587_2587_2587_2587_2589_2589_2589_2590_2590_2590_2590_2592_2593_2594_2594_2595_2596_2596_2597_2597_2599_2599_2600_2603_2604_2604_2605_2606_2606_2607_2608_2608_2609_2609_2609_2609_2610_2611_2611_2615_2616_2616_2616_2621_2623_2624_2624_2626_2629_2629_2630_2630_2630_2637_2637_2637_2637_2638_2638_2638_2638_2639_2639_2640_2640_2641_2642_2645_2646_2647_2647_2647_2647_2647_2647_2648_2649_2649_2649_2649_2651_2651_2651_2651_2651_2651_2651_2651_2651_2651_2654_2654_2654_2654_2654_2654_2654_2654_2654_2654_2656_2657_2658_2659_2662_2662_2665_2669_2669_2671_2671_2671_2671_2671_2671_2671_2672_2672_2674_2679_2680_2680_2682_2683_2684_2685_2686_2687_2688_2690_2690_2691_2695_2695_2698_2698_2699_2700_2700_2701_2701_2702_2703_2704_2705_2705_2705_2705_2706_2706_2706_2706_2707_2707_2708_2708_2709_2709_2711_2711_2713_2713_2714_2714_2714_2714_2717_2717_2718_2718_2718_2718_2719_2719_2719_2720_2720_2721_2721_2721_2721_2722_2722_2722_2723_2723_2725_2726_2727_2728_2728_2729_2729_2730_2731_2731_2731_2731_2731_2734_2734_2735_2736_2737_2739_2740_2740_2740_2742_2742_2744_2744_2745_2745_2746_2746_2746_2746_2747_2747_2748_2749_2750_2750_2750_2753_2753_2753_2754_2754_2754_2754_2756_2756_2756_2756_2756_2756_2759_2759_2759_2759_2761_2761_2761_2761_2762_2762_2762_2762_2763_2766_2766_2766_2767_2769_2769_2769_2769_2769_2769_2769_2770_2770_2770_2770_2770_2770_2770_2771_2771_2771_2771_2771_2772_2773_2773_2773_2774_2775_2776_2776_2776_2779_2779_2779_2780_2781_2781_2781_2781_2782_2782_2782_2782_2784_2784_2790_2790_2791_2791_2793_2793_2793_2793_2794_2795_2795_2795_2797_2797_2799_2802_2802_2803_2803_2804_2804_2806_2807_2807_2807_2807_2807_2809_2809_2810_2810_2811_2811_2812_2812_2813_2814_2814_2814_2814_2815_2815_2815_2815_2815_2815_2815_2815_2816_2818_2824_2824_2824_2826_2826_2826_2827_2828_2828_2828_2828_2828_2830_2830_2830_2833_2834_2835_2835_2836_2836_2836_2837_2838_2838_2838_2838_2839_2840_2840_2841_2841_2841_2842_2843_2844_2845_2846_2846_2847_2848_2848_2848_2849_2851_2851_2852_2853_2857_2857_2857_2857_2858_2858_2858_2858_2860_2861_2861_2861_2861_2861_2862_2864_2865_2867_2867_2867_2867_2868_2869_2869_2869_2869_2872_2872_2872_2872_2872_2873_2881_2881_2882_2882_2882_2882_2883_2883_2883_2884_2884_2885_2885_2886_2886_2887_2887_2888_2888_2888_2889_2889_2890_2890_2896_2898_2898_2899_2900_2901_2902_2902_2902_2904_2904_2904_2908_2908_2909_2909_2910_2910_2913_2914_2914_2915_2916_2917_2917_2918_2918_2918_2919_2920_2922_2922_2923_2925_2925_2926_2928_2931_2931_2933_2933_2933_2933_2933_2933_2934_2936_2937_2938_2939_2939_2940_2940_2941_2942_2943_2944_2945_2945_2946_2947_2948_2949_2949_2950_2950_2951_2951_2953_2953_2953_2953_2953_2954_2954_2954_2955_2956_2956_2956_2956_2957_2957_2957_2957_2958_2959_2960_2961_2961_2962_2963_2963_2967_2967_2967_2967_2968_2969_2972_2972_2972_2972_2972_2973_2973_2974_2975_2975_2975_2976_2976_2976_2976_2976_2976_2976_2976_2977_2977_2980_2980_2981_2981_2982_2982_2983_2983_2983_2984_2984_2984_2985_2986_2987_2987_2988_2988_2988_2990_2992_2993_2994_2996_2999_3001_3001_3001_3001_3001_3002_3003_3003_3005_3006_3006_3007_3008_3009_3009_3009_3009_3010_3010_3010_3010_3012_3012_3012_3012_3012_3013_3014_3014_3016_3019_3020_3022_3022_3022_3023_3023_3023_3025_3025_3025_3027_3027_3027_3030_3031_3031_3032_3032_3032_3032_3032_3033_3033_3033_3033_3033_3034_3034_3036_3037_3038_3038_3038_3038_3038_3039_3039_3039_3039_3039_3040_3041_3041_3042_3042_3043_3043_3046_3046_3047_3049_3050_3050_3051_3052_3053_3054_3054_3055_3055_3055_3055_3055_3055_3055_3056_3056_3057_3059_3059_3060_3063_3064_3065_3067_3069_3069_3070_3070_3073_3073_3073_3073_3074_3074_3074_3074_3076_3076_3076_3078_3078_3079_3079_3079_3083_3083_3083_3083_3083_3083_3083_3084_3084_3084_3084_3084_3084_3085_3086_3086_3087_3088_3088_3089_3090_3092_3093_3093_3094_3095_3095_3095_3095_3096_3096_3097_3098_3099_3099_3100_3101_3103_3103_3103_3103_3103_3103_3104_3104_3105_3105_3105_3106_3107_3107_3107_3107_3108_3108_3109_3109_3110_3110_3110_3110_3110_3110_3110_3110_3111_3111_3112_3112_3112_3114_3115_3115_3115_3115_3117_3117_3118_3118_3118_3118_3119_3119_3119_3119_3119_3119_3120_3121_3124_3124_3124_3124_3124_3124_3125_3126_3129_3129_3130_3130_3132_3132_3132_3132_3133_3133_3133_3134_3135_3137_3138_3139_3139_3139_3140_3141_3145_3146_3146_3146_3146_3146_3149_3149_3149_3150_3150_3151_3152_3152_3153_3153_3153_3154_3155_3158_3158_3158_3158_3159_3159_3159_3159_3159_3159_3160_3161_3161_3161_3161_3161_3161_3162_3163_3163_3163_3163_3163_3164_3165_3166_3166_3168_3169_3170_3170_3172_3172_3174_3175_3175_3176_3176_3177_3178_3179_3180_3184_3184_3184_3184_3185_3186_3186_3186_3187_3187_3187_3187_3187_3188_3188_3188_3189_3189_3189_3189_3189_3192_3192_3193_3194_3194_3194_3194_3195_3195_3195_3196_3196_3196_3197_3197_3199_3199_3201_3202_3202_3202_3204_3204_3205_3205_3205_3205_3205_3206_3207_3207_3207_3210_3210_3210_3210_3211_3213_3213_3213_3215_3215_3215_3215_3216_3218_3218_3218_3223_3223_3225_3225_3227_3227_3227_3228_3229_3231_3231_3231_3231_3231_3231_3232_3232_3232_3232_3232_3232_3233_3233_3234_3236_3238_3239_3239_3240_3242_3242_3243_3243_3243_3243_3244_3244_3245_3246_3246_3246_3246_3246_3246_3246_3247_3247_3249_3249_3252_3253_3253_3253_3253_3253_3253_3253_3254_3254_3254_3254_3255_3255_3255_3255_3256_3256_3256_3256_3257_3259_3260_3262_3263_3264_3265_3266_3267_3267_3267_3267_3268_3270_3272_3272_3273_3274_3274_3274_3278_3279_3281_3281_3281_3281_3282_3282_3282_3282_3283_3286_3287_3288_3288_3289_3289_3289_3289_3289_3289_3289_3289_3289_3289_3289_3289_3290_3290_3290_3290_3290_3290_3290_3290_3290_3290_3290_3290_3291_3292_3293_3294_3294_3295_3295_3295_3297_3298_3301_3304_3304_3306_3306_3306_3307_3307_3308_3308_3308_3308_3308_3310_3312_3313_3315_3315_3318_3319_3319_3319_3321_3322_3324_3324_3326_3327_3329_3329_3330_3330_3331_3331_3331_3331_3331_3331_3331_3331_3331_3332_3332_3333_3333_3333_3333_3333_3334_3337_3339_3340_3341_3341_3341_3341_3341_3342_3345_3345_3347_3347_3347_3347_3351_3351_3352_3352_3353_3354_3354_3355_3356_3358_3358_3360_3360_3360_3360_3363_3363_3363_3363_3363_3364_3364_3364_3364_3366_3367_3367_3368_3368_3371_3372_3373_3373_3373_3373_3374_3374_3374_3374_3376_3376_3376_3378_3378_3378_3379_3380_3380_3380_3382_3383_3384_3385_3385_3385_3385_3386_3386_3387_3388_3388_3389_3389_3389_3390_3390_3390_3391_3391_3393_3393_3397_3397_3397_3397_3400_3401_3401_3405_3409_3409_3410_3412_3412_3413_3415_3416_3417_3417_3417_3418_3418_3418_3418_3418_3418_3419_3419_3420_3421_3422_3425_3429_3430_3430_3431_3431_3431_3431_3431_3431_3431_3431_3431_3432_3432_3432_3432_3432_3432_3432_3432_3432_3433_3433_3433_3433_3433_3433_3433_3433_3435_3435_3435_3435_3435_3435_3435_3435_3437_3437_3440_3442_3443_3443_3443_3443_3443_3444_3445_3445_3445_3446_3448_3448_3448_3448_3450_3451_3452_3453_3453_3453_3453_3455_3456_3457_3458_3458_3458_3459_3460_3463_3463_3463_3463_3464_3465_3466_3466_3466_3467_3467_3468_3468_3470_3470_3470_3470_3471_3471_3471_3471_3472_3472_3473_3475_3475_3475_3475_3477_3477_3477_3479_3479_3480_3480_3480_3481_3481_3482_3482_3482_3483_3485_3487_3487_3487_3489_3489_3489_3489_3491_3491_3491_3491_3492_3492_3493_3494_3495_3496_3497_3498_3498_3500_3500_
1,3,建議,N,84,160,244,4_5_8_48_91_113_113_186_186_196_196_201_207_239_239_248_249_249_258_281_288_290_320_320_338_342_352_376_388_395_408_434_435_435_437_451_459_477_486_503_515_540_540_546_555_582_583_600_609_610_619_670_684_711_711_721_721_729_756_758_795_798_857_866_902_960_966_1054_1054_1091_1215_1239_1249_1250_1319_1319_1319_1324_1324_1324_1371_1476_1483_,2024_2033_2035_2037_2061_2062_2063_2074_2095_2097_2108_2109_2124_2127_2131_2133_2136_2140_2161_2180_2193_2232_2237_2238_2241_2246_2249_2251_2260_2273_2273_2295_2305_2308_2323_2324_2345_2350_2363_2382_2384_2384_2388_2398_2403_2450_2453_2492_2492_2508_2517_2517_2519_2519_2522_2527_2549_2550_2593_2594_2611_2631_2672_2679_2733_2737_2746_2753_2791_2812_2813_2817_2819_2831_2832_2842_2843_2844_2883_2885_2887_2908_2922_2926_2941_2949_2958_2973_2987_2996_3004_3009_3010_3011_3013_3034_3037_3059_3065_3067_3069_3070_3071_3074_3083_3123_3136_3159_3160_3163_3184_3187_3189_3193_3194_3203_3204_3205_3232_3244_3265_3267_3272_3276_3289_3290_3294_3296_3307_3313_3326_3327_3329_3340_3341_3345_3345_3347_3347_3353_3353_3353_3353_3355_3355_3355_3355_3361_3362_3386_3387_3389_3390_3419_3448_3453_3470_3488_3490_
1,3,路線,N,2,1,3,5_,
1,3,公路,N,2,2,4,5_,3012_
1,3,對,Vi,4,12,16,5_740_808_,2258_2259_2333_2334_2354_2355_2475_2544_2976_3383_3384_
1,3,公交,N,17,1,18,5_50_103_103_520_528_529_537_787_787_814_814_820_962_1054_1054_,
1,3,是,Vt,1754,2784,4538,4_5_8_10_12_13_14_14_15_16_16_16_17_23_23_31_31_35_35_37_37_37_40_40_41_41_41_41_42_42_43_43_44_44_45_50_51_51_51_52_52_52_53_58_64_64_64_66_67_68_68_69_69_69_71_71_71_73_74_75_75_76_76_76_77_78_79_80_80_81_83_84_85_86_86_87_89_89_89_91_91_91_91_93_94_94_94_99_103_103_103_103_104_104_106_107_108_108_108_109_109_111_113_113_114_114_115_115_116_118_118_119_119_119_119_121_121_122_122_122_123_126_126_127_127_127_127_129_129_130_130_130_131_133_133_133_137_138_139_140_140_140_141_142_142_142_142_144_145_145_149_149_149_150_150_152_154_155_155_155_155_156_157_158_158_158_158_159_162_162_162_162_162_163_163_163_163_163_164_165_165_165_165_167_167_167_167_167_168_168_168_168_168_169_170_170_170_170_172_173_174_175_175_175_175_176_176_179_182_183_183_183_184_184_184_184_184_186_186_186_186_186_186_186_189_192_193_193_193_194_194_194_194_194_196_196_196_196_196_196_196_199_204_204_205_210_210_211_212_213_213_213_214_214_216_217_217_218_218_219_219_223_225_226_227_227_227_228_228_228_228_228_229_229_229_229_229_230_231_231_231_239_239_239_239_241_241_241_242_242_242_242_244_245_245_247_249_249_249_249_251_251_251_252_252_252_252_253_254_255_255_257_260_260_262_262_267_268_268_269_270_271_272_272_272_272_273_273_274_276_276_278_278_279_279_279_279_279_279_280_281_281_281_281_281_283_283_287_287_287_288_288_288_288_289_290_290_291_294_295_297_298_298_298_299_302_303_305_306_306_306_308_310_312_314_316_316_316_316_320_320_320_321_322_322_326_327_328_331_332_333_334_334_334_335_337_339_339_340_341_342_345_346_349_351_351_352_355_356_359_361_361_364_364_364_365_366_369_369_369_370_371_373_373_374_378_378_379_379_379_379_380_380_381_381_383_383_384_384_386_388_388_389_391_392_393_395_395_396_397_397_397_398_401_402_405_406_407_407_407_407_408_408_409_410_410_411_411_412_414_418_419_419_422_422_422_423_424_424_424_427_429_429_431_433_434_434_434_434_434_435_437_439_445_445_448_451_453_453_456_459_460_462_465_465_470_471_474_475_477_478_478_480_481_481_481_481_481_482_486_487_487_489_491_494_494_497_499_500_501_504_504_505_505_505_506_507_508_509_511_517_517_518_520_521_521_521_522_522_522_522_524_524_526_529_530_530_530_531_531_531_531_533_533_535_540_544_544_546_546_546_546_546_546_546_546_550_551_554_554_555_555_555_555_555_555_555_555_559_560_563_563_566_569_570_572_573_573_575_578_579_581_584_584_590_592_594_595_595_597_599_599_601_603_604_604_608_608_610_610_610_611_611_611_612_616_618_618_619_619_619_620_620_620_621_625_627_627_628_628_628_629_630_630_630_630_630_630_630_630_630_630_630_630_631_632_635_636_636_636_637_638_638_638_639_641_641_643_644_649_649_655_655_657_658_658_662_663_663_663_663_663_666_668_668_669_669_670_670_670_670_670_670_670_670_672_672_672_674_674_674_674_674_674_674_678_687_687_687_692_692_692_698_699_699_699_699_699_700_700_701_702_702_703_704_705_706_707_707_707_707_707_708_708_709_709_709_709_710_710_710_710_710_710_710_710_710_710_710_710_710_711_711_711_711_711_711_713_713_714_714_715_716_716_717_717_717_717_717_718_718_719_719_719_719_720_720_720_720_720_720_720_720_720_720_720_720_720_721_721_721_721_721_721_723_723_724_724_725_726_726_734_735_736_736_738_738_738_738_738_739_740_745_745_745_745_745_746_747_747_747_749_751_754_755_755_756_756_757_757_758_758_761_761_762_762_764_765_766_768_768_771_771_772_773_775_775_776_777_779_780_783_783_783_783_784_784_784_785_786_787_787_787_788_788_788_788_790_793_793_794_794_794_795_796_796_797_797_797_798_799_800_802_802_803_804_804_805_806_808_809_809_811_811_811_812_812_814_814_814_814_814_814_815_815_815_815_815_815_816_816_816_817_817_817_818_819_819_820_820_820_821_821_822_822_822_822_823_825_825_825_826_828_830_830_832_832_832_832_834_835_835_835_835_835_835_835_837_837_837_841_841_842_842_842_842_842_843_843_843_844_844_845_845_846_846_846_847_847_852_853_855_856_856_856_856_856_857_857_857_857_857_861_862_864_865_865_865_865_865_866_866_866_866_866_869_869_869_870_870_871_871_872_872_873_876_876_876_877_877_877_878_878_879_879_880_880_881_884_884_884_885_885_885_885_885_885_885_885_885_885_885_886_886_886_886_887_887_887_887_887_887_887_887_887_887_887_887_887_888_888_889_889_889_889_889_889_890_890_890_891_892_893_893_893_893_893_893_893_893_893_893_893_894_894_894_894_895_895_895_895_895_895_895_895_895_895_895_895_895_896_896_897_897_897_897_897_897_898_898_898_899_900_901_901_901_902_902_902_905_906_906_907_907_910_910_910_910_910_910_910_910_910_910_910_912_914_914_915_916_917_917_917_921_921_921_921_921_923_923_923_924_924_924_924_925_928_929_931_931_931_932_932_932_932_933_934_935_935_935_935_935_936_937_939_940_941_942_944_944_944_944_946_947_949_949_950_950_951_951_956_956_957_959_960_962_962_962_963_964_964_964_966_970_973_973_974_974_976_977_978_980_981_981_981_983_983_985_985_986_988_988_989_989_989_990_990_990_991_992_992_992_993_993_993_994_998_1003_1004_1005_1005_1005_1005_1005_1006_1006_1006_1007_1007_1007_1007_1007_1007_1007_1007_1009_1009_1010_1011_1015_1017_1019_1019_1020_1020_1020_1020_1020_1020_1021_1021_1022_1025_1025_1026_1026_1026_1029_1029_1030_1031_1031_1032_1032_1033_1038_1038_1039_1040_1043_1048_1049_1049_1051_1054_1054_1054_1054_1057_1057_1057_1057_1059_1060_1060_1061_1062_1062_1063_1063_1063_1064_1066_1066_1067_1069_1069_1070_1073_1073_1073_1074_1076_1076_1077_1080_1080_1080_1081_1081_1081_1081_1081_1082_1082_1083_1087_1087_1087_1088_1088_1088_1088_1088_1088_1088_1089_1089_1089_1090_1090_1091_1091_1091_1091_1092_1092_1095_1095_1097_1098_1101_1101_1102_1105_1105_1105_1106_1106_1106_1108_1112_1112_1113_1114_1114_1115_1115_1116_1120_1120_1121_1124_1124_1124_1124_1124_1124_1125_1127_1129_1129_1131_1131_1131_1131_1131_1131_1132_1134_1135_1135_1136_1136_1139_1139_1140_1141_1141_1141_1141_1141_1141_1141_1143_1143_1143_1143_1143_1143_1143_1145_1145_1149_1149_1150_1151_1153_1154_1154_1156_1156_1157_1158_1160_1161_1161_1164_1164_1166_1166_1168_1168_1169_1169_1171_1172_1175_1175_1176_1176_1178_1179_1181_1187_1194_1195_1195_1195_1195_1198_1198_1198_1198_1199_1204_1204_1205_1209_1211_1211_1211_1211_1211_1212_1213_1213_1217_1217_1218_1218_1219_1220_1220_1221_1222_1222_1228_1228_1230_1230_1235_1236_1237_1238_1239_1239_1239_1242_1243_1243_1243_1246_1247_1247_1247_1249_1250_1250_1250_1251_1252_1256_1257_1257_1258_1258_1261_1264_1266_1266_1266_1267_1270_1270_1272_1272_1273_1273_1275_1275_1277_1281_1281_1282_1284_1288_1288_1289_1290_1293_1294_1296_1296_1298_1300_1300_1303_1303_1304_1304_1306_1306_1307_1307_1309_1309_1310_1311_1311_1313_1313_1314_1315_1315_1316_1316_1317_1317_1317_1319_1319_1319_1319_1320_1320_1321_1321_1322_1322_1322_1324_1324_1324_1324_1325_1325_1326_1326_1326_1326_1326_1328_1328_1328_1328_1328_1328_1328_1332_1332_1333_1335_1337_1337_1338_1338_1340_1341_1343_1343_1343_1348_1350_1350_1352_1352_1352_1352_1352_1356_1359_1359_1359_1361_1364_1364_1364_1366_1367_1371_1371_1371_1371_1374_1375_1378_1378_1383_1383_1386_1386_1393_1394_1397_1398_1399_1399_1402_1403_1406_1407_1408_1410_1413_1415_1418_1418_1419_1421_1423_1423_1423_1423_1423_1423_1425_1425_1425_1425_1425_1425_1426_1427_1427_1428_1428_1429_1429_1429_1429_1429_1430_1430_1431_1431_1433_1433_1433_1435_1435_1435_1436_1437_1437_1437_1437_1437_1439_1441_1442_1444_1446_1447_1451_1451_1453_1455_1455_1455_1456_1457_1459_1459_1459_1464_1464_1464_1465_1469_1470_1471_1471_1472_1472_1472_1472_1472_1473_1473_1476_1478_1478_1481_1481_1481_1481_1483_1485_1485_1488_1488_1488_1488_1491_1491_1491_1494_1494_1494_1495_1495_1495_1496_1497_1497_1497_1498_1498_1499_1499_1500_1500_,2006_2007_2008_2009_2009_2009_2011_2012_2012_2012_2012_2012_2012_2012_2012_2014_2014_2014_2015_2015_2015_2015_2015_2015_2015_2016_2016_2017_2019_2019_2020_2020_2020_2020_2022_2023_2023_2023_2024_2027_2027_2029_2036_2036_2036_2036_2037_2037_2037_2037_2037_2037_2037_2037_2037_2037_2037_2037_2037_2037_2037_2037_2037_2037_2037_2037_2037_2037_2037_2037_2038_2038_2038_2038_2038_2038_2038_2038_2038_2039_2039_2039_2039_2039_2039_2040_2040_2040_2040_2040_2040_2040_2040_2040_2041_2041_2041_2041_2041_2041_2042_2042_2042_2042_2042_2043_2043_2043_2044_2044_2045_2045_2045_2047_2047_2048_2048_2048_2048_2050_2050_2050_2051_2051_2053_2053_2053_2054_2054_2055_2055_2055_2057_2057_2057_2057_2057_2058_2058_2058_2058_2058_2059_2059_2060_2060_2060_2061_2063_2069_2069_2069_2070_2070_2070_2070_2070_2070_2070_2071_2072_2072_2074_2074_2074_2074_2075_2077_2077_2077_2081_2081_2081_2081_2081_2081_2081_2083_2083_2083_2083_2083_2083_2083_2084_2084_2085_2085_2086_2086_2088_2089_2089_2089_2089_2090_2090_2090_2090_2095_2095_2095_2095_2097_2097_2097_2097_2098_2099_2099_2099_2099_2099_2101_2101_2102_2102_2103_2104_2104_2104_2104_2104_2105_2105_2106_2106_2106_2106_2107_2108_2111_2111_2112_2112_2113_2114_2116_2117_2119_2123_2124_2124_2125_2125_2126_2126_2126_2127_2127_2131_2133_2134_2134_2134_2135_2135_2135_2135_2136_2136_2137_2137_2137_2139_2139_2139_2140_2140_2141_2141_2141_2143_2143_2143_2144_2145_2146_2146_2149_2149_2151_2151_2151_2151_2154_2154_2155_2158_2158_2159_2159_2159_2159_2161_2161_2161_2161_2161_2161_2161_2162_2162_2162_2162_2162_2162_2162_2162_2162_2162_2162_2162_2162_2163_2163_2163_2164_2166_2166_2166_2167_2171_2175_2175_2175_2177_2177_2180_2181_2183_2183_2184_2184_2186_2188_2189_2189_2189_2189_2190_2192_2192_2193_2193_2193_2193_2194_2194_2195_2195_2195_2196_2198_2198_2198_2198_2198_2204_2204_2204_2204_2205_2205_2205_2206_2206_2206_2207_2207_2207_2209_2209_2210_2210_2211_2211_2211_2211_2219_2220_2220_2221_2222_2222_2223_2225_2225_2225_2225_2226_2226_2226_2226_2228_2228_2229_2229_2229_2231_2231_2231_2231_2231_2232_2232_2232_2232_2232_2232_2232_2232_2232_2232_2232_2232_2233_2233_2233_2235_2235_2236_2236_2237_2237_2238_2238_2239_2239_2240_2242_2244_2245_2246_2246_2246_2247_2247_2247_2249_2249_2251_2251_2252_2252_2252_2252_2253_2253_2253_2253_2258_2258_2258_2258_2258_2258_2258_2259_2259_2259_2259_2259_2259_2259_2260_2260_2260_2261_2261_2263_2263_2264_2264_2264_2264_2264_2264_2264_2264_2265_2266_2266_2266_2267_2269_2269_2269_2271_2272_2272_2273_2274_2274_2276_2276_2277_2277_2280_2283_2283_2283_2283_2284_2284_2286_2287_2287_2288_2288_2289_2289_2289_2290_2290_2290_2291_2291_2291_2294_2295_2295_2295_2295_2295_2295_2295_2297_2297_2298_2298_2298_2298_2298_2299_2299_2299_2299_2299_2299_2299_2300_2300_2301_2301_2301_2301_2301_2302_2302_2302_2302_2302_2302_2302_2303_2305_2305_2305_2305_2306_2308_2308_2308_2308_2309_2309_2309_2309_2309_2309_2309_2309_2309_2310_2311_2312_2312_2312_2313_2313_2313_2313_2313_2314_2314_2314_2314_2315_2315_2315_2316_2316_2316_2316_2316_2317_2317_2317_2317_2318_2318_2319_2319_2320_2320_2320_2322_2322_2322_2322_2322_2322_2322_2324_2326_2326_2328_2328_2330_2330_2333_2333_2334_2334_2335_2335_2335_2335_2337_2338_2338_2338_2339_2339_2340_2340_2341_2341_2342_2342_2342_2342_2342_2342_2344_2344_2344_2344_2344_2344_2345_2345_2349_2349_2349_2349_2349_2349_2350_2350_2353_2353_2353_2354_2355_2359_2360_2360_2360_2360_2360_2360_2360_2360_2360_2360_2360_2360_2360_2360_2360_2360_2361_2361_2361_2361_2361_2361_2361_2361_2361_2361_2361_2361_2361_2361_2361_2361_2362_2363_2364_2365_2367_2370_2371_2372_2372_2372_2372_2372_2372_2372_2373_2374_2375_2375_2375_2375_2375_2375_2375_2376_2377_2378_2380_2380_2381_2381_2381_2382_2382_2382_2383_2383_2384_2385_2386_2386_2386_2387_2388_2389_2390_2390_2391_2391_2391_2391_2391_2391_2392_2393_2394_2398_2400_2400_2402_2402_2403_2404_2409_2410_2411_2412_2412_2412_2412_2414_2414_2414_2416_2416_2416_2416_2416_2417_2418_2418_2419_2421_2421_2421_2421_2425_2425_2425_2426_2428_2428_2428_2432_2434_2434_2434_2434_2434_2435_2436_2436_2438_2438_2440_2440_2444_2445_2445_2445_2445_2445_2445_2446_2446_2446_2446_2446_2446_2450_2450_2450_2450_2450_2450_2450_2450_2452_2452_2453_2453_2453_2453_2453_2453_2453_2453_2454_2454_2454_2454_2454_2455_2455_2455_2455_2455_2457_2457_2457_2460_2460_2461_2461_2463_2464_2465_2466_2475_2476_2479_2483_2483_2483_2483_2486_2487_2488_2490_2492_2492_2492_2492_2494_2494_2494_2494_2494_2495_2495_2495_2495_2495_2497_2497_2498_2498_2498_2500_2500_2501_2501_2502_2502_2502_2502_2503_2504_2504_2504_2504_2505_2505_2508_2509_2509_2509_2509_2510_2510_2510_2511_2511_2511_2512_2514_2515_2515_2516_2516_2516_2516_2516_2516_2516_2517_2517_2517_2517_2517_2517_2517_2517_2518_2518_2518_2518_2518_2518_2518_2519_2519_2519_2519_2519_2519_2519_2519_2521_2521_2521_2521_2521_2521_2522_2522_2522_2523_2524_2525_2526_2526_2527_2527_2527_2528_2528_2528_2528_2530_2530_2530_2530_2531_2531_2531_2532_2532_2532_2533_2533_2533_2534_2534_2534_2534_2534_2534_2534_2535_2537_2538_2541_2541_2543_2543_2543_2544_2544_2544_2547_2548_2549_2549_2549_2549_2549_2549_2549_2550_2550_2550_2550_2550_2550_2550_2551_2552_2552_2553_2553_2553_2554_2554_2554_2555_2555_2555_2556_2556_2559_2560_2560_2561_2561_2562_2562_2564_2564_2564_2565_2565_2565_2565_2565_2565_2565_2566_2567_2569_2572_2572_2572_2572_2573_2573_2573_2573_2573_2574_2574_2576_2576_2579_2579_2579_2579_2579_2582_2582_2582_2582_2584_2584_2584_2585_2585_2585_2587_2587_2587_2587_2589_2590_2590_2592_2594_2594_2595_2596_2596_2596_2596_2596_2596_2596_2596_2597_2597_2597_2597_2597_2597_2597_2597_2598_2600_2601_2601_2601_2601_2603_2604_2604_2604_2604_2605_2606_2606_2606_2606_2607_2607_2608_2608_2608_2609_2609_2609_2609_2609_2609_2609_2609_2609_2609_2609_2611_2611_2613_2615_2615_2615_2616_2619_2620_2621_2625_2625_2625_2626_2626_2627_2631_2631_2631_2636_2636_2636_2637_2637_2637_2637_2637_2637_2637_2637_2638_2638_2638_2638_2638_2638_2638_2638_2641_2642_2645_2646_2647_2647_2647_2647_2649_2649_2649_2649_2649_2651_2651_2651_2651_2651_2651_2654_2654_2654_2654_2654_2654_2657_2658_2659_2662_2662_2662_2662_2662_2662_2669_2669_2670_2671_2671_2671_2671_2671_2671_2671_2671_2671_2671_2671_2671_2671_2671_2671_2671_2674_2674_2678_2680_2680_2684_2687_2688_2688_2689_2690_2690_2690_2695_2695_2698_2698_2698_2698_2700_2700_2700_2700_2700_2701_2701_2701_2701_2701_2702_2702_2703_2703_2703_2703_2703_2707_2707_2707_2707_2708_2708_2708_2708_2709_2710_2711_2712_2714_2714_2714_2714_2714_2715_2716_2717_2717_2717_2718_2720_2720_2720_2721_2723_2725_2730_2730_2730_2731_2731_2731_2731_2731_2731_2731_2731_2731_2731_2731_2731_2732_2739_2739_2739_2739_2739_2739_2740_2740_2740_2740_2741_2742_2742_2744_2744_2745_2745_2746_2746_2746_2746_2746_2746_2746_2746_2746_2748_2748_2748_2748_2748_2750_2750_2750_2750_2750_2750_2752_2753_2753_2753_2753_2754_2754_2754_2754_2754_2754_2754_2754_2756_2756_2756_2757_2758_2759_2759_2760_2760_2761_2761_2761_2761_2761_2761_2761_2761_2762_2762_2762_2762_2762_2762_2762_2762_2767_2767_2767_2767_2767_2767_2767_2768_2768_2769_2769_2769_2769_2769_2770_2770_2770_2770_2770_2771_2771_2772_2773_2773_2773_2773_2774_2775_2775_2775_2775_2776_2776_2776_2776_2777_2779_2779_2779_2780_2781_2782_2782_2782_2786_2787_2787_2788_2789_2789_2790_2790_2790_2790_2790_2791_2791_2791_2793_2793_2793_2794_2794_2797_2798_2798_2798_2798_2800_2800_2800_2800_2802_2803_2803_2803_2803_2803_2804_2804_2806_2806_2807_2807_2807_2807_2809_2810_2811_2815_2815_2815_2815_2815_2815_2815_2815_2815_2815_2816_2816_2816_2816_2817_2817_2818_2818_2818_2818_2819_2819_2822_2822_2824_2824_2824_2824_2824_2824_2824_2824_2824_2824_2824_2824_2826_2826_2826_2826_2826_2826_2826_2826_2826_2826_2826_2826_2828_2828_2828_2828_2828_2829_2829_2830_2834_2834_2834_2836_2836_2836_2836_2836_2837_2837_2838_2838_2839_2841_2841_2841_2841_2841_2844_2844_2846_2846_2846_2846_2846_2846_2846_2846_2846_2846_2847_2847_2847_2847_2847_2851_2851_2852_2854_2854_2854_2854_2854_2857_2857_2857_2858_2858_2858_2860_2861_2861_2861_2861_2861_2861_2861_2862_2863_2863_2864_2864_2864_2865_2866_2866_2867_2867_2869_2869_2869_2869_2871_2871_2871_2871_2872_2872_2872_2872_2872_2872_2872_2872_2872_2873_2879_2879_2880_2880_2881_2881_2881_2881_2882_2882_2883_2883_2883_2883_2883_2889_2889_2889_2890_2890_2890_2892_2893_2897_2898_2898_2899_2902_2903_2903_2904_2905_2905_2906_2907_2907_2907_2908_2908_2909_2910_2914_2914_2914_2914_2915_2915_2916_2916_2917_2917_2917_2917_2918_2921_2922_2922_2922_2923_2923_2924_2925_2925_2925_2929_2930_2930_2933_2933_2933_2934_2934_2938_2939_2940_2941_2944_2945_2945_2945_2945_2945_2945_2945_2945_2946_2946_2946_2946_2946_2946_2949_2951_2953_2953_2953_2953_2954_2954_2956_2956_2956_2957_2957_2957_2958_2958_2958_2958_2959_2959_2959_2959_2959_2961_2963_2964_2964_2965_2966_2967_2967_2967_2967_2967_2968_2969_2969_2969_2972_2972_2972_2972_2972_2972_2972_2972_2972_2972_2972_2972_2972_2974_2975_2975_2975_2975_2976_2976_2976_2976_2976_2976_2976_2978_2980_2980_2983_2984_2987_2987_2987_2987_2987_2987_2987_2988_2988_2988_2990_2992_2993_2994_2995_2995_2997_2997_2997_2998_2998_2998_2999_3001_3001_3002_3003_3007_3008_3009_3009_3010_3010_3012_3012_3012_3012_3012_3013_3013_3014_3014_3014_3014_3015_3020_3020_3024_3024_3025_3026_3026_3027_3029_3029_3030_3030_3030_3030_3031_3032_3032_3032_3032_3032_3033_3033_3033_3033_3033_3034_3035_3035_3037_3037_3038_3038_3038_3038_3038_3038_3038_3038_3038_3038_3038_3038_3038_3038_3038_3039_3039_3039_3039_3039_3039_3039_3039_3039_3039_3039_3039_3039_3039_3039_3040_3040_3040_3040_3040_3040_3041_3041_3043_3043_3044_3046_3046_3047_3047_3048_3049_3049_3049_3049_3049_3049_3049_3049_3049_3049_3050_3050_3051_3051_3052_3053_3054_3054_3055_3055_3055_3056_3056_3057_3059_3059_3061_3062_3063_3063_3064_3065_3065_3065_3065_3067_3067_3067_3067_3069_3069_3070_3070_3071_3071_3071_3071_3071_3071_3072_3072_3073_3073_3074_3074_3074_3074_3074_3076_3076_3076_3076_3076_3078_3078_3078_3078_3079_3082_3083_3083_3083_3083_3083_3083_3084_3084_3084_3085_3085_3086_3086_3087_3087_3089_3093_3095_3095_3095_3095_3097_3097_3098_3098_3098_3098_3099_3099_3100_3100_3101_3103_3103_3103_3103_3103_3103_3103_3103_3103_3103_3104_3105_3105_3105_3105_3108_3109_3110_3110_3110_3110_3110_3111_3111_3111_3111_3112_3115_3115_3115_3118_3119_3119_3119_3119_3119_3119_3124_3124_3124_3124_3124_3124_3129_3129_3129_3129_3129_3130_3130_3130_3130_3130_3132_3132_3132_3132_3132_3132_3133_3133_3133_3133_3133_3137_3137_3138_3139_3139_3139_3140_3140_3141_3141_3141_3142_3142_3142_3142_3142_3145_3146_3146_3146_3146_3146_3146_3147_3149_3149_3150_3150_3150_3150_3152_3153_3153_3156_3159_3159_3159_3159_3161_3161_3162_3163_3163_3163_3163_3163_3167_3170_3170_3170_3172_3172_3172_3174_3175_3176_3177_3180_3180_3180_3181_3182_3183_3184_3184_3184_3185_3185_3185_3185_3185_3186_3186_3187_3187_3187_3188_3188_3189_3189_3189_3190_3190_3193_3194_3194_3195_3195_3195_3196_3196_3196_3197_3199_3202_3202_3202_3202_3202_3205_3205_3205_3207_3210_3211_3213_3213_3213_3215_3216_3218_3218_3218_3222_3223_3223_3223_3223_3225_3225_3225_3227_3228_3229_3231_3231_3231_3231_3231_3231_3231_3231_3231_3231_3232_3232_3232_3232_3232_3232_3233_3233_3233_3234_3234_3235_3236_3236_3236_3237_3237_3239_3239_3239_3239_3242_3242_3244_3245_3245_3246_3246_3246_3246_3246_3246_3246_3246_3247_3252_3253_3253_3253_3253_3253_3253_3253_3253_3253_3253_3253_3253_3253_3253_3254_3254_3254_3254_3254_3254_3254_3254_3255_3255_3255_3255_3255_3255_3256_3256_3256_3256_3256_3256_3257_3257_3257_3259_3259_3260_3260_3260_3260_3261_3265_3265_3265_3266_3266_3266_3266_3267_3267_3268_3270_3270_3271_3274_3274_3274_3275_3276_3277_3278_3279_3281_3281_3281_3283_3283_3283_3286_3288_3288_3288_3288_3288_3288_3288_3288_3288_3288_3289_3289_3289_3289_3289_3289_3289_3289_3289_3289_3289_3289_3290_3290_3290_3290_3290_3290_3290_3290_3290_3290_3290_3290_3291_3291_3291_3291_3291_3292_3292_3292_3292_3292_3294_3294_3294_3294_3294_3294_3294_3295_3296_3296_3296_3304_3304_3304_3304_3305_3305_3305_3306_3306_3306_3307_3307_3308_3308_3308_3308_3308_3308_3308_3308_3308_3308_3308_3310_3311_3313_3313_3313_3313_3313_3313_3318_3318_3318_3319_3319_3319_3319_3319_3319_3319_3319_3319_3321_3321_3322_3322_3323_3324_3324_3324_3324_3327_3327_3327_3327_3327_3327_3327_3327_3327_3327_3329_3329_3329_3329_3331_3331_3331_3331_3331_3331_3331_3331_3332_3333_3333_3333_3333_3333_3333_3333_3333_3333_3334_3335_3338_3338_3340_3342_3342_3342_3344_3344_3344_3345_3345_3345_3345_3347_3347_3347_3347_3349_3351_3351_3351_3351_3352_3352_3352_3353_3353_3354_3354_3354_3355_3355_3357_3357_3357_3358_3359_3359_3359_3360_3360_3360_3360_3360_3360_3360_3360_3360_3360_3361_3361_3362_3362_3363_3363_3363_3364_3365_3365_3366_3366_3367_3367_3367_3367_3368_3368_3368_3368_3369_3370_3371_3371_3371_3371_3371_3372_3372_3372_3372_3372_3373_3374_3376_3376_3378_3378_3379_3379_3380_3383_3384_3385_3385_3386_3386_3386_3386_3386_3388_3388_3388_3388_3389_3389_3389_3389_3390_3390_3390_3390_3391_3391_3392_3392_3392_3393_3393_3394_3394_3394_3395_3395_3395_3396_3397_3397_3397_3397_3397_3397_3397_3398_3400_3403_3405_3405_3405_3405_3406_3408_3409_3409_3409_3409_3409_3409_3409_3409_3409_3410_3410_3410_3410_3411_3414_3415_3415_3415_3417_3418_3418_3418_3418_3418_3418_3418_3418_3418_3418_3418_3419_3419_3421_3421_3422_3422_3422_3422_3423_3423_3423_3424_3424_3424_3425_3425_3425_3430_3431_3431_3431_3431_3432_3432_3432_3432_3433_3433_3433_3433_3433_3433_3433_3433_3433_3433_3433_3433_3433_3433_3433_3433_3434_3434_3434_3434_3435_3435_3435_3435_3435_3435_3435_3435_3435_3435_3435_3435_3435_3435_3435_3435_3436_3436_3436_3436_3440_3442_3443_3443_3443_3443_3443_3443_3443_3443_3443_3443_3444_3444_3446_3446_3446_3446_3448_3448_3448_3448_3448_3448_3448_3450_3451_3453_3453_3453_3453_3453_3453_3453_3455_3456_3458_3458_3458_3458_3458_3458_3458_3458_3458_3458_3458_3458_3459_3459_3460_3460_3460_3462_3462_3462_3462_3463_3465_3466_3466_3466_3466_3466_3467_3470_3470_3470_3471_3471_3471_3472_3472_3472_3473_3475_3475_3477_3478_3479_3479_3480_3480_3481_3481_3482_3482_3487_3487_3487_3488_3488_3489_3490_3490_3491_3493_3495_3495_3495_3495_3497_3497_3497_3497_
1,3,會,ADV,258,232,490,5_20_21_28_29_41_44_55_56_60_61_66_73_91_92_104_104_105_116_118_126_138_139_147_149_157_157_158_160_163_164_168_169_173_199_200_205_206_213_226_227_231_244_248_254_258_272_275_276_281_282_297_305_316_321_324_341_362_367_402_403_409_411_424_431_434_434_435_436_442_443_483_492_496_507_508_515_515_516_524_525_526_527_533_534_535_536_540_540_546_546_548_550_551_555_555_557_559_560_567_568_572_576_577_581_586_610_610_619_619_628_631_634_657_670_674_678_684_685_690_699_710_711_713_715_716_720_721_723_725_726_738_739_765_778_785_787_814_816_842_848_859_868_886_887_887_887_889_891_891_892_894_895_895_895_897_899_899_900_901_902_902_910_914_915_918_919_921_922_928_930_934_936_946_946_949_962_980_982_1005_1020_1025_1028_1038_1043_1046_1054_1054_1054_1054_1061_1067_1070_1074_1077_1081_1082_1087_1087_1088_1091_1091_1093_1094_1095_1112_1112_1115_1115_1120_1120_1124_1131_1152_1159_1197_1200_1203_1204_1208_1211_1211_1217_1218_1239_1270_1270_1271_1273_1273_1274_1276_1283_1318_1319_1319_1323_1324_1324_1342_1343_1343_1371_1378_1378_1388_1394_1403_1428_1430_1437_1450_1451_1480_1487_1491_1494_,2005_2010_2010_2037_2037_2037_2048_2050_2053_2060_2074_2099_2124_2126_2126_2126_2131_2133_2139_2139_2143_2143_2151_2154_2154_2161_2162_2162_2163_2167_2167_2167_2186_2193_2199_2225_2225_2226_2226_2231_2232_2249_2251_2252_2253_2264_2276_2309_2309_2318_2319_2343_2391_2391_2391_2442_2445_2445_2446_2446_2475_2477_2478_2494_2494_2494_2494_2495_2495_2495_2495_2509_2522_2523_2529_2531_2531_2531_2531_2531_2549_2549_2549_2550_2550_2550_2553_2560_2568_2589_2589_2590_2608_2666_2671_2671_2680_2714_2714_2724_2730_2740_2745_2745_2745_2746_2747_2751_2754_2759_2769_2770_2782_2795_2803_2804_2815_2815_2834_2834_2840_2857_2857_2858_2858_2861_2862_2862_2862_2863_2872_2902_2904_2909_2910_2924_2939_2940_2946_2987_3032_3033_3038_3038_3039_3039_3040_3049_3049_3058_3065_3067_3074_3076_3076_3076_3098_3103_3103_3132_3132_3133_3141_3146_3146_3146_3186_3188_3196_3231_3232_3236_3243_3246_3247_3253_3253_3259_3260_3266_3274_3282_3295_3295_3295_3308_3308_3319_3327_3345_3360_3360_3360_3363_3371_3388_3391_3393_3397_3431_3431_3432_3432_3433_3433_3433_3433_3433_3433_3433_3434_3435_3435_3435_3435_3435_3435_3435_3436_3438_3446_3446_3448_3453_3454_3454_3483_3488_3488_3490_3490_
1,3,房間,N,1177,1612,2789,2_3_4_4_5_6_7_8_8_9_10_11_12_12_16_16_16_17_17_17_18_23_24_31_32_35_37_38_40_41_42_42_42_43_45_47_49_51_51_52_52_52_52_52_53_54_55_56_57_58_59_60_61_62_64_65_66_66_68_68_68_69_69_69_69_71_72_73_73_75_75_75_76_76_76_76_77_81_82_83_87_88_89_90_91_93_94_95_96_99_100_101_102_103_103_107_107_109_109_109_114_118_121_121_124_126_129_129_132_133_134_135_137_144_145_145_146_150_150_150_150_154_155_155_155_157_158_159_160_160_161_162_162_162_162_162_163_163_163_166_167_167_167_167_167_168_168_168_174_175_176_180_181_185_190_191_195_198_198_199_203_203_204_204_204_205_209_209_210_210_210_211_212_213_213_215_216_217_218_219_219_226_226_228_231_233_235_237_237_238_241_246_247_248_251_253_256_257_258_259_261_264_265_266_268_272_276_276_276_278_280_281_283_285_286_286_287_287_289_290_290_290_292_293_294_297_300_301_302_305_307_308_308_308_309_311_312_312_312_313_320_324_325_326_330_331_334_334_335_338_338_339_340_341_341_342_342_345_345_351_352_352_355_355_361_362_363_367_368_373_374_374_375_376_377_378_379_380_381_383_384_386_387_388_390_392_392_393_393_394_395_396_396_397_403_405_407_408_408_408_409_410_411_411_414_415_419_421_422_427_429_429_431_431_433_433_433_434_434_434_434_434_434_435_437_441_442_446_448_454_456_460_464_466_467_470_471_471_474_475_475_477_478_480_480_481_482_482_482_482_486_487_489_489_491_491_491_491_495_496_497_499_503_504_506_506_507_507_507_510_514_516_516_516_517_517_518_519_520_521_521_522_523_524_527_527_529_530_530_531_532_533_536_536_540_540_543_545_546_546_546_546_546_547_548_550_551_551_552_553_553_553_554_554_555_555_555_555_555_556_557_559_560_560_561_562_562_562_563_563_566_567_569_570_572_572_573_575_576_578_579_581_581_587_588_589_589_590_592_594_596_600_601_603_605_609_610_610_611_612_615_616_618_619_619_620_621_624_625_627_628_628_628_630_631_631_632_636_636_638_638_640_643_649_650_655_656_657_659_660_662_662_663_663_664_665_665_669_669_670_670_674_676_678_678_680_683_687_689_692_694_695_695_696_697_698_704_706_707_707_707_707_710_710_710_711_714_714_714_714_714_717_717_717_717_720_720_720_721_724_724_724_724_724_728_729_732_734_735_738_739_740_740_742_742_743_745_745_745_746_747_749_750_751_752_754_754_755_757_759_760_761_762_766_767_768_770_771_771_771_772_773_773_774_775_775_775_776_777_777_778_780_783_784_784_784_786_787_790_793_794_794_795_796_797_797_798_799_800_803_804_805_806_808_809_811_812_813_814_814_815_815_815_815_816_816_817_817_819_820_820_821_821_822_823_824_825_825_826_826_827_828_830_832_835_839_841_842_843_845_846_846_847_848_849_851_853_855_856_856_856_856_856_858_859_860_862_864_865_865_865_865_865_867_868_871_871_871_871_872_872_872_872_873_873_874_875_875_875_875_875_876_879_879_879_879_880_880_880_880_881_881_882_883_883_883_883_883_884_885_886_886_886_887_888_888_888_889_889_890_891_892_893_894_894_894_895_896_896_896_897_897_898_899_900_901_901_901_901_901_901_904_904_906_906_907_910_910_912_912_912_913_914_914_915_915_917_919_919_921_921_922_922_922_923_923_924_928_929_930_930_930_931_931_932_934_934_935_936_937_939_940_942_942_943_945_946_947_948_948_949_950_951_955_957_958_961_964_966_970_971_971_972_973_973_974_974_977_978_978_981_981_982_985_986_988_989_992_995_995_996_996_998_1000_1005_1005_1006_1009_1010_1010_1011_1013_1015_1015_1016_1018_1018_1020_1020_1020_1020_1021_1024_1025_1025_1029_1029_1030_1031_1031_1033_1036_1037_1039_1040_1042_1049_1049_1049_1050_1051_1052_1055_1056_1057_1057_1057_1057_1057_1057_1057_1057_1057_1058_1060_1062_1063_1067_1068_1069_1069_1069_1069_1069_1070_1072_1072_1073_1073_1074_1075_1076_1076_1076_1076_1076_1077_1079_1079_1080_1080_1081_1084_1085_1087_1088_1088_1090_1091_1091_1091_1092_1092_1093_1094_1095_1095_1099_1105_1105_1106_1106_1108_1109_1111_1112_1112_1113_1116_1117_1119_1120_1120_1121_1124_1124_1124_1125_1129_1131_1131_1131_1132_1136_1139_1139_1140_1140_1141_1141_1143_1143_1145_1150_1151_1152_1154_1155_1155_1157_1158_1159_1161_1162_1162_1164_1166_1167_1168_1169_1169_1171_1172_1174_1175_1176_1176_1178_1179_1181_1181_1183_1184_1185_1186_1187_1187_1189_1190_1191_1192_1195_1195_1197_1198_1198_1199_1199_1200_1201_1201_1204_1207_1211_1211_1213_1218_1220_1222_1224_1226_1227_1228_1229_1230_1232_1234_1234_1235_1238_1238_1239_1239_1242_1243_1244_1246_1247_1248_1249_1250_1250_1251_1251_1251_1252_1252_1254_1257_1264_1266_1267_1269_1272_1275_1276_1276_1277_1280_1281_1282_1283_1283_1284_1287_1288_1289_1290_1290_1293_1293_1293_1294_1295_1296_1298_1299_1300_1303_1304_1304_1306_1307_1307_1309_1311_1311_1313_1315_1315_1316_1321_1326_1326_1327_1332_1333_1334_1334_1335_1337_1338_1339_1342_1343_1343_1345_1346_1348_1350_1353_1355_1356_1358_1360_1361_1362_1366_1366_1366_1374_1375_1376_1377_1383_1386_1392_1394_1397_1398_1398_1401_1403_1406_1407_1407_1408_1409_1413_1418_1419_1423_1423_1425_1425_1428_1429_1429_1431_1431_1433_1435_1437_1450_1450_1452_1455_1456_1456_1458_1459_1464_1469_1470_1472_1472_1472_1472_1472_1472_1473_1474_1476_1476_1480_1481_1483_1483_1487_1488_1489_1492_1496_1498_1498_1499_,2004_2004_2004_2006_2006_2006_2009_2010_2011_2012_2012_2012_2013_2014_2014_2016_2017_2018_2019_2020_2020_2022_2023_2027_2028_2029_2032_2034_2036_2037_2037_2037_2037_2037_2037_2037_2037_2037_2037_2038_2039_2040_2041_2042_2042_2043_2043_2044_2044_2045_2045_2047_2047_2048_2055_2056_2057_2057_2057_2057_2057_2057_2057_2058_2059_2061_2066_2068_2072_2076_2077_2077_2081_2081_2081_2081_2083_2083_2083_2083_2084_2085_2088_2089_2089_2090_2091_2092_2094_2094_2094_2095_2096_2096_2096_2097_2098_2101_2101_2101_2101_2102_2102_2102_2102_2103_2104_2104_2104_2105_2106_2106_2108_2108_2109_2109_2110_2110_2114_2116_2116_2117_2119_2119_2120_2121_2125_2126_2126_2127_2134_2134_2135_2135_2135_2136_2137_2138_2139_2139_2139_2140_2141_2143_2143_2143_2144_2144_2144_2145_2145_2145_2146_2147_2149_2149_2151_2153_2153_2154_2154_2159_2161_2161_2162_2162_2162_2163_2164_2165_2166_2166_2167_2167_2168_2169_2170_2171_2172_2172_2174_2175_2175_2175_2178_2179_2181_2183_2183_2183_2186_2186_2186_2186_2186_2190_2191_2191_2193_2196_2198_2199_2200_2201_2202_2204_2205_2206_2209_2210_2211_2216_2219_2221_2225_2225_2226_2226_2231_2232_2232_2237_2238_2239_2239_2240_2241_2244_2244_2245_2245_2246_2247_2247_2247_2247_2252_2253_2254_2255_2256_2257_2258_2258_2259_2259_2260_2264_2265_2266_2266_2266_2267_2269_2271_2272_2272_2273_2273_2273_2273_2273_2275_2276_2279_2280_2280_2280_2280_2281_2282_2283_2283_2284_2285_2286_2289_2290_2290_2290_2291_2292_2293_2294_2294_2294_2296_2297_2298_2298_2299_2299_2300_2301_2301_2302_2302_2309_2309_2309_2309_2310_2311_2312_2312_2313_2313_2314_2315_2315_2316_2316_2317_2318_2319_2320_2321_2323_2324_2325_2325_2325_2326_2326_2326_2335_2335_2339_2340_2340_2341_2341_2342_2342_2343_2343_2344_2344_2344_2344_2345_2345_2349_2349_2349_2349_2350_2350_2353_2356_2356_2356_2356_2358_2359_2359_2360_2361_2362_2363_2363_2363_2363_2363_2364_2365_2367_2367_2367_2371_2374_2376_2376_2377_2378_2380_2380_2382_2383_2384_2384_2385_2386_2388_2390_2390_2390_2390_2390_2391_2392_2393_2393_2395_2396_2397_2398_2398_2399_2400_2401_2402_2405_2406_2406_2407_2408_2408_2409_2410_2411_2412_2413_2414_2414_2416_2416_2417_2421_2425_2425_2426_2428_2428_2432_2434_2435_2436_2438_2439_2440_2444_2445_2445_2445_2445_2446_2446_2446_2446_2447_2450_2452_2453_2454_2455_2457_2459_2460_2461_2463_2463_2465_2465_2467_2468_2469_2471_2477_2479_2480_2483_2483_2483_2483_2484_2486_2487_2488_2489_2490_2491_2492_2492_2492_2494_2494_2494_2494_2494_2495_2495_2495_2495_2495_2498_2499_2500_2500_2501_2501_2505_2505_2508_2508_2508_2510_2510_2510_2510_2511_2511_2511_2511_2512_2515_2516_2516_2516_2516_2517_2517_2518_2518_2518_2518_2519_2519_2520_2520_2521_2522_2525_2525_2527_2528_2530_2531_2531_2535_2535_2537_2538_2540_2541_2541_2543_2543_2544_2544_2544_2547_2547_2548_2549_2549_2550_2550_2551_2553_2553_2553_2556_2560_2564_2566_2567_2572_2574_2575_2576_2576_2578_2582_2584_2584_2585_2586_2587_2588_2589_2589_2589_2592_2594_2594_2594_2596_2597_2599_2599_2600_2600_2601_2604_2606_2607_2610_2611_2611_2612_2613_2613_2613_2615_2615_2616_2621_2623_2623_2624_2624_2624_2625_2626_2626_2629_2630_2630_2631_2632_2632_2633_2633_2636_2637_2638_2639_2641_2641_2645_2645_2647_2648_2649_2649_2649_2650_2651_2651_2651_2652_2653_2654_2654_2654_2655_2656_2657_2659_2669_2669_2669_2671_2671_2671_2671_2671_2679_2680_2680_2681_2683_2683_2684_2686_2686_2687_2688_2688_2690_2698_2698_2698_2700_2700_2701_2701_2702_2703_2703_2703_2704_2705_2705_2706_2706_2709_2709_2709_2709_2710_2711_2711_2711_2711_2712_2713_2714_2714_2714_2714_2717_2717_2718_2718_2718_2718_2720_2720_2721_2721_2721_2721_2724_2724_2724_2725_2726_2727_2731_2731_2731_2731_2731_2731_2732_2732_2734_2734_2734_2734_2735_2736_2739_2739_2740_2740_2740_2742_2742_2742_2742_2743_2743_2744_2744_2745_2746_2746_2746_2746_2746_2747_2747_2748_2748_2748_2748_2749_2749_2750_2750_2752_2753_2753_2753_2753_2754_2754_2757_2758_2761_2762_2763_2767_2767_2769_2769_2769_2770_2770_2770_2772_2772_2773_2774_2775_2775_2775_2775_2775_2775_2775_2775_2775_2780_2780_2781_2782_2782_2783_2784_2784_2785_2786_2787_2787_2788_2789_2789_2790_2793_2793_2794_2795_2796_2804_2805_2806_2806_2807_2808_2809_2809_2813_2814_2814_2814_2814_2814_2815_2815_2817_2817_2817_2819_2819_2819_2820_2822_2822_2824_2824_2826_2826_2827_2828_2829_2830_2833_2836_2836_2839_2840_2840_2840_2841_2841_2841_2841_2841_2844_2845_2845_2845_2846_2846_2847_2847_2848_2852_2854_2855_2855_2856_2856_2857_2857_2857_2858_2858_2858_2862_2862_2862_2863_2863_2863_2863_2864_2864_2865_2867_2867_2868_2869_2870_2872_2872_2872_2872_2872_2872_2872_2872_2872_2872_2872_2872_2872_2872_2873_2873_2874_2875_2876_2879_2879_2879_2880_2880_2880_2881_2881_2882_2883_2883_2885_2885_2887_2887_2889_2889_2890_2890_2893_2893_2897_2898_2900_2906_2908_2908_2908_2908_2908_2909_2910_2911_2912_2913_2914_2914_2916_2916_2917_2917_2920_2922_2923_2923_2925_2925_2925_2926_2927_2928_2928_2928_2932_2933_2936_2937_2938_2938_2939_2939_2940_2940_2941_2943_2944_2944_2946_2946_2946_2946_2946_2946_2946_2948_2949_2949_2950_2951_2953_2956_2957_2958_2958_2961_2961_2963_2963_2965_2966_2968_2969_2969_2969_2970_2970_2970_2970_2971_2972_2972_2972_2973_2973_2974_2974_2975_2975_2976_2980_2981_2982_2983_2984_2985_2987_2987_2987_2987_2987_2988_2990_2990_2992_2992_2993_2994_2995_2995_2997_2997_2998_3001_3001_3001_3003_3005_3005_3006_3006_3007_3008_3008_3011_3013_3013_3016_3017_3018_3019_3020_3020_3020_3022_3023_3025_3027_3029_3030_3032_3032_3033_3033_3034_3035_3037_3038_3038_3039_3039_3040_3040_3041_3041_3046_3047_3047_3049_3050_3051_3051_3052_3052_3053_3053_3054_3054_3054_3054_3054_3055_3056_3056_3058_3059_3061_3063_3063_3064_3065_3065_3065_3067_3067_3067_3069_3069_3069_3070_3070_3070_3071_3071_3071_3074_3076_3076_3078_3080_3083_3083_3083_3084_3085_3087_3087_3091_3092_3092_3095_3095_3097_3098_3098_3099_3101_3101_3103_3103_3104_3106_3107_3108_3109_3110_3110_3111_3112_3114_3115_3115_3115_3115_3117_3117_3118_3119_3119_3119_3119_3120_3122_3124_3124_3124_3124_3125_3127_3129_3129_3129_3129_3130_3130_3130_3130_3131_3132_3132_3132_3133_3134_3135_3139_3140_3142_3146_3146_3146_3146_3146_3150_3152_3160_3161_3162_3162_3164_3167_3170_3172_3174_3178_3180_3182_3183_3184_3184_3184_3184_3184_3184_3185_3185_3185_3186_3187_3187_3188_3189_3189_3194_3194_3194_3195_3195_3196_3198_3200_3201_3202_3202_3203_3205_3205_3207_3209_3210_3210_3211_3212_3212_3213_3213_3214_3215_3215_3216_3217_3217_3218_3218_3219_3222_3223_3223_3224_3225_3226_3226_3227_3227_3227_3228_3229_3231_3231_3232_3232_3232_3232_3233_3237_3237_3238_3246_3246_3246_3249_3253_3253_3253_3253_3253_3253_3253_3253_3254_3255_3255_3256_3256_3257_3257_3257_3257_3259_3260_3260_3262_3263_3265_3265_3266_3267_3270_3274_3276_3276_3277_3278_3278_3278_3279_3279_3281_3281_3281_3283_3283_3284_3285_3286_3287_3288_3289_3289_3289_3290_3290_3290_3293_3293_3295_3296_3296_3296_3297_3300_3300_3303_3303_3304_3305_3306_3306_3307_3307_3308_3308_3309_3311_3312_3316_3316_3318_3318_3319_3321_3322_3324_3326_3326_3327_3327_3327_3327_3331_3331_3333_3333_3333_3333_3333_3335_3341_3341_3341_3341_3341_3341_3341_3344_3344_3349_3349_3351_3352_3353_3353_3354_3355_3355_3357_3357_3359_3360_3360_3360_3360_3363_3363_3363_3364_3365_3369_3370_3371_3371_3371_3371_3371_3371_3371_3372_3376_3376_3378_3378_3382_3383_3383_3383_3384_3384_3384_3386_3386_3386_3386_3386_3386_3388_3388_3388_3388_3389_3389_3390_3390_3391_3392_3393_3394_3395_3396_3396_3396_3397_3397_3397_3398_3400_3401_3401_3401_3403_3405_3405_3406_3408_3409_3409_3409_3409_3409_3410_3410_3411_3413_3413_3414_3414_3417_3417_3418_3418_3418_3418_3419_3421_3421_3422_3423_3423_3423_3424_3424_3424_3425_3425_3426_3427_3428_3428_3431_3431_3431_3431_3431_3432_3432_3432_3432_3432_3433_3433_3433_3433_3433_3433_3433_3435_3435_3435_3435_3435_3435_3435_3438_3446_3446_3448_3448_3448_3448_3448_3448_3448_3450_3451_3451_3453_3453_3453_3453_3453_3453_3453_3454_3454_3455_3456_3456_3458_3458_3460_3460_3462_3462_3462_3462_3462_3463_3463_3464_3465_3466_3467_3467_3467_3470_3470_3470_3470_3470_3470_3470_3470_3471_3472_3472_3473_3473_3473_3475_3476_3477_3477_3477_3478_3478_3478_3478_3479_3480_3481_3482_3483_3483_3483_3483_3484_3484_3485_3486_3487_3488_3488_3489_3490_3490_3491_3499_
1,3,指示,Vt,5,2,7,5_182_192_903_,3297_
1,3,簡單,Vi,19,33,52,5_176_245_255_553_562_569_578_736_738_780_788_921_1140_1244_1248_1282_1289_,2221_2272_2284_2299_2302_2309_2338_2372_2375_2376_2438_2440_2484_2572_2604_2630_2630_2864_2882_2921_2929_2931_2976_2976_3121_3126_3225_3246_3345_3398_3464_3470_
1,3,麻煩,Vt,8,18,26,5_432_701_736_1249_1451_1474_,2361_2392_2549_2549_2550_2550_2629_2728_2729_2742_2919_3076_3140_3196_3333_3360_3397_
1,3,較為,ADV,5,1,6,5_801_1164_1166_,
1,3,非常,ADV,350,354,704,5_15_16_19_19_26_34_42_44_52_52_52_79_81_85_87_89_89_89_89_91_93_93_94_94_94_94_94_100_107_110_118_119_119_120_121_121_121_126_127_127_128_129_129_129_141_141_146_151_157_157_171_171_177_178_188_201_207_216_225_230_231_231_232_232_237_244_246_254_256_260_262_271_273_277_280_308_312_316_321_339_343_343_344_351_353_353_354_361_366_366_371_371_376_376_382_385_386_392_408_409_427_430_439_442_443_471_475_480_480_481_482_489_489_491_514_521_521_521_521_522_524_530_530_530_530_531_533_550_551_551_553_554_559_560_560_562_563_567_572_576_581_582_582_583_583_589_593_599_602_608_610_611_611_619_620_620_628_630_634_644_663_665_667_669_669_708_710_710_710_715_715_718_720_720_720_725_725_728_739_739_744_744_762_763_765_773_777_782_782_783_786_787_787_787_801_812_812_819_821_828_831_837_841_841_848_852_855_856_856_859_859_859_861_864_865_865_868_868_868_885_888_893_896_902_910_910_913_919_923_923_923_923_923_923_924_931_931_931_931_931_931_932_940_940_956_956_956_956_958_974_982_982_983_983_983_983_988_989_992_1008_1009_1030_1031_1032_1038_1042_1043_1046_1056_1062_1088_1090_1126_1129_1133_1136_1141_1143_1149_1151_1156_1158_1164_1166_1167_1167_1168_1169_1172_1173_1174_1174_1175_1176_1179_1180_1181_1187_1227_1229_1232_1243_1247_1252_1255_1281_1288_1309_1311_1313_1315_1319_1324_1336_1337_1337_1337_1337_1349_1362_1366_1366_1375_1376_1376_1376_1386_1387_1391_1393_1395_1398_1400_1402_1404_1407_1409_1437_1455_1465_1469_1470_1472_1480_1487_1496_1497_1499_,2004_2006_2018_2033_2035_2037_2037_2043_2043_2045_2045_2048_2050_2053_2066_2074_2088_2108_2108_2108_2110_2116_2119_2120_2121_2128_2128_2134_2144_2144_2144_2144_2145_2145_2145_2145_2151_2159_2159_2159_2159_2159_2163_2163_2163_2163_2163_2175_2183_2191_2192_2225_2225_2226_2226_2233_2239_2252_2252_2253_2253_2258_2259_2260_2267_2272_2275_2284_2297_2300_2304_2305_2305_2305_2305_2307_2308_2308_2308_2308_2321_2356_2356_2356_2356_2356_2356_2356_2359_2360_2361_2362_2388_2391_2394_2400_2402_2406_2408_2412_2417_2436_2436_2445_2446_2447_2447_2450_2450_2453_2453_2460_2460_2461_2461_2464_2464_2464_2466_2466_2466_2475_2492_2494_2495_2509_2516_2518_2529_2548_2549_2549_2550_2550_2553_2553_2556_2558_2560_2564_2564_2566_2566_2567_2575_2575_2589_2592_2596_2596_2596_2597_2597_2597_2611_2625_2637_2638_2642_2646_2671_2700_2700_2701_2701_2705_2705_2706_2706_2714_2714_2725_2731_2734_2740_2740_2740_2742_2746_2746_2746_2750_2752_2764_2765_2771_2772_2772_2773_2779_2782_2791_2791_2798_2798_2800_2800_2808_2851_2857_2857_2858_2858_2864_2881_2881_2881_2881_2881_2882_2883_2885_2887_2900_2903_2905_2914_2914_2914_2917_2918_2948_2951_2953_2956_2957_2969_2972_2972_2985_2997_3006_3020_3020_3024_3026_3032_3033_3035_3037_3037_3038_3038_3039_3039_3040_3071_3083_3083_3083_3083_3088_3093_3104_3105_3119_3124_3132_3132_3145_3145_3145_3152_3152_3163_3175_3176_3186_3188_3197_3199_3207_3207_3207_3207_3207_3228_3229_3231_3231_3231_3232_3233_3238_3246_3253_3253_3255_3255_3255_3256_3256_3256_3286_3312_3324_3327_3327_3338_3340_3341_3347_3371_3371_3391_3393_3417_3422_3422_3427_3427_3431_3431_3431_3431_3431_3432_3432_3432_3432_3432_3433_3433_3433_3433_3433_3433_3433_3433_3435_3435_3435_3435_3435_3435_3435_3435_3448_3448_3453_3453_3459_3459_3470_3479_3481_3487_3495_3495_3497_3497_3498_3500_
1,1,蔡陸線,N,2,0,2,5_,
2,3,經濟,N,11,18,29,6_218_320_334_687_692_1348_1450_1491_1494_,2114_2116_2117_2119_2243_2434_2530_2609_2647_2750_2756_2824_2824_2826_2826_2828_3103_
2,3,感覺,N,424,309,733,6_22_23_30_31_38_41_45_51_53_54_58_59_68_68_69_75_75_76_79_79_81_81_85_85_87_87_89_103_108_119_127_134_139_142_142_155_156_162_163_164_167_168_169_175_177_180_180_182_190_190_192_203_204_209_210_211_213_214_217_217_218_224_226_229_230_239_240_240_245_249_250_250_255_268_273_274_281_287_290_292_300_308_309_309_312_313_313_320_334_335_335_335_341_342_351_351_352_361_361_364_369_372_388_393_401_402_407_412_415_422_424_424_427_434_436_437_442_442_461_467_479_480_481_482_484_484_488_489_491_493_493_495_497_499_501_502_508_522_522_522_522_522_522_525_531_531_531_531_531_531_534_541_546_550_551_552_553_555_559_560_561_562_566_569_575_578_582_583_588_594_595_597_603_604_628_629_629_630_630_634_636_638_657_662_663_663_663_669_669_681_682_683_695_710_710_720_720_732_734_734_740_747_749_751_762_763_769_784_793_793_793_794_794_795_796_796_796_797_797_798_799_803_803_814_814_814_817_820_826_837_841_843_843_856_856_865_865_870_870_872_874_878_878_880_882_885_885_890_893_893_898_901_907_910_912_913_915_917_920_921_923_923_923_924_931_931_931_932_934_943_957_957_961_974_974_978_983_986_1005_1005_1005_1007_1007_1007_1009_1011_1018_1018_1021_1021_1021_1022_1022_1026_1054_1056_1057_1057_1058_1058_1060_1081_1088_1088_1098_1098_1100_1103_1106_1106_1107_1112_1112_1113_1114_1114_1114_1120_1120_1121_1124_1124_1129_1131_1131_1135_1136_1138_1139_1139_1141_1143_1148_1168_1175_1181_1186_1187_1192_1195_1198_1204_1205_1209_1212_1216_1218_1220_1220_1222_1222_1239_1250_1251_1251_1254_1254_1258_1261_1281_1288_1293_1304_1307_1309_1313_1316_1317_1321_1322_1332_1332_1333_1337_1343_1345_1347_1349_1352_1353_1375_1376_1384_1386_1387_1399_1411_1416_1418_1418_1419_1421_1423_1423_1423_1425_1425_1425_1428_1428_1430_1431_1433_1435_1437_1438_1439_1444_1451_1462_1467_1471_1473_1473_1481_1488_1489_1492_1495_1497_1498_1500_,2018_2022_2049_2050_2052_2053_2056_2057_2057_2060_2064_2067_2068_2069_2090_2090_2090_2090_2093_2093_2105_2108_2114_2117_2122_2126_2159_2161_2161_2180_2180_2186_2201_2202_2207_2211_2211_2219_2221_2233_2234_2266_2269_2281_2282_2283_2283_2299_2299_2302_2302_2310_2311_2322_2342_2359_2360_2361_2362_2362_2362_2363_2388_2388_2391_2391_2391_2395_2398_2409_2410_2411_2414_2414_2417_2417_2432_2435_2436_2439_2445_2445_2446_2446_2450_2453_2454_2454_2455_2455_2459_2470_2478_2484_2489_2500_2500_2501_2501_2505_2508_2508_2534_2540_2543_2543_2544_2546_2546_2549_2549_2549_2550_2550_2550_2576_2589_2599_2606_2610_2610_2616_2626_2626_2629_2637_2638_2641_2645_2647_2647_2647_2649_2659_2659_2667_2669_2670_2671_2690_2698_2705_2706_2718_2719_2721_2722_2724_2731_2735_2736_2744_2748_2748_2750_2754_2771_2790_2790_2791_2794_2799_2799_2807_2813_2814_2815_2815_2817_2819_2837_2848_2854_2854_2857_2858_2889_2890_2898_2898_2903_2905_2906_2912_2922_2927_2934_2934_2969_2974_2975_2976_2977_2978_2983_2984_2987_2995_2995_3013_3049_3049_3055_3055_3057_3065_3066_3067_3068_3077_3083_3083_3083_3084_3084_3085_3088_3094_3096_3101_3101_3104_3132_3132_3132_3133_3139_3146_3151_3160_3161_3171_3173_3174_3177_3184_3190_3196_3207_3207_3210_3215_3220_3220_3221_3221_3243_3246_3260_3260_3274_3282_3282_3286_3289_3290_3293_3308_3313_3318_3318_3319_3319_3324_3327_3327_3331_3345_3349_3353_3355_3358_3360_3360_3360_3360_3360_3360_3361_3362_3363_3363_3369_3369_3369_3370_3370_3370_3371_3371_3383_3384_3392_3394_3397_3413_3417_3420_3427_3433_3435_3437_3438_3458_3471_3487_3488_3490_
2,3,商務,N,75,52,127,6_12_40_42_43_43_43_69_76_82_88_150_162_162_162_167_167_167_171_174_175_175_176_199_203_205_209_213_215_219_226_231_231_241_251_271_272_433_540_540_540_540_546_546_550_555_555_559_599_608_658_658_828_928_936_971_990_993_1060_1068_1075_1115_1186_1192_1309_1313_1352_1352_1353_1353_1375_1376_1469_1470_,2022_2043_2045_2077_2108_2108_2167_2186_2280_2283_2284_2322_2372_2375_2399_2401_2412_2412_2417_2419_2483_2548_2647_2709_2711_2817_2819_2847_2851_2866_2889_2890_2916_2980_3024_3026_3047_3051_3074_3104_3195_3224_3270_3281_3345_3364_3364_3383_3384_3417_3443_
2,3,很,ADV,1916,1219,3135,3_3_3_3_3_4_6_7_7_7_7_7_8_9_9_9_9_11_12_12_15_16_16_17_18_18_20_20_20_24_24_24_25_28_28_28_32_32_32_33_36_38_38_39_40_40_40_40_42_43_44_47_50_51_51_51_52_52_52_52_52_56_56_56_56_61_61_61_61_64_65_65_65_66_66_66_67_68_68_68_68_68_68_69_69_69_69_71_72_72_72_73_73_73_74_75_75_75_75_75_75_76_76_76_76_78_78_78_79_79_79_79_81_81_81_81_82_82_84_84_84_85_85_85_85_87_87_87_87_88_88_89_89_89_89_90_91_91_92_94_98_98_99_99_99_99_99_100_100_100_100_101_103_103_103_103_103_103_103_105_105_106_106_106_107_107_107_107_108_108_109_109_109_109_111_111_113_114_114_116_118_119_120_123_123_123_124_126_127_128_131_131_131_132_133_137_139_139_139_139_142_142_144_144_145_146_147_148_149_150_150_154_154_155_155_156_157_158_158_158_159_159_162_162_163_163_163_167_167_168_168_168_171_173_174_176_176_176_176_176_176_177_179_179_180_181_181_181_182_183_183_183_184_184_186_186_186_186_187_187_187_187_189_189_190_191_191_191_192_193_193_193_194_194_196_196_196_196_197_197_197_197_199_201_204_204_205_207_210_210_212_212_215_215_215_215_216_216_216_216_217_217_218_219_219_219_219_223_224_225_225_225_225_226_226_226_226_226_226_228_228_230_230_231_232_232_234_236_237_238_238_238_239_240_240_244_246_246_246_247_247_247_247_247_247_248_248_249_250_250_253_254_256_256_256_257_257_257_257_257_257_258_258_259_259_259_261_261_261_264_264_265_265_266_266_267_268_270_270_271_271_272_274_276_276_276_279_279_280_281_281_281_281_281_283_283_283_285_286_286_287_287_287_288_289_290_290_290_290_291_293_294_295_295_296_296_297_297_298_298_299_301_302_303_303_304_304_305_305_306_306_307_309_309_309_311_313_313_313_315_315_316_316_316_316_317_320_320_320_320_320_321_321_322_324_327_328_328_332_333_333_334_334_334_334_335_335_335_335_335_335_335_335_335_335_336_336_337_337_337_338_339_339_339_339_340_340_341_341_341_341_341_342_344_344_344_348_348_351_351_351_352_354_354_354_361_361_361_362_363_364_364_364_366_366_366_367_368_369_369_369_371_371_371_373_373_373_373_373_374_374_376_376_377_377_377_378_380_381_381_382_383_384_384_385_388_389_390_390_390_391_391_392_393_395_396_401_401_403_403_406_407_408_408_411_411_411_411_412_413_415_419_419_421_421_424_427_428_428_429_429_429_430_430_431_431_432_433_434_434_436_436_438_440_441_443_444_445_452_453_461_462_466_467_470_471_471_471_474_475_475_475_476_476_477_477_477_478_479_479_483_484_485_485_486_486_486_487_488_488_492_493_494_494_496_496_496_497_500_503_504_505_505_507_512_512_518_520_520_520_521_522_522_522_522_522_522_522_523_524_524_524_524_524_524_526_526_526_528_529_529_529_530_531_531_531_531_531_531_531_532_533_533_533_533_533_533_535_535_535_537_538_540_541_547_548_548_548_550_550_550_551_552_553_553_554_554_554_554_556_557_557_557_559_559_559_560_561_562_562_563_563_563_563_567_569_570_571_573_576_578_579_580_582_583_585_590_594_595_596_596_596_596_603_604_605_605_605_605_607_610_611_611_612_613_618_619_620_620_621_622_627_629_629_629_629_630_630_630_630_631_631_632_634_634_634_636_638_639_639_643_644_644_645_645_649_649_650_651_651_655_655_656_657_658_661_663_663_663_663_663_663_663_663_663_664_664_665_667_668_668_668_668_669_670_670_670_670_670_671_674_674_674_674_674_674_676_676_676_678_678_678_678_678_678_678_678_680_685_686_686_689_690_691_691_694_695_698_699_699_701_701_703_705_707_707_707_707_709_709_709_710_710_710_710_710_710_710_710_710_710_710_710_711_711_711_711_711_713_713_714_714_714_714_714_714_714_716_716_716_716_717_717_717_717_719_719_719_720_720_720_720_720_720_720_720_720_720_720_720_721_721_721_721_721_723_723_724_724_724_724_724_724_724_726_726_726_726_730_731_731_732_734_736_736_738_738_739_740_741_744_745_745_745_745_745_746_746_747_751_751_754_754_754_754_754_755_755_755_755_757_757_757_757_760_760_762_762_763_767_767_767_770_770_771_771_774_774_775_775_778_779_779_780_780_780_782_782_783_783_783_783_784_784_784_785_786_786_786_787_787_787_787_788_788_788_788_788_792_792_792_793_793_793_794_794_795_795_795_795_796_796_796_797_797_798_798_798_798_799_799_799_799_799_799_800_802_804_804_804_804_808_809_811_812_813_814_814_814_814_814_814_814_814_815_816_816_818_819_820_820_820_821_821_822_824_824_825_825_826_826_827_828_828_828_828_828_828_828_828_828_828_828_830_830_834_834_835_835_835_835_835_835_839_839_841_842_842_842_842_844_845_845_845_846_846_848_848_852_855_856_856_856_857_859_861_864_865_865_865_866_868_869_869_869_870_870_870_870_870_872_872_872_872_872_874_875_875_875_875_875_877_877_877_878_878_878_878_878_880_880_880_880_880_882_883_883_883_883_883_885_885_885_885_885_885_886_886_886_886_886_886_886_886_887_887_887_888_888_888_889_889_889_889_889_889_889_890_890_890_890_891_891_891_892_893_893_893_893_893_893_894_894_894_894_894_894_894_894_895_895_895_896_896_896_897_897_897_897_897_897_897_898_898_898_898_899_899_899_900_902_902_903_905_906_906_907_907_907_907_910_910_910_910_912_912_912_912_916_916_918_919_919_919_919_921_921_921_922_922_922_922_922_923_923_923_923_923_924_924_924_924_924_924_924_930_930_930_930_930_931_931_931_931_931_932_932_932_932_932_932_932_934_934_934_934_935_935_939_939_939_941_942_944_944_944_944_944_944_946_946_946_946_947_947_948_948_948_948_948_950_950_950_951_952_953_955_959_960_960_961_961_962_962_962_963_964_964_965_966_967_970_970_971_973_973_973_974_974_974_974_978_979_979_979_980_980_981_981_981_981_981_981_982_982_982_983_984_984_984_984_989_991_991_992_994_994_998_1005_1005_1005_1005_1007_1008_1008_1009_1010_1011_1011_1013_1013_1015_1018_1018_1018_1018_1018_1021_1025_1026_1026_1026_1029_1031_1031_1031_1031_1033_1036_1037_1040_1042_1042_1042_1042_1043_1043_1044_1044_1045_1046_1047_1048_1049_1049_1050_1052_1052_1054_1054_1055_1055_1055_1055_1056_1056_1056_1057_1057_1057_1057_1057_1057_1057_1059_1059_1060_1060_1061_1063_1063_1064_1066_1067_1067_1068_1068_1068_1069_1071_1074_1074_1075_1075_1075_1076_1078_1081_1081_1082_1082_1082_1082_1082_1082_1084_1084_1085_1085_1085_1086_1086_1086_1087_1087_1088_1088_1088_1088_1088_1088_1088_1088_1091_1091_1091_1091_1091_1092_1092_1092_1093_1093_1094_1094_1095_1095_1099_1100_1100_1100_1103_1103_1105_1105_1106_1106_1106_1106_1106_1107_1109_1110_1112_1112_1113_1113_1113_1113_1113_1114_1114_1115_1115_1115_1117_1118_1120_1120_1121_1121_1121_1121_1121_1127_1127_1129_1134_1134_1135_1135_1136_1139_1139_1141_1141_1141_1143_1143_1143_1145_1149_1149_1149_1149_1151_1153_1156_1156_1156_1156_1158_1160_1163_1165_1167_1168_1168_1171_1172_1173_1174_1175_1175_1178_1179_1180_1181_1181_1181_1181_1184_1186_1187_1187_1187_1187_1190_1192_1195_1197_1198_1200_1201_1204_1204_1204_1205_1208_1208_1208_1211_1211_1211_1211_1211_1211_1211_1212_1212_1212_1213_1213_1217_1217_1218_1220_1222_1224_1224_1226_1226_1228_1228_1228_1228_1228_1230_1230_1230_1230_1230_1232_1234_1235_1235_1235_1236_1237_1237_1237_1237_1238_1238_1238_1238_1239_1241_1242_1242_1244_1244_1244_1244_1245_1246_1246_1248_1248_1248_1248_1249_1249_1250_1251_1251_1251_1251_1253_1254_1254_1254_1257_1259_1259_1259_1261_1267_1267_1269_1269_1270_1271_1273_1274_1278_1279_1281_1281_1285_1286_1288_1288_1295_1297_1299_1301_1304_1307_1308_1309_1309_1311_1312_1313_1313_1315_1319_1319_1319_1319_1320_1320_1320_1324_1324_1324_1324_1325_1325_1325_1326_1328_1328_1328_1329_1330_1333_1334_1337_1337_1338_1340_1342_1342_1343_1345_1345_1346_1350_1350_1350_1350_1355_1359_1359_1359_1360_1362_1362_1362_1364_1364_1364_1366_1366_1366_1369_1369_1375_1377_1377_1378_1378_1378_1378_1383_1383_1383_1383_1383_1384_1385_1385_1385_1386_1386_1389_1392_1392_1393_1394_1394_1394_1395_1396_1396_1397_1397_1398_1398_1401_1401_1402_1403_1403_1403_1404_1405_1405_1406_1406_1407_1407_1408_1408_1410_1413_1413_1415_1419_1421_1423_1423_1427_1429_1429_1429_1429_1430_1430_1431_1431_1431_1431_1433_1433_1433_1433_1435_1435_1435_1435_1436_1437_1437_1437_1437_1439_1440_1440_1440_1440_1440_1444_1445_1445_1445_1445_1445_1450_1452_1457_1457_1457_1459_1459_1463_1463_1463_1464_1464_1468_1468_1468_1469_1470_1471_1471_1471_1471_1473_1473_1473_1473_1473_1473_1473_1473_1473_1473_1473_1474_1481_1481_1488_1488_1489_1490_1490_1492_1493_1493_1495_1495_1495_1496_1496_1496_1496_1499_1499_1499_1500_1500_,2004_2005_2006_2010_2012_2012_2014_2017_2020_2022_2022_2032_2032_2034_2034_2037_2037_2037_2037_2037_2037_2037_2037_2037_2037_2037_2038_2038_2038_2040_2040_2040_2048_2048_2056_2057_2058_2058_2060_2060_2060_2066_2068_2070_2074_2077_2077_2081_2083_2090_2090_2090_2090_2091_2092_2093_2093_2098_2098_2098_2103_2104_2108_2112_2112_2113_2114_2114_2115_2115_2116_2116_2116_2116_2117_2117_2118_2118_2119_2119_2119_2119_2124_2125_2126_2126_2126_2127_2127_2130_2132_2134_2134_2135_2136_2136_2136_2139_2140_2140_2140_2143_2144_2144_2144_2144_2145_2145_2145_2145_2148_2149_2149_2149_2151_2153_2153_2153_2153_2153_2154_2154_2154_2154_2161_2161_2161_2161_2161_2161_2162_2162_2162_2162_2163_2164_2164_2164_2166_2167_2168_2175_2175_2175_2175_2175_2175_2175_2177_2180_2181_2181_2181_2183_2183_2183_2183_2189_2195_2196_2196_2198_2198_2198_2198_2200_2200_2201_2202_2204_2209_2209_2210_2210_2211_2211_2211_2211_2211_2215_2215_2215_2215_2215_2219_2219_2220_2220_2221_2221_2222_2222_2224_2225_2225_2225_2226_2226_2226_2227_2229_2229_2231_2231_2232_2232_2235_2236_2240_2244_2245_2246_2246_2246_2246_2246_2246_2247_2247_2252_2252_2252_2252_2253_2253_2253_2253_2254_2256_2258_2258_2259_2259_2260_2260_2260_2260_2260_2260_2260_2260_2261_2263_2264_2265_2266_2266_2266_2269_2269_2269_2269_2275_2283_2283_2283_2285_2289_2292_2292_2299_2299_2299_2302_2302_2302_2304_2305_2305_2307_2308_2308_2309_2310_2310_2310_2311_2311_2311_2312_2313_2314_2315_2316_2317_2318_2319_2321_2322_2326_2326_2332_2333_2333_2334_2334_2335_2335_2335_2335_2338_2340_2340_2341_2341_2347_2347_2353_2353_2353_2358_2359_2360_2361_2362_2367_2367_2377_2380_2382_2384_2384_2384_2385_2385_2385_2389_2391_2394_2394_2400_2400_2402_2402_2404_2409_2409_2410_2410_2414_2414_2416_2417_2418_2418_2419_2419_2421_2424_2426_2434_2434_2436_2438_2439_2439_2440_2442_2444_2444_2445_2445_2445_2445_2445_2446_2446_2446_2446_2446_2448_2450_2450_2450_2451_2452_2453_2453_2453_2454_2454_2455_2455_2459_2459_2464_2466_2470_2477_2477_2478_2484_2489_2489_2490_2491_2491_2494_2495_2498_2500_2500_2500_2500_2500_2500_2501_2501_2501_2501_2501_2501_2504_2505_2505_2505_2508_2509_2509_2510_2510_2510_2510_2511_2511_2511_2511_2512_2515_2515_2516_2516_2517_2517_2518_2518_2519_2519_2522_2525_2525_2525_2527_2528_2530_2534_2534_2535_2537_2538_2539_2541_2543_2543_2543_2544_2547_2548_2548_2549_2549_2549_2549_2549_2549_2550_2550_2550_2550_2550_2550_2557_2560_2561_2562_2567_2568_2572_2574_2575_2576_2576_2576_2578_2578_2582_2593_2596_2597_2598_2598_2601_2607_2608_2608_2608_2608_2608_2609_2609_2609_2609_2609_2610_2611_2611_2611_2611_2613_2616_2616_2621_2624_2624_2624_2626_2626_2626_2629_2630_2630_2631_2631_2631_2631_2634_2634_2636_2649_2650_2650_2652_2653_2653_2655_2656_2665_2667_2669_2669_2669_2671_2671_2671_2672_2675_2677_2688_2691_2698_2698_2699_2702_2702_2702_2702_2702_2703_2704_2705_2705_2706_2706_2707_2708_2714_2717_2718_2718_2719_2720_2721_2721_2722_2734_2734_2740_2740_2740_2740_2740_2740_2740_2742_2746_2747_2747_2747_2749_2750_2753_2753_2753_2753_2753_2754_2756_2756_2756_2756_2756_2760_2761_2762_2766_2766_2766_2769_2769_2769_2770_2770_2770_2771_2772_2773_2775_2775_2775_2776_2782_2783_2784_2785_2792_2796_2799_2802_2803_2803_2807_2807_2807_2809_2809_2809_2810_2811_2812_2813_2813_2814_2814_2815_2815_2815_2815_2815_2815_2815_2816_2818_2823_2824_2825_2826_2827_2827_2829_2829_2829_2834_2835_2835_2837_2841_2846_2846_2846_2847_2847_2847_2847_2847_2850_2850_2851_2852_2854_2855_2855_2855_2855_2856_2856_2856_2856_2857_2857_2857_2857_2857_2857_2858_2858_2858_2858_2858_2858_2860_2860_2860_2861_2863_2863_2864_2864_2864_2864_2864_2867_2867_2867_2867_2872_2872_2872_2876_2876_2877_2877_2878_2878_2881_2883_2883_2883_2888_2889_2889_2889_2890_2890_2890_2892_2896_2896_2897_2897_2898_2902_2902_2903_2904_2904_2905_2907_2907_2907_2907_2907_2909_2909_2909_2909_2909_2909_2909_2910_2910_2910_2910_2910_2910_2910_2912_2915_2916_2917_2923_2925_2927_2928_2928_2928_2930_2930_2931_2931_2931_2932_2933_2933_2933_2933_2934_2934_2941_2941_2943_2944_2946_2950_2953_2953_2953_2953_2953_2953_2954_2956_2957_2959_2959_2960_2962_2969_2971_2971_2974_2976_2976_2983_2984_2988_2988_2988_2988_2993_2994_2997_3000_3001_3001_3001_3004_3011_3011_3012_3012_3012_3012_3012_3019_3019_3020_3025_3025_3025_3027_3027_3027_3029_3030_3031_3034_3041_3046_3049_3050_3055_3055_3056_3056_3056_3056_3056_3057_3059_3064_3064_3073_3074_3074_3076_3076_3076_3076_3076_3076_3076_3077_3079_3080_3084_3084_3088_3093_3093_3095_3097_3097_3098_3099_3099_3100_3100_3100_3101_3101_3102_3103_3103_3106_3108_3108_3109_3109_3111_3111_3111_3111_3112_3112_3113_3114_3115_3117_3119_3120_3121_3121_3121_3122_3124_3125_3126_3126_3126_3127_3131_3132_3133_3135_3135_3135_3137_3137_3138_3139_3144_3144_3146_3146_3147_3149_3149_3151_3152_3152_3153_3156_3158_3158_3158_3158_3159_3159_3159_3160_3167_3167_3168_3168_3169_3169_3171_3171_3171_3173_3173_3173_3174_3174_3174_3177_3178_3182_3183_3184_3186_3188_3190_3190_3196_3197_3198_3198_3199_3200_3200_3202_3205_3205_3210_3211_3214_3215_3216_3219_3222_3222_3223_3227_3227_3228_3228_3229_3229_3231_3231_3231_3231_3233_3239_3240_3242_3242_3242_3254_3254_3254_3254_3254_3254_3254_3255_3256_3257_3265_3267_3267_3268_3270_3272_3272_3274_3279_3281_3282_3282_3283_3283_3284_3285_3286_3287_3287_3288_3288_3288_3288_3288_3293_3293_3293_3293_3293_3295_3308_3308_3310_3318_3318_3318_3318_3319_3319_3319_3321_3322_3324_3327_3327_3329_3331_3333_3333_3333_3333_3333_3333_3333_3333_3333_3333_3333_3334_3334_3336_3339_3341_3345_3349_3352_3352_3354_3354_3357_3358_3358_3358_3360_3360_3360_3360_3360_3361_3362_3365_3365_3366_3367_3368_3369_3369_3370_3370_3376_3376_3376_3378_3378_3378_3386_3386_3391_3391_3391_3392_3393_3393_3393_3394_3397_3400_3400_3401_3402_3405_3405_3407_3410_3410_3414_3415_3418_3418_3418_3418_3421_3426_3433_3433_3433_3433_3433_3433_3433_3433_3433_3434_3434_3434_3435_3435_3435_3435_3435_3435_3435_3435_3435_3436_3436_3436_3437_3439_3441_3443_3443_3443_3444_3447_3454_3454_3454_3458_3463_3465_3466_3466_3466_3466_3466_3468_3470_3470_3470_3472_3476_3477_3477_3477_3479_3480_3480_3480_3481_3482_3482_3482_3483_3483_3484_3485_3487_3487_3488_3490_3494_3494_3496_3496_3498_3498_3500_3500_
2,3,床,N,218,255,473,2_3_3_6_6_7_7_42_68_75_109_109_109_115_115_115_115_117_125_133_158_162_162_163_167_167_168_186_186_186_196_196_196_203_209_213_213_218_218_219_223_223_228_245_248_255_258_276_281_322_322_326_328_331_333_342_352_376_391_396_397_407_408_431_434_434_434_434_434_434_435_470_470_474_474_499_499_500_521_521_522_522_530_530_531_531_550_559_570_579_611_620_628_629_670_672_675_678_698_707_707_717_717_747_751_766_784_787_788_792_795_798_799_806_831_844_844_844_851_860_870_870_872_873_873_875_878_878_880_881_881_883_885_888_889_893_896_897_906_907_910_921_921_948_952_953_971_981_981_984_990_990_993_993_1009_1009_1015_1015_1020_1033_1033_1039_1052_1055_1055_1061_1066_1069_1073_1076_1080_1091_1099_1099_1124_1131_1145_1183_1186_1189_1192_1204_1217_1218_1220_1222_1232_1235_1259_1270_1270_1271_1273_1273_1274_1294_1298_1338_1342_1348_1394_1403_1411_1416_1418_1418_1418_1418_1418_1442_1447_1469_1470_1473_1473_1478_1485_,2020_2023_2037_2043_2045_2050_2053_2057_2059_2060_2060_2071_2072_2073_2077_2122_2122_2135_2135_2135_2146_2151_2154_2154_2162_2162_2179_2184_2190_2194_2211_2239_2247_2255_2257_2261_2263_2279_2283_2284_2284_2312_2312_2312_2315_2315_2315_2322_2322_2325_2326_2335_2338_2338_2342_2360_2360_2360_2360_2361_2361_2361_2361_2371_2372_2374_2375_2392_2414_2425_2428_2434_2434_2450_2450_2450_2453_2453_2453_2477_2483_2483_2483_2483_2492_2494_2494_2495_2495_2508_2515_2523_2541_2541_2543_2547_2567_2585_2589_2599_2601_2611_2613_2649_2669_2704_2709_2711_2714_2714_2718_2718_2721_2721_2731_2731_2731_2731_2734_2739_2739_2740_2752_2752_2752_2756_2756_2772_2776_2776_2799_2804_2815_2815_2815_2815_2815_2815_2815_2815_2815_2816_2818_2841_2846_2846_2861_2865_2866_2866_2867_2872_2881_2881_2881_2881_2889_2890_2907_2907_2908_2921_2925_2928_2933_2938_2946_2946_2951_2953_2954_2967_2976_3022_3023_3040_3046_3047_3050_3051_3069_3070_3076_3089_3093_3093_3096_3115_3115_3120_3125_3141_3171_3173_3177_3184_3207_3213_3218_3223_3232_3232_3232_3232_3239_3242_3270_3279_3294_3294_3308_3308_3327_3327_3329_3329_3329_3329_3332_3333_3345_3353_3355_3360_3364_3364_3379_3379_3382_3396_3415_3417_3417_3418_3418_3422_3431_3432_3433_3433_3433_3433_3435_3435_3435_3435_3459_3466_3470_3472_3472_3472_3484_3485_
2,3,大,Vi,503,449,952,2_3_6_6_7_12_40_40_42_45_49_51_52_52_52_54_56_57_59_61_62_65_65_67_68_72_72_74_75_81_87_91_99_100_101_104_107_109_110_115_115_117_125_133_157_157_158_161_162_162_163_164_166_167_167_168_169_172_175_175_175_176_176_176_186_196_201_203_207_209_213_213_218_223_223_227_241_247_247_247_248_248_248_251_257_257_257_258_258_258_266_275_276_278_281_285_286_286_289_290_291_299_308_312_322_328_333_341_341_351_361_374_376_376_379_380_383_391_391_392_395_396_396_397_407_408_411_413_417_422_431_431_433_433_434_434_434_434_434_436_437_438_439_441_442_443_450_458_466_467_470_471_474_475_478_478_482_487_487_491_495_495_499_499_500_503_515_515_516_517_517_517_520_521_521_521_522_527_529_530_530_530_531_536_545_546_546_550_552_553_555_555_559_561_562_571_573_580_588_590_599_608_611_616_620_625_628_628_630_640_668_670_675_676_678_678_697_707_707_710_711_717_717_720_721_728_732_732_739_742_742_742_749_749_750_751_753_754_755_757_762_766_771_775_779_780_784_787_788_788_790_792_795_798_799_804_806_808_808_809_814_815_815_818_820_821_822_822_822_823_825_825_826_827_828_830_831_834_842_844_855_856_864_865_870_870_871_871_871_873_873_874_875_878_878_879_879_879_881_881_882_883_885_886_886_887_888_891_893_894_894_895_896_899_906_907_910_910_913_915_917_921_922_922_922_928_929_930_930_930_934_936_937_943_943_948_950_952_953_971_977_978_980_980_981_981_981_984_990_993_1005_1005_1007_1009_1009_1020_1021_1023_1026_1033_1033_1033_1039_1040_1042_1050_1052_1055_1063_1064_1066_1068_1069_1072_1073_1073_1075_1076_1079_1080_1080_1081_1088_1091_1092_1093_1093_1094_1094_1095_1099_1099_1124_1131_1135_1139_1141_1143_1145_1145_1181_1181_1183_1186_1187_1187_1189_1192_1194_1204_1204_1211_1212_1213_1220_1222_1224_1226_1228_1228_1230_1230_1235_1243_1243_1247_1247_1249_1251_1251_1253_1254_1259_1261_1267_1269_1270_1270_1270_1271_1273_1273_1273_1274_1281_1288_1290_1293_1294_1295_1298_1299_1304_1304_1307_1307_1326_1328_1334_1337_1338_1342_1356_1358_1359_1361_1362_1364_1366_1377_1383_1386_1392_1401_1411_1416_1418_1418_1418_1425_1428_1429_1431_1440_1442_1445_1447_1450_1451_1465_1469_1469_1469_1470_1470_1470_1472_1473_1478_1485_1491_1494_,2008_2014_2023_2030_2031_2033_2033_2033_2035_2035_2035_2036_2037_2037_2037_2038_2039_2040_2041_2057_2059_2060_2062_2065_2073_2090_2101_2102_2108_2109_2122_2125_2126_2126_2128_2131_2133_2135_2135_2149_2162_2162_2163_2166_2177_2184_2191_2196_2197_2198_2205_2206_2206_2207_2211_2224_2225_2226_2232_2241_2252_2253_2260_2261_2263_2264_2264_2264_2266_2268_2273_2283_2284_2284_2292_2304_2305_2305_2305_2307_2308_2308_2308_2312_2312_2312_2315_2315_2315_2322_2322_2325_2338_2338_2356_2358_2359_2360_2360_2360_2360_2361_2361_2361_2361_2372_2375_2390_2412_2417_2425_2428_2432_2434_2435_2445_2446_2450_2450_2450_2453_2453_2453_2463_2465_2478_2489_2492_2492_2492_2492_2492_2494_2495_2505_2508_2510_2510_2511_2511_2516_2518_2521_2523_2525_2528_2535_2543_2544_2547_2556_2561_2562_2568_2575_2575_2578_2582_2589_2601_2608_2609_2609_2609_2609_2613_2613_2616_2621_2649_2652_2655_2656_2662_2665_2669_2671_2671_2671_2671_2671_2671_2680_2702_2703_2703_2704_2714_2718_2718_2718_2721_2721_2721_2730_2731_2731_2731_2731_2731_2734_2739_2740_2740_2747_2750_2753_2756_2756_2759_2761_2762_2766_2769_2770_2772_2775_2776_2780_2783_2784_2784_2785_2787_2789_2790_2790_2791_2795_2804_2807_2815_2815_2815_2815_2815_2815_2815_2824_2824_2826_2826_2829_2838_2841_2845_2846_2846_2847_2859_2861_2861_2861_2866_2866_2867_2868_2869_2872_2872_2881_2881_2881_2882_2884_2886_2889_2890_2898_2907_2907_2908_2908_2908_2919_2921_2923_2925_2925_2938_2938_2946_2946_2951_2953_2954_2954_2956_2957_2965_2966_2967_2996_2996_2998_3012_3013_3016_3020_3029_3031_3032_3033_3040_3040_3055_3056_3071_3074_3076_3076_3078_3083_3088_3095_3098_3099_3100_3103_3110_3119_3122_3124_3127_3146_3151_3171_3171_3173_3173_3177_3182_3183_3187_3187_3189_3189_3195_3198_3200_3202_3205_3210_3215_3223_3223_3225_3228_3229_3231_3231_3232_3232_3232_3232_3242_3242_3244_3246_3246_3255_3256_3257_3265_3269_3270_3270_3274_3279_3289_3289_3290_3290_3293_3294_3294_3304_3307_3308_3319_3319_3327_3327_3329_3332_3333_3333_3333_3333_3345_3347_3349_3358_3360_3364_3364_3364_3369_3370_3375_3375_3376_3377_3377_3378_3383_3384_3388_3389_3390_3396_3415_3417_3417_3417_3418_3433_3433_3433_3433_3433_3434_3435_3435_3435_3435_3435_3436_3437_3438_3443_3444_3459_3462_3466_3470_3472_3472_3472_3475_3480_3482_3484_3486_3489_3489_3491_3491_
2,3,寬,Vi,5,3,8,6_678_1033_1266_,2326_3418_
2,3,有,Vt,1054,1187,2241,4_4_6_8_8_10_12_12_16_16_17_35_39_41_41_42_47_47_47_50_51_51_52_52_55_60_63_63_67_67_69_70_70_74_74_76_77_79_81_81_81_81_82_83_85_87_87_87_87_88_91_91_91_91_94_101_103_104_106_108_109_109_110_111_111_112_116_119_119_121_122_122_127_127_129_130_130_133_137_142_145_145_147_148_148_149_150_150_155_155_157_157_158_159_162_162_162_162_163_163_164_167_167_167_167_168_168_169_172_172_173_175_175_176_176_186_186_187_196_196_197_198_201_201_203_204_204_207_207_209_210_210_213_217_217_218_223_223_226_226_226_226_227_227_227_228_229_231_231_238_242_242_242_246_246_248_248_252_252_252_253_253_256_256_258_258_271_272_272_275_275_276_276_276_276_277_277_281_281_282_284_286_287_287_289_295_295_295_303_303_303_308_312_316_316_320_321_321_322_323_326_327_328_331_332_333_334_334_334_335_338_339_340_341_341_341_341_342_342_345_345_345_346_348_351_352_352_355_355_355_356_361_362_364_364_364_367_369_369_369_373_374_374_374_375_381_384_388_388_390_390_391_391_391_394_395_395_396_408_411_412_412_413_413_418_419_422_424_424_427_434_434_434_437_439_441_442_465_468_469_469_470_472_473_473_474_477_480_481_481_481_482_482_482_482_486_489_491_491_491_491_494_498_499_503_504_517_520_520_520_521_521_521_522_522_524_529_529_529_530_530_530_531_531_533_540_540_540_540_540_543_546_546_546_546_546_546_546_547_550_551_551_551_551_553_553_554_554_555_555_555_555_555_555_555_556_559_560_560_560_560_562_562_563_563_571_572_573_580_581_588_594_596_597_599_600_603_605_608_609_611_613_620_622_629_629_630_630_631_631_631_632_632_634_634_640_641_641_642_642_644_648_649_649_649_654_655_655_655_657_657_663_663_663_669_669_669_669_670_670_670_672_672_674_674_675_676_677_677_677_683_684_685_686_690_691_697_707_707_707_708_708_709_710_710_710_710_710_710_710_710_711_713_714_714_714_716_716_717_717_717_718_718_719_720_720_720_720_720_720_720_720_721_723_724_724_724_726_726_728_736_738_739_742_742_743_745_750_753_753_753_765_766_770_771_771_773_774_775_775_777_780_780_780_782_782_783_783_783_783_787_787_787_788_788_789_790_792_793_794_796_797_799_802_802_802_803_803_804_804_813_813_814_814_815_815_818_820_820_820_820_822_822_823_823_827_828_828_830_833_835_835_835_835_835_835_835_835_835_836_837_837_838_839_842_842_842_842_844_844_844_846_846_848_849_851_853_855_856_856_856_856_856_856_856_856_857_857_857_858_859_859_860_862_864_865_865_865_865_865_865_865_865_866_866_866_867_868_868_870_870_875_875_878_878_883_883_885_885_885_886_886_886_886_886_886_886_887_887_887_888_889_889_889_889_889_889_889_889_889_889_889_891_891_891_891_892_893_893_893_894_894_894_894_894_894_894_895_895_895_896_897_897_897_897_897_897_897_897_897_897_897_899_899_899_899_900_901_903_904_906_906_906_910_910_910_912_912_915_917_917_919_922_923_924_924_930_931_932_932_935_940_941_943_943_944_946_956_960_962_964_964_964_967_967_968_972_973_974_980_982_982_982_982_983_984_990_990_991_993_993_994_995_996_1000_1005_1005_1005_1005_1005_1005_1005_1005_1005_1005_1005_1006_1007_1009_1014_1018_1022_1025_1025_1025_1030_1030_1030_1031_1032_1036_1037_1040_1040_1040_1041_1048_1048_1049_1049_1052_1054_1054_1054_1055_1055_1057_1057_1057_1058_1058_1060_1061_1062_1066_1067_1070_1070_1070_1070_1072_1074_1077_1077_1077_1077_1079_1082_1084_1087_1087_1088_1088_1088_1088_1088_1091_1091_1092_1093_1094_1097_1100_1100_1100_1105_1105_1105_1105_1106_1106_1106_1109_1109_1112_1112_1114_1117_1117_1120_1120_1124_1124_1125_1125_1127_1129_1131_1131_1132_1132_1134_1136_1141_1141_1143_1143_1149_1156_1164_1164_1164_1166_1166_1166_1171_1178_1181_1181_1186_1187_1187_1192_1201_1201_1201_1207_1211_1211_1211_1215_1219_1220_1221_1222_1233_1235_1236_1237_1238_1238_1238_1239_1239_1242_1242_1243_1243_1243_1244_1246_1246_1247_1247_1247_1248_1250_1250_1250_1250_1251_1251_1251_1251_1251_1254_1259_1261_1266_1267_1267_1270_1270_1271_1271_1272_1273_1273_1274_1274_1275_1276_1277_1277_1278_1278_1279_1279_1283_1284_1284_1285_1285_1286_1286_1304_1307_1311_1315_1316_1319_1321_1324_1326_1328_1328_1336_1337_1343_1343_1343_1345_1348_1348_1348_1349_1351_1352_1359_1359_1362_1364_1364_1366_1367_1367_1367_1371_1371_1375_1375_1375_1376_1376_1378_1378_1378_1384_1385_1399_1399_1399_1408_1409_1410_1411_1413_1415_1416_1418_1418_1418_1419_1419_1423_1423_1423_1423_1425_1425_1427_1429_1430_1430_1430_1431_1433_1435_1436_1437_1437_1438_1442_1443_1447_1448_1450_1454_1454_1455_1455_1457_1459_1462_1464_1467_1471_1472_1472_1472_1474_1477_1479_1479_1479_1479_1479_1481_1481_1484_1486_1486_1486_1486_1486_1488_1488_1491_1494_1495_1496_1498_1499_,2008_2009_2010_2012_2012_2014_2015_2015_2015_2016_2017_2017_2019_2029_2036_2036_2037_2037_2037_2037_2038_2039_2040_2041_2042_2044_2047_2048_2048_2048_2057_2058_2059_2059_2059_2065_2065_2066_2071_2081_2083_2086_2086_2090_2090_2090_2090_2090_2091_2092_2093_2093_2099_2099_2101_2102_2104_2106_2108_2108_2110_2110_2114_2117_2124_2125_2125_2126_2126_2127_2127_2131_2133_2134_2134_2135_2136_2136_2139_2139_2140_2140_2143_2143_2144_2145_2146_2148_2149_2151_2151_2155_2159_2161_2161_2162_2162_2162_2162_2162_2162_2163_2166_2167_2169_2170_2170_2175_2175_2175_2175_2175_2180_2183_2184_2190_2190_2190_2192_2195_2195_2196_2197_2198_2199_2205_2207_2211_2211_2212_2220_2220_2222_2222_2223_2225_2225_2226_2226_2228_2229_2231_2231_2232_2232_2232_2235_2236_2243_2246_2247_2249_2251_2252_2252_2252_2253_2253_2253_2258_2258_2258_2259_2259_2259_2260_2264_2266_2266_2266_2267_2269_2269_2271_2275_2278_2283_2283_2285_2287_2288_2290_2292_2294_2295_2295_2296_2299_2299_2302_2302_2305_2308_2309_2313_2313_2313_2316_2316_2316_2318_2318_2319_2319_2320_2322_2322_2324_2325_2326_2326_2327_2329_2332_2332_2335_2335_2340_2340_2341_2341_2342_2342_2342_2344_2344_2344_2347_2349_2349_2349_2358_2359_2359_2363_2363_2365_2370_2372_2372_2372_2373_2375_2375_2375_2378_2380_2380_2380_2384_2387_2387_2391_2391_2391_2391_2392_2392_2394_2394_2398_2399_2401_2405_2406_2406_2407_2408_2408_2411_2412_2412_2414_2417_2417_2419_2419_2419_2419_2425_2425_2425_2428_2428_2428_2432_2434_2434_2435_2436_2438_2438_2440_2440_2445_2445_2445_2445_2446_2446_2446_2446_2447_2448_2450_2450_2451_2453_2453_2454_2455_2459_2464_2466_2475_2475_2483_2483_2483_2483_2484_2484_2487_2487_2488_2488_2489_2490_2492_2492_2492_2492_2494_2495_2497_2498_2500_2500_2501_2501_2502_2505_2505_2508_2508_2509_2509_2509_2510_2510_2510_2510_2511_2511_2511_2511_2516_2516_2517_2517_2517_2517_2517_2518_2518_2519_2519_2519_2519_2519_2521_2522_2522_2522_2522_2528_2528_2528_2528_2528_2528_2528_2530_2531_2531_2531_2534_2534_2535_2537_2537_2538_2538_2540_2541_2541_2544_2544_2547_2547_2547_2549_2549_2549_2549_2549_2549_2550_2550_2550_2550_2550_2550_2551_2551_2551_2551_2551_2553_2553_2559_2561_2562_2565_2565_2567_2567_2571_2571_2571_2573_2577_2582_2582_2582_2585_2585_2587_2587_2589_2589_2594_2595_2596_2596_2597_2597_2599_2604_2606_2608_2608_2608_2609_2609_2610_2611_2611_2613_2613_2613_2613_2621_2621_2623_2623_2623_2625_2629_2629_2630_2634_2634_2636_2637_2637_2637_2638_2638_2638_2640_2641_2642_2645_2646_2647_2647_2649_2649_2649_2649_2651_2651_2651_2651_2654_2654_2654_2654_2659_2669_2669_2670_2671_2671_2671_2672_2680_2680_2680_2680_2683_2684_2686_2687_2689_2695_2695_2698_2698_2702_2707_2708_2714_2714_2714_2717_2717_2718_2718_2718_2718_2719_2720_2720_2721_2721_2721_2721_2722_2724_2724_2730_2730_2730_2730_2731_2731_2731_2731_2731_2735_2736_2739_2739_2740_2740_2741_2742_2742_2745_2746_2746_2746_2746_2747_2748_2750_2751_2753_2753_2754_2754_2754_2756_2756_2756_2756_2756_2757_2758_2759_2759_2759_2759_2761_2761_2762_2762_2764_2765_2767_2769_2769_2770_2770_2773_2775_2776_2776_2779_2780_2782_2782_2784_2791_2795_2795_2796_2799_2799_2806_2806_2807_2807_2807_2808_2809_2809_2812_2812_2815_2815_2815_2816_2816_2818_2818_2824_2826_2828_2828_2836_2838_2838_2841_2844_2845_2845_2847_2848_2848_2852_2855_2856_2857_2857_2858_2858_2861_2861_2861_2861_2861_2862_2862_2862_2863_2863_2863_2864_2864_2864_2864_2866_2867_2867_2869_2872_2872_2872_2873_2879_2880_2882_2883_2884_2886_2888_2888_2895_2898_2898_2899_2908_2908_2908_2909_2910_2911_2913_2914_2915_2916_2919_2919_2922_2924_2924_2924_2925_2926_2926_2927_2928_2928_2929_2931_2931_2932_2933_2933_2934_2934_2934_2934_2939_2940_2945_2945_2945_2945_2945_2946_2946_2946_2951_2951_2951_2958_2964_2967_2968_2969_2970_2972_2972_2974_2975_2976_2976_2978_2980_2980_2980_2983_2983_2983_2984_2984_2984_2987_2993_2994_2995_2995_2996_2997_2997_2998_2999_3001_3003_3003_3005_3012_3013_3013_3013_3013_3016_3016_3020_3022_3022_3023_3023_3029_3029_3030_3031_3032_3032_3033_3033_3037_3038_3038_3038_3038_3038_3038_3038_3038_3039_3039_3039_3039_3039_3039_3039_3039_3040_3041_3047_3049_3051_3054_3059_3062_3065_3067_3071_3071_3072_3073_3074_3074_3074_3074_3074_3074_3076_3076_3076_3076_3076_3077_3083_3083_3083_3083_3084_3084_3087_3091_3092_3095_3095_3096_3097_3098_3098_3098_3098_3099_3099_3101_3102_3103_3103_3103_3103_3104_3104_3105_3111_3115_3115_3119_3119_3124_3124_3132_3132_3132_3132_3132_3132_3146_3146_3146_3146_3150_3152_3152_3158_3160_3162_3170_3170_3170_3170_3171_3172_3172_3172_3172_3173_3174_3174_3174_3175_3175_3176_3176_3177_3177_3177_3180_3182_3183_3184_3186_3187_3188_3189_3194_3194_3195_3196_3196_3196_3196_3201_3201_3202_3202_3202_3202_3202_3202_3202_3202_3203_3204_3205_3206_3207_3207_3209_3210_3212_3213_3215_3217_3218_3223_3226_3226_3227_3227_3231_3231_3231_3231_3231_3231_3232_3233_3233_3237_3239_3239_3239_3241_3243_3243_3244_3246_3246_3246_3246_3247_3249_3252_3253_3253_3253_3253_3253_3253_3254_3255_3256_3257_3259_3260_3262_3263_3264_3266_3270_3272_3274_3276_3277_3282_3286_3288_3288_3293_3293_3295_3296_3297_3304_3308_3308_3308_3313_3313_3315_3317_3318_3318_3318_3318_3318_3318_3319_3319_3319_3319_3319_3319_3319_3327_3327_3327_3331_3333_3333_3333_3341_3341_3345_3345_3347_3353_3355_3357_3358_3360_3360_3360_3360_3360_3363_3363_3363_3366_3371_3371_3371_3371_3371_3371_3375_3376_3377_3378_3380_3385_3386_3388_3388_3389_3389_3390_3390_3391_3392_3392_3392_3393_3394_3394_3394_3395_3397_3397_3397_3397_3397_3397_3397_3405_3406_3410_3411_3414_3414_3415_3417_3418_3418_3418_3418_3419_3422_3423_3424_3427_3431_3431_3431_3431_3432_3432_3432_3432_3433_3433_3433_3433_3433_3433_3433_3433_3433_3433_3434_3434_3434_3434_3435_3435_3435_3435_3435_3435_3435_3435_3435_3435_3436_3436_3436_3436_3438_3445_3446_3446_3448_3448_3448_3448_3448_3448_3450_3453_3453_3453_3453_3453_3453_3454_3454_3454_3455_3458_3459_3459_3459_3466_3466_3466_3466_3466_3466_3470_3470_3470_3470_3470_3473_3476_3476_3477_3477_3479_3480_3481_3482_3483_3487_3487_3488_3488_3488_3489_3490_3490_3490_3491_
2,3,房,N,127,247,374,3_6_7_50_115_115_115_115_133_162_162_167_167_172_186_186_196_196_213_218_245_255_263_275_277_282_322_342_352_380_383_391_396_397_408_431_434_481_499_500_521_522_522_530_531_531_568_577_597_600_609_611_620_675_675_736_743_753_753_766_771_775_788_792_835_870_870_873_873_878_878_881_881_889_897_916_929_937_952_953_964_981_990_993_1022_1022_1039_1050_1066_1069_1076_1091_1098_1100_1105_1124_1131_1186_1192_1204_1212_1215_1219_1221_1235_1243_1247_1294_1298_1311_1315_1338_1339_1342_1356_1361_1409_1418_1418_1430_1442_1447_1477_1484_1498_1499_,2015_2016_2016_2023_2026_2037_2038_2040_2047_2047_2047_2060_2061_2065_2066_2073_2078_2079_2090_2099_2099_2104_2122_2136_2140_2144_2145_2162_2162_2162_2166_2170_2175_2177_2186_2211_2211_2258_2259_2261_2261_2261_2263_2263_2263_2269_2269_2272_2273_2284_2284_2284_2284_2284_2284_2290_2312_2312_2312_2312_2315_2315_2315_2315_2338_2338_2342_2342_2360_2360_2360_2360_2361_2361_2361_2361_2363_2364_2372_2372_2375_2375_2416_2416_2417_2425_2428_2450_2453_2477_2487_2488_2492_2503_2517_2519_2547_2571_2582_2589_2594_2594_2607_2613_2639_2682_2685_2704_2718_2721_2731_2731_2731_2731_2731_2731_2740_2740_2743_2751_2775_2775_2776_2836_2836_2836_2841_2841_2841_2846_2846_2846_2846_2846_2861_2861_2866_2866_2869_2873_2873_2879_2880_2881_2881_2881_2884_2886_2889_2890_2907_2907_2921_2923_2923_2924_2925_2933_2946_2946_2958_2972_2976_2995_3032_3033_3038_3039_3044_3048_3122_3127_3129_3130_3141_3141_3144_3165_3170_3172_3177_3177_3184_3186_3186_3186_3186_3188_3188_3188_3188_3213_3213_3213_3218_3218_3218_3232_3232_3239_3242_3246_3266_3267_3270_3279_3281_3294_3309_3338_3341_3341_3350_3364_3364_3364_3367_3367_3368_3368_3371_3386_3417_3418_3433_3433_3433_3433_3433_3433_3433_3435_3435_3435_3435_3435_3435_3435_3462_3462_3463_3466_3467_3472_3473_3478_
2,3,實惠,Vi,28,4,32,6_100_184_194_218_227_276_425_426_462_519_539_572_581_820_907_921_942_965_973_1030_1040_1110_1118_1320_1325_1362_,2133_2996_3364_
2,3,不錯,Vi,977,156,1133,3_4_6_7_8_10_12_18_23_25_26_31_33_34_35_42_44_44_45_47_51_51_51_53_55_56_58_60_61_64_65_66_67_68_69_69_71_72_73_74_75_76_76_77_78_81_82_83_84_87_88_89_91_93_94_96_101_101_102_104_104_107_107_107_108_108_109_111_111_111_112_112_114_116_118_123_123_126_131_131_134_135_135_142_148_148_150_150_152_154_154_155_155_156_157_158_159_162_163_163_164_164_167_168_168_169_169_171_174_175_176_180_180_183_186_186_186_190_190_193_196_196_196_198_199_200_203_204_204_205_206_209_210_210_212_214_214_215_217_217_218_218_224_228_229_232_236_237_237_245_246_248_248_248_253_253_255_256_258_258_258_263_267_268_271_277_279_283_284_285_286_287_287_288_288_291_295_296_296_297_298_298_299_303_304_304_305_306_306_307_308_308_309_311_312_312_313_320_320_322_322_323_325_328_330_333_334_335_338_339_341_342_348_349_351_352_359_361_362_364_365_366_367_369_370_371_374_374_375_375_376_379_386_386_388_389_390_391_391_391_391_393_395_397_398_399_401_402_404_405_405_406_407_407_409_410_411_413_417_419_419_422_422_424_427_430_431_433_434_434_435_437_438_439_439_440_441_442_446_447_448_450_454_455_456_458_460_461_465_465_470_471_474_475_480_480_483_484_484_484_489_489_492_493_493_493_496_500_500_500_503_508_510_510_512_515_519_521_522_522_522_524_524_525_526_526_528_530_531_531_531_533_533_534_535_535_537_539_541_543_546_546_546_546_546_547_547_552_552_553_555_555_555_555_555_556_556_561_561_562_565_567_571_574_576_580_582_582_583_583_584_584_584_591_599_608_612_612_615_617_618_621_621_624_626_627_628_628_628_629_629_630_630_632_632_641_641_642_645_648_649_650_651_654_655_656_657_659_660_661_662_668_668_669_669_670_670_672_675_676_677_679_684_686_688_688_691_693_693_695_699_701_702_707_709_713_713_713_713_717_719_723_723_723_723_727_729_733_733_734_735_738_739_745_745_745_747_749_749_751_751_752_753_754_755_756_757_758_759_760_762_763_764_766_767_767_769_770_771_772_774_775_776_778_779_780_782_783_783_786_791_792_792_794_795_797_798_799_800_800_802_802_804_804_806_808_809_809_814_814_814_814_814_815_816_818_818_818_820_825_826_830_831_831_832_833_834_835_841_841_842_847_848_849_855_856_857_864_865_866_872_873_875_880_881_883_885_886_887_888_888_889_890_891_892_892_893_894_895_896_896_897_898_899_900_900_903_903_906_907_907_910_910_912_912_913_913_915_916_916_917_918_921_921_929_935_937_939_940_940_941_942_943_945_945_946_946_947_948_951_952_953_954_955_956_959_961_962_964_966_967_967_968_969_970_970_971_974_978_981_982_983_985_987_987_988_989_989_992_992_998_1000_1003_1004_1006_1009_1010_1010_1011_1012_1013_1014_1015_1020_1020_1022_1026_1028_1029_1033_1037_1038_1038_1039_1043_1045_1049_1055_1058_1058_1058_1060_1063_1064_1066_1070_1070_1070_1071_1073_1077_1077_1077_1078_1080_1081_1082_1082_1084_1084_1088_1088_1088_1088_1090_1090_1091_1091_1091_1092_1095_1096_1098_1099_1099_1099_1099_1100_1103_1105_1106_1106_1107_1108_1110_1111_1113_1114_1114_1114_1114_1114_1116_1118_1119_1121_1125_1129_1129_1132_1136_1136_1138_1139_1139_1140_1140_1141_1141_1141_1142_1143_1143_1143_1144_1145_1146_1147_1148_1149_1151_1151_1152_1154_1154_1155_1156_1158_1158_1159_1161_1161_1162_1163_1164_1164_1165_1166_1166_1169_1170_1171_1172_1172_1172_1176_1177_1178_1179_1179_1179_1182_1184_1188_1190_1193_1199_1199_1201_1206_1207_1209_1211_1213_1218_1218_1224_1226_1227_1228_1228_1229_1230_1230_1231_1239_1243_1247_1249_1249_1250_1250_1251_1251_1251_1254_1254_1255_1256_1257_1257_1258_1259_1266_1268_1270_1273_1277_1278_1279_1280_1281_1281_1284_1285_1286_1287_1288_1288_1293_1296_1297_1300_1301_1302_1303_1305_1306_1308_1309_1311_1311_1312_1313_1315_1315_1316_1316_1316_1316_1317_1318_1320_1321_1321_1321_1321_1322_1323_1325_1327_1330_1330_1331_1332_1333_1333_1334_1335_1336_1337_1338_1338_1340_1343_1343_1345_1347_1348_1348_1349_1351_1352_1358_1362_1377_1378_1378_1383_1385_1385_1386_1386_1391_1392_1393_1394_1395_1396_1397_1397_1398_1398_1399_1400_1401_1402_1403_1404_1405_1406_1406_1407_1407_1410_1411_1412_1415_1416_1417_1418_1421_1423_1425_1426_1428_1428_1431_1431_1431_1433_1435_1437_1438_1439_1440_1444_1445_1450_1451_1451_1453_1454_1455_1455_1456_1465_1469_1470_1472_1473_1474_1475_1475_1476_1477_1478_1478_1478_1479_1479_1482_1482_1483_1484_1485_1485_1485_1486_1486_1489_1492_1498_1498_1498_1498_,2012_2012_2060_2091_2091_2091_2092_2092_2092_2126_2155_2163_2206_2235_2236_2239_2260_2273_2278_2289_2324_2326_2356_2362_2368_2369_2389_2395_2404_2412_2438_2440_2445_2446_2450_2453_2454_2455_2471_2499_2500_2501_2510_2511_2522_2525_2525_2525_2531_2537_2537_2538_2538_2547_2572_2606_2618_2636_2683_2686_2691_2705_2706_2718_2718_2721_2721_2742_2748_2756_2774_2787_2789_2805_2806_2815_2821_2822_2822_2844_2846_2848_2855_2856_2857_2858_2883_2889_2890_2895_2902_2904_2906_2908_2908_2913_2933_2938_2938_2939_2940_2948_2967_2970_2977_2983_2984_2998_3013_3014_3038_3039_3042_3065_3067_3074_3146_3148_3152_3153_3162_3164_3167_3175_3176_3178_3184_3184_3198_3198_3200_3200_3213_3218_3222_3237_3253_3254_3304_3318_3347_3357_3360_3360_3365_3389_3390_3413_3417_3417_3422_3438_3443_3466_3471_
2,3,整體,N,40,19,59,6_119_127_134_186_196_213_217_229_293_301_326_331_495_499_552_561_772_776_906_1010_1010_1084_1089_1092_1114_1124_1125_1129_1129_1131_1132_1136_1136_1148_1254_1338_1433_1435_,2161_2169_2180_2219_2221_2414_2584_2599_2606_2671_2691_2883_3077_3177_3293_3359_3369_3370_
3,3,要,ADV,218,680,898,4_4_7_8_8_35_64_66_67_67_68_68_71_73_74_74_75_75_91_91_103_103_108_109_112_120_122_124_128_130_132_142_152_163_168_182_182_183_184_192_192_193_194_203_209_213_229_270_272_272_272_272_278_281_290_321_338_340_373_379_379_391_395_408_414_418_424_424_434_445_450_451_453_458_459_461_465_467_515_520_521_526_529_530_535_540_573_591_593_593_600_602_602_609_610_614_619_623_662_674_675_675_680_695_698_699_701_701_704_706_707_710_711_711_716_717_720_721_721_726_745_753_786_786_816_817_835_835_841_854_857_863_866_870_878_885_885_886_889_889_889_889_893_893_894_897_897_897_897_903_903_938_939_943_949_964_966_978_980_982_1003_1009_1025_1048_1049_1049_1053_1058_1084_1088_1091_1112_1120_1124_1131_1169_1176_1201_1203_1212_1239_1240_1243_1247_1253_1253_1308_1312_1326_1334_1334_1347_1348_1352_1359_1359_1364_1364_1374_1383_1408_1413_1423_1423_1425_1425_1472_1472_1472_1473_1473_1490_1490_1491_1493_1493_1494_,2009_2015_2030_2031_2037_2037_2038_2039_2040_2041_2042_2042_2047_2059_2062_2065_2066_2070_2070_2071_2071_2071_2072_2073_2074_2081_2081_2081_2081_2081_2083_2083_2083_2083_2083_2084_2085_2090_2095_2097_2099_2099_2099_2103_2104_2108_2124_2124_2126_2126_2127_2135_2136_2136_2137_2137_2139_2139_2140_2140_2141_2141_2143_2143_2154_2154_2161_2161_2161_2162_2162_2162_2162_2162_2168_2169_2170_2171_2171_2175_2179_2193_2195_2195_2197_2208_2209_2210_2215_2229_2229_2229_2229_2229_2231_2231_2231_2231_2231_2232_2232_2239_2240_2240_2244_2245_2252_2252_2252_2252_2252_2253_2253_2253_2253_2253_2255_2257_2258_2259_2264_2264_2264_2266_2266_2272_2272_2272_2272_2272_2273_2273_2276_2283_2284_2287_2288_2290_2293_2294_2295_2295_2296_2298_2298_2299_2299_2301_2301_2302_2302_2312_2315_2318_2318_2319_2319_2322_2324_2333_2333_2334_2334_2338_2338_2342_2342_2354_2355_2359_2360_2360_2360_2360_2361_2361_2361_2361_2372_2375_2377_2380_2384_2384_2387_2388_2390_2390_2391_2393_2399_2401_2412_2416_2417_2426_2438_2440_2445_2445_2446_2446_2447_2450_2450_2453_2453_2459_2459_2462_2462_2480_2480_2483_2484_2493_2512_2514_2515_2516_2516_2516_2518_2518_2518_2522_2525_2531_2532_2533_2534_2540_2547_2549_2549_2549_2549_2549_2549_2549_2550_2550_2550_2550_2550_2550_2550_2551_2553_2554_2555_2558_2563_2564_2564_2565_2565_2573_2579_2582_2582_2587_2595_2603_2603_2604_2604_2604_2604_2605_2605_2606_2606_2606_2606_2606_2609_2609_2615_2615_2615_2616_2623_2625_2632_2633_2637_2638_2649_2650_2653_2674_2688_2690_2695_2695_2698_2698_2698_2700_2701_2703_2704_2707_2707_2708_2708_2719_2722_2731_2731_2731_2731_2731_2731_2734_2739_2739_2742_2745_2746_2746_2746_2747_2752_2754_2754_2754_2761_2762_2767_2767_2769_2769_2769_2769_2770_2770_2770_2770_2773_2773_2773_2775_2775_2776_2784_2787_2787_2789_2789_2791_2791_2798_2800_2806_2812_2815_2824_2824_2824_2824_2826_2826_2826_2826_2827_2828_2835_2837_2838_2842_2842_2843_2843_2846_2846_2846_2846_2846_2846_2846_2847_2847_2852_2853_2861_2861_2864_2876_2881_2881_2893_2902_2904_2914_2914_2917_2919_2919_2923_2925_2933_2934_2934_2939_2939_2940_2940_2946_2947_2953_2964_2967_2972_2972_2972_2972_2973_2974_2975_2976_2979_2980_2986_2987_2988_2995_2999_3001_3013_3029_3029_3031_3032_3032_3033_3033_3034_3038_3038_3039_3039_3049_3055_3055_3071_3072_3074_3074_3074_3083_3083_3083_3083_3084_3089_3098_3099_3103_3103_3103_3107_3116_3117_3118_3118_3118_3119_3124_3129_3129_3129_3130_3130_3130_3132_3144_3144_3146_3150_3158_3158_3161_3163_3163_3163_3167_3170_3170_3172_3172_3174_3184_3184_3184_3184_3185_3185_3186_3186_3188_3188_3193_3193_3195_3195_3196_3205_3210_3213_3215_3218_3220_3221_3225_3226_3226_3227_3231_3232_3232_3232_3242_3242_3245_3245_3249_3249_3253_3253_3253_3253_3253_3253_3254_3254_3255_3255_3255_3255_3256_3256_3256_3256_3257_3257_3264_3264_3264_3264_3266_3267_3268_3270_3277_3277_3279_3279_3281_3281_3283_3288_3288_3288_3289_3290_3291_3291_3291_3292_3292_3292_3294_3296_3296_3307_3308_3310_3312_3319_3319_3321_3322_3327_3329_3333_3333_3333_3333_3333_3337_3347_3347_3349_3350_3351_3352_3353_3353_3354_3355_3355_3360_3360_3360_3360_3363_3364_3364_3373_3373_3374_3374_3379_3379_3391_3392_3393_3394_3397_3397_3397_3399_3409_3409_3413_3413_3413_3413_3414_3418_3431_3431_3432_3432_3433_3433_3433_3433_3433_3433_3434_3434_3434_3435_3435_3435_3435_3435_3435_3436_3436_3436_3443_3443_3445_3447_3448_3448_3452_3453_3453_3457_3458_3460_3462_3465_3466_3473_3477_3478_3478_3478_3489_3489_3491_3491_3499_
3,3,價格,N,252,261,513,3_4_7_7_8_17_22_23_24_30_31_32_55_60_69_76_89_91_109_111_114_114_116_116_118_119_126_127_140_150_162_163_167_168_176_184_194_198_203_209_227_245_245_246_255_255_256_274_286_290_290_295_297_303_305_307_309_311_313_315_318_320_320_322_334_343_346_353_356_376_391_395_401_414_423_425_426_427_432_433_444_444_445_448_449_449_449_450_452_452_453_456_457_457_457_458_462_470_470_474_474_476_483_485_492_519_539_544_546_546_551_555_555_560_572_581_584_584_610_619_640_641_649_655_686_691_715_725_753_753_764_771_775_783_802_808_818_819_841_842_842_846_885_885_887_887_888_893_893_895_895_896_905_905_912_920_921_923_923_931_931_959_967_969_971_983_983_988_989_989_991_992_992_994_1002_1003_1009_1011_1012_1014_1015_1038_1045_1051_1051_1056_1060_1067_1074_1081_1082_1093_1094_1095_1110_1114_1118_1124_1127_1127_1131_1134_1134_1142_1144_1149_1149_1152_1156_1156_1159_1193_1195_1195_1198_1198_1201_1201_1204_1204_1213_1214_1235_1242_1246_1257_1259_1259_1261_1293_1293_1311_1315_1326_1326_1329_1331_1337_1341_1349_1359_1364_1371_1398_1407_1428_1436_1451_1453_1455_1498_,2012_2022_2024_2057_2060_2064_2065_2069_2071_2071_2074_2086_2089_2101_2102_2112_2122_2123_2131_2133_2136_2139_2140_2143_2153_2161_2177_2178_2186_2207_2212_2213_2232_2246_2249_2251_2255_2257_2266_2266_2266_2277_2277_2279_2281_2282_2295_2295_2295_2295_2295_2298_2301_2342_2359_2365_2385_2386_2390_2400_2402_2409_2410_2412_2412_2457_2463_2465_2480_2498_2506_2507_2522_2522_2522_2522_2523_2544_2549_2550_2564_2567_2571_2588_2595_2604_2604_2604_2606_2612_2621_2623_2629_2634_2634_2656_2659_2681_2688_2688_2690_2700_2701_2702_2703_2707_2708_2713_2723_2731_2745_2748_2750_2750_2750_2750_2750_2750_2750_2750_2750_2750_2757_2758_2768_2783_2790_2790_2790_2791_2793_2804_2824_2826_2834_2836_2838_2838_2839_2851_2855_2856_2860_2861_2864_2868_2881_2883_2885_2887_2893_2895_2908_2913_2922_2930_2934_2938_2949_2965_2966_2975_2978_2996_2997_3011_3011_3013_3020_3032_3033_3090_3091_3095_3098_3099_3099_3099_3099_3099_3099_3100_3115_3115_3115_3115_3146_3146_3162_3163_3175_3176_3187_3189_3209_3214_3219_3227_3231_3231_3231_3244_3252_3255_3256_3260_3260_3267_3273_3282_3300_3303_3308_3308_3308_3308_3308_3313_3313_3318_3319_3319_3326_3327_3335_3336_3344_3345_3349_3360_3363_3363_3364_3364_3364_3364_3364_3364_3365_3371_3376_3378_3391_3393_3401_3414_3420_3422_3437_3452_3454_3457_3463_3467_3489_3489_3489_3491_3491_3491_
3,3,說,Vt,291,869,1160,4_7_8_43_44_51_91_100_112_119_127_140_151_152_161_166_173_178_186_186_186_187_188_196_196_196_197_198_217_217_224_229_229_234_238_246_246_248_256_256_258_269_278_279_281_282_287_287_308_312_316_320_322_339_363_364_365_368_369_370_374_388_390_391_396_407_410_413_417_422_424_434_434_434_434_434_435_460_460_462_462_465_471_475_477_481_482_486_491_494_504_511_520_529_554_563_584_584_585_592_599_599_601_608_608_612_621_630_630_630_630_630_630_630_630_631_644_646_652_662_668_668_669_670_700_702_707_710_710_710_714_714_717_720_720_720_724_724_728_732_736_738_738_743_745_756_756_758_758_779_783_783_784_787_788_788_789_792_793_796_808_814_830_842_842_857_866_870_871_872_873_876_878_879_880_881_884_887_887_887_887_888_889_889_890_895_895_895_895_896_897_897_898_902_902_906_907_912_912_912_913_917_925_933_939_940_945_945_963_970_988_1001_1005_1005_1005_1010_1010_1011_1019_1020_1020_1020_1020_1020_1020_1039_1054_1057_1057_1060_1061_1073_1080_1083_1089_1102_1115_1124_1124_1131_1131_1163_1164_1165_1166_1181_1187_1211_1218_1244_1248_1251_1259_1272_1272_1272_1275_1275_1275_1281_1288_1319_1319_1324_1324_1328_1329_1336_1337_1348_1348_1350_1352_1352_1355_1356_1360_1361_1366_1378_1393_1399_1402_1409_1428_1436_1451_1473_1473_1499_,2009_2012_2015_2015_2016_2016_2018_2030_2031_2036_2036_2037_2037_2037_2037_2037_2038_2038_2039_2040_2040_2041_2042_2043_2045_2047_2047_2050_2051_2053_2054_2058_2059_2066_2072_2072_2081_2081_2081_2081_2081_2081_2081_2081_2081_2083_2083_2083_2083_2083_2083_2083_2083_2083_2086_2089_2090_2095_2097_2099_2099_2099_2101_2102_2104_2107_2126_2127_2128_2131_2133_2134_2134_2134_2139_2143_2144_2145_2149_2149_2154_2154_2158_2161_2161_2162_2175_2175_2175_2175_2186_2186_2192_2193_2195_2197_2198_2209_2209_2210_2210_2211_2211_2225_2226_2228_2229_2231_2231_2231_2232_2239_2242_2252_2253_2269_2273_2276_2283_2284_2287_2287_2288_2288_2293_2294_2295_2295_2296_2313_2314_2314_2316_2317_2317_2322_2326_2333_2334_2338_2340_2341_2342_2342_2342_2360_2360_2360_2360_2360_2360_2360_2361_2361_2361_2361_2361_2361_2361_2372_2372_2372_2375_2375_2375_2377_2378_2387_2387_2390_2390_2391_2391_2391_2392_2400_2402_2411_2411_2416_2416_2418_2424_2436_2436_2445_2445_2445_2445_2445_2446_2446_2446_2446_2446_2450_2452_2452_2452_2453_2454_2454_2454_2455_2455_2455_2457_2457_2458_2483_2483_2483_2483_2494_2494_2495_2495_2497_2502_2503_2508_2521_2521_2525_2525_2525_2526_2527_2527_2528_2528_2528_2529_2531_2531_2531_2531_2532_2532_2533_2533_2536_2541_2543_2543_2548_2549_2549_2549_2549_2549_2550_2550_2550_2550_2550_2551_2552_2553_2553_2554_2554_2554_2555_2555_2555_2559_2565_2565_2565_2567_2572_2573_2573_2582_2582_2582_2584_2585_2587_2589_2598_2599_2601_2604_2608_2608_2609_2609_2609_2609_2615_2616_2631_2632_2633_2637_2637_2638_2638_2639_2640_2640_2642_2646_2657_2657_2658_2662_2669_2671_2671_2672_2679_2680_2680_2681_2698_2705_2706_2707_2707_2708_2708_2710_2712_2714_2715_2716_2717_2718_2720_2721_2730_2731_2731_2731_2731_2731_2731_2731_2739_2739_2739_2739_2740_2740_2742_2744_2746_2746_2746_2746_2746_2746_2746_2746_2746_2746_2746_2746_2746_2746_2748_2753_2754_2757_2758_2759_2759_2765_2767_2767_2767_2767_2769_2769_2769_2770_2770_2770_2771_2772_2775_2775_2775_2775_2775_2775_2777_2782_2783_2784_2784_2787_2789_2791_2794_2796_2796_2798_2800_2803_2803_2806_2807_2809_2809_2809_2812_2816_2816_2817_2818_2818_2819_2822_2824_2824_2824_2824_2826_2826_2826_2826_2828_2828_2828_2836_2836_2838_2846_2846_2847_2853_2853_2857_2857_2858_2858_2861_2861_2861_2861_2862_2864_2864_2864_2867_2869_2869_2869_2870_2879_2880_2881_2881_2883_2884_2886_2889_2890_2892_2902_2902_2904_2904_2906_2914_2914_2941_2945_2945_2946_2946_2956_2956_2956_2956_2957_2957_2957_2957_2958_2958_2964_2968_2968_2968_2972_2972_2976_2980_2987_2988_2993_2994_2997_3000_3001_3001_3001_3001_3005_3009_3010_3013_3014_3014_3019_3020_3024_3026_3029_3030_3031_3031_3032_3032_3033_3033_3038_3038_3038_3039_3039_3039_3047_3049_3051_3054_3055_3055_3063_3073_3074_3074_3076_3087_3088_3088_3095_3096_3101_3103_3103_3105_3105_3107_3110_3115_3115_3115_3118_3119_3119_3124_3124_3129_3129_3130_3130_3132_3132_3141_3142_3142_3146_3147_3149_3158_3158_3158_3159_3159_3159_3159_3159_3163_3167_3174_3174_3175_3176_3180_3181_3184_3184_3184_3184_3184_3184_3184_3184_3184_3184_3185_3186_3186_3186_3188_3188_3188_3193_3194_3195_3195_3196_3196_3196_3196_3196_3196_3202_3202_3204_3205_3205_3205_3210_3210_3213_3215_3215_3218_3226_3226_3226_3227_3227_3227_3231_3231_3231_3231_3231_3231_3232_3232_3232_3233_3234_3237_3239_3239_3239_3239_3242_3243_3243_3249_3253_3253_3253_3253_3254_3254_3254_3255_3255_3255_3255_3256_3256_3256_3256_3257_3257_3264_3264_3264_3271_3272_3274_3274_3274_3279_3281_3281_3281_3281_3281_3281_3281_3281_3281_3281_3288_3289_3289_3289_3289_3289_3290_3290_3290_3290_3290_3291_3291_3291_3291_3292_3292_3292_3292_3295_3296_3296_3304_3308_3308_3308_3308_3308_3308_3313_3313_3313_3319_3319_3320_3324_3327_3327_3327_3329_3329_3333_3337_3337_3349_3351_3351_3360_3360_3360_3360_3360_3361_3362_3363_3363_3365_3367_3368_3373_3374_3376_3378_3388_3388_3397_3397_3397_3397_3397_3405_3410_3415_3418_3418_3419_3423_3424_3429_3433_3433_3433_3433_3433_3433_3433_3433_3433_3433_3433_3433_3433_3433_3433_3433_3433_3433_3433_3433_3433_3433_3433_3433_3433_3433_3433_3433_3433_3433_3433_3433_3433_3433_3433_3434_3434_3434_3435_3435_3435_3435_3435_3435_3435_3435_3435_3435_3435_3435_3435_3435_3435_3435_3435_3435_3435_3435_3435_3435_3435_3435_3435_3435_3435_3435_3435_3435_3435_3435_3435_3435_3435_3436_3436_3436_3438_3443_3443_3443_3446_3448_3448_3453_3453_3458_3460_3460_3462_3463_3463_3463_3466_3470_3470_3477_3478_3487_3487_3487_3487_3487_
3,3,加班,Vi,2,1,3,7_,
3,3,這裡,N,119,105,224,7_12_38_51_51_51_151_186_196_212_222_240_250_267_309_313_316_341_374_394_401_407_407_427_431_434_436_442_482_484_491_493_494_501_509_520_521_529_530_569_578_629_630_630_677_707_716_716_716_717_726_726_726_739_769_790_795_798_808_820_823_828_848_872_880_892_900_925_933_946_951_964_965_974_974_979_999_1005_1005_1009_1067_1073_1074_1080_1081_1082_1098_1112_1120_1152_1159_1168_1175_1208_1208_1211_1211_1211_1311_1315_1318_1323_1326_1340_1342_1345_1352_1421_1423_1442_1447_1461_1466_1471_1475_1482_1499_1500_,2005_2023_2038_2040_2049_2051_2052_2054_2061_2069_2104_2104_2106_2112_2158_2161_2232_2249_2251_2252_2253_2276_2283_2284_2309_2313_2316_2323_2426_2439_2442_2509_2509_2515_2521_2522_2541_2543_2547_2564_2571_2592_2606_2606_2637_2638_2698_2698_2742_2748_2766_2771_2816_2818_2828_2867_2872_2872_2885_2887_2897_2934_2960_2962_2968_3031_3055_3074_3074_3076_3107_3112_3160_3163_3163_3166_3167_3195_3202_3222_3231_3276_3289_3290_3298_3301_3334_3349_3392_3394_3405_3410_3420_3434_3436_3443_3445_3445_3471_3485_3488_3488_3490_3490_
3,3,想想,Vt,3,14,17,7_1088_,2531_2746_2863_2956_2957_3038_3039_3231_3232_3289_3290_3298_3301_
3,3,也,ADV,911,1020,1931,4_7_8_9_11_20_22_23_24_28_30_31_32_35_35_37_39_41_41_41_42_44_47_50_51_51_52_56_61_65_65_65_65_66_67_67_72_72_72_72_73_74_74_77_78_79_81_81_81_83_84_85_87_87_87_91_92_92_95_99_100_102_103_105_107_107_107_108_110_111_112_112_114_116_116_118_118_118_123_123_126_126_126_131_131_135_137_139_144_145_146_147_149_150_152_152_155_157_157_158_158_159_160_161_161_163_163_164_164_166_166_168_168_169_169_171_172_175_176_183_184_185_185_186_186_186_186_187_193_194_195_195_196_196_196_196_197_199_204_205_210_211_212_213_213_213_215_218_219_219_219_219_222_223_225_226_227_232_236_237_237_238_242_242_242_242_244_247_247_248_248_252_252_252_252_253_253_254_257_257_258_258_266_266_268_274_275_276_276_278_279_286_286_287_293_298_301_306_307_308_311_312_315_316_316_318_320_320_324_326_328_331_333_334_334_336_337_338_338_339_344_346_348_348_354_356_364_366_369_371_374_374_375_376_378_380_383_386_386_387_389_391_391_391_395_395_397_402_403_406_406_407_410_410_410_411_411_420_422_427_430_435_439_461_461_462_465_468_471_472_475_480_481_482_489_491_495_497_498_499_500_501_506_508_515_521_521_524_524_524_526_526_530_530_533_533_533_535_535_539_539_540_540_543_546_550_551_551_555_559_560_560_567_570_571_573_576_579_580_584_585_591_592_593_593_596_601_602_602_605_611_614_617_620_623_626_629_629_630_630_630_630_630_630_630_632_636_636_638_638_642_644_649_655_660_662_662_662_663_666_667_668_669_669_672_676_678_688_689_693_694_700_700_701_707_707_708_710_711_713_713_714_717_717_718_720_721_723_723_724_727_727_733_735_735_736_739_740_745_745_746_746_746_747_751_754_755_755_756_757_757_758_762_762_762_762_767_779_780_780_780_782_783_783_784_784_786_786_786_787_787_787_788_790_793_796_799_800_803_804_804_804_806_812_812_813_814_814_814_814_814_814_814_814_818_818_820_822_823_826_826_828_828_830_831_834_834_835_835_835_835_835_835_839_839_841_841_841_842_842_842_842_842_842_842_842_843_845_846_847_847_854_856_856_857_857_859_859_863_865_865_866_866_868_868_870_870_872_875_876_878_878_880_883_884_886_886_886_886_886_886_887_887_887_887_887_887_887_887_887_887_889_889_890_891_894_894_894_894_894_894_895_895_895_895_895_895_895_895_895_895_897_897_898_899_902_903_906_907_907_907_907_907_910_910_910_910_912_912_912_913_913_915_916_917_917_918_919_921_921_921_921_923_923_924_924_924_924_928_929_931_931_932_932_932_932_935_936_937_940_940_942_943_947_950_958_962_962_962_968_972_973_974_974_978_979_981_981_983_995_996_1005_1005_1008_1008_1009_1011_1011_1018_1020_1020_1029_1031_1039_1043_1043_1045_1049_1049_1050_1051_1054_1054_1054_1056_1056_1056_1057_1057_1067_1068_1069_1070_1070_1072_1073_1073_1074_1075_1076_1077_1077_1079_1080_1080_1081_1081_1083_1083_1084_1087_1087_1088_1088_1088_1088_1090_1091_1091_1091_1091_1091_1091_1092_1092_1092_1093_1094_1099_1105_1105_1107_1107_1109_1110_1115_1117_1118_1124_1131_1140_1141_1141_1143_1143_1145_1148_1148_1149_1151_1154_1156_1158_1161_1164_1166_1170_1171_1172_1173_1177_1178_1179_1180_1181_1184_1186_1187_1190_1192_1199_1202_1203_1206_1206_1208_1211_1213_1213_1213_1213_1213_1223_1224_1225_1226_1228_1228_1228_1228_1230_1230_1230_1230_1242_1242_1243_1243_1243_1244_1246_1246_1247_1247_1247_1248_1249_1250_1250_1254_1257_1257_1259_1259_1259_1267_1267_1270_1270_1271_1273_1273_1274_1277_1278_1279_1280_1281_1282_1284_1285_1286_1287_1288_1289_1296_1297_1300_1301_1302_1304_1304_1305_1307_1307_1311_1311_1311_1315_1315_1315_1316_1318_1319_1319_1320_1321_1323_1324_1324_1325_1326_1328_1328_1328_1328_1329_1335_1336_1337_1337_1337_1338_1341_1343_1346_1346_1348_1350_1350_1355_1356_1358_1359_1360_1361_1362_1364_1367_1369_1371_1375_1377_1378_1383_1383_1385_1386_1392_1393_1394_1394_1395_1397_1399_1401_1402_1403_1403_1404_1406_1409_1418_1423_1423_1423_1423_1425_1425_1428_1428_1431_1431_1437_1437_1439_1440_1444_1445_1450_1456_1469_1470_1473_1474_1475_1478_1479_1482_1485_1486_1495_1495_1495_1495_1497_1497_1498_1498_1498_,2009_2012_2012_2012_2014_2015_2015_2016_2020_2022_2022_2022_2024_2028_2036_2036_2037_2037_2037_2038_2038_2038_2038_2040_2040_2040_2040_2044_2044_2048_2056_2058_2059_2069_2072_2072_2073_2081_2081_2083_2083_2086_2088_2088_2089_2090_2091_2092_2095_2097_2098_2101_2102_2104_2104_2104_2104_2105_2105_2106_2106_2112_2113_2114_2114_2116_2117_2117_2119_2123_2123_2126_2126_2126_2127_2131_2131_2133_2133_2134_2134_2134_2134_2135_2136_2139_2140_2143_2144_2145_2149_2149_2149_2149_2149_2149_2151_2155_2159_2161_2161_2161_2161_2161_2161_2161_2162_2162_2162_2162_2162_2162_2162_2163_2163_2163_2163_2166_2167_2167_2168_2171_2172_2177_2183_2183_2184_2189_2189_2194_2195_2196_2198_2198_2198_2198_2199_2199_2202_2204_2206_2206_2206_2208_2208_2212_2212_2216_2219_2221_2229_2232_2232_2232_2232_2232_2232_2237_2238_2244_2245_2246_2247_2252_2253_2258_2258_2259_2259_2260_2260_2260_2260_2264_2265_2266_2269_2270_2271_2272_2272_2274_2274_2275_2279_2280_2283_2283_2283_2284_2287_2287_2288_2288_2289_2292_2296_2298_2298_2301_2301_2304_2305_2307_2308_2313_2313_2316_2316_2318_2318_2318_2318_2319_2319_2319_2319_2321_2321_2322_2322_2324_2324_2328_2330_2333_2334_2335_2335_2338_2340_2340_2341_2341_2342_2353_2353_2358_2358_2359_2359_2360_2360_2360_2360_2360_2360_2360_2361_2361_2361_2361_2361_2361_2361_2362_2363_2365_2376_2376_2376_2377_2377_2381_2381_2383_2384_2384_2385_2385_2386_2387_2387_2388_2388_2390_2390_2390_2391_2391_2391_2394_2399_2401_2405_2407_2411_2411_2419_2421_2425_2425_2426_2428_2428_2434_2436_2439_2439_2439_2442_2445_2445_2446_2446_2447_2448_2450_2450_2451_2453_2453_2454_2454_2455_2455_2458_2459_2460_2460_2461_2461_2463_2464_2465_2466_2471_2471_2480_2483_2483_2483_2483_2491_2492_2494_2494_2495_2495_2499_2508_2508_2509_2517_2519_2523_2525_2525_2528_2529_2530_2530_2530_2531_2532_2533_2534_2541_2541_2541_2541_2543_2544_2544_2544_2544_2544_2549_2549_2549_2549_2549_2550_2550_2550_2550_2550_2553_2553_2553_2559_2564_2568_2569_2571_2571_2572_2572_2572_2576_2578_2581_2584_2585_2586_2587_2587_2589_2596_2596_2596_2596_2597_2597_2597_2597_2598_2599_2608_2609_2609_2615_2615_2621_2621_2623_2623_2625_2626_2626_2626_2635_2637_2637_2638_2638_2639_2647_2647_2647_2649_2649_2650_2652_2653_2655_2659_2662_2662_2670_2671_2681_2683_2686_2688_2690_2695_2695_2698_2698_2703_2713_2713_2718_2718_2718_2718_2719_2721_2721_2721_2721_2722_2723_2730_2731_2731_2731_2731_2732_2734_2742_2742_2742_2746_2746_2746_2746_2746_2746_2748_2748_2753_2754_2754_2754_2756_2756_2757_2757_2758_2758_2759_2759_2761_2761_2762_2762_2764_2764_2766_2767_2769_2769_2769_2769_2770_2770_2770_2770_2771_2773_2779_2780_2782_2782_2784_2784_2793_2795_2795_2797_2798_2798_2798_2799_2800_2800_2800_2803_2807_2807_2809_2809_2815_2815_2815_2816_2816_2818_2818_2829_2829_2829_2829_2830_2835_2836_2837_2838_2838_2840_2841_2844_2846_2848_2852_2853_2853_2853_2855_2856_2857_2858_2860_2861_2861_2861_2861_2861_2861_2862_2864_2864_2864_2867_2867_2870_2872_2873_2874_2874_2877_2878_2881_2881_2882_2883_2883_2884_2886_2889_2889_2890_2890_2896_2898_2900_2907_2908_2908_2913_2913_2914_2915_2916_2917_2917_2918_2918_2922_2922_2922_2924_2925_2928_2933_2941_2942_2943_2945_2946_2946_2949_2951_2951_2953_2953_2953_2956_2956_2957_2957_2960_2961_2962_2963_2964_2964_2967_2969_2969_2972_2976_2979_2980_2983_2983_2983_2983_2984_2984_2984_2984_2986_2987_2987_2988_2988_2995_2996_3001_3001_3001_3005_3012_3013_3013_3014_3019_3020_3020_3025_3027_3030_3030_3031_3032_3033_3038_3039_3040_3040_3049_3054_3055_3055_3055_3059_3061_3062_3065_3067_3073_3074_3074_3076_3076_3078_3079_3080_3083_3083_3083_3083_3083_3083_3083_3083_3084_3085_3093_3099_3099_3099_3103_3103_3103_3103_3103_3103_3104_3105_3105_3107_3107_3110_3110_3110_3110_3111_3115_3115_3115_3115_3115_3118_3119_3119_3124_3124_3129_3129_3130_3130_3131_3133_3135_3135_3139_3141_3145_3149_3149_3149_3151_3152_3156_3159_3159_3160_3163_3163_3170_3170_3170_3172_3172_3172_3174_3177_3180_3184_3184_3184_3184_3185_3185_3191_3191_3194_3194_3194_3194_3195_3195_3204_3205_3205_3205_3207_3207_3207_3210_3213_3215_3218_3223_3227_3227_3228_3229_3231_3231_3231_3232_3232_3237_3246_3246_3246_3246_3252_3253_3253_3253_3253_3253_3253_3254_3254_3254_3257_3260_3262_3263_3266_3267_3267_3267_3268_3272_3274_3280_3281_3281_3288_3289_3289_3289_3289_3290_3290_3290_3290_3293_3293_3293_3293_3294_3296_3300_3303_3305_3306_3307_3308_3308_3308_3308_3312_3313_3313_3313_3313_3316_3319_3319_3319_3319_3324_3327_3327_3327_3329_3329_3331_3331_3331_3332_3333_3333_3333_3334_3335_3336_3337_3339_3340_3345_3345_3347_3347_3347_3357_3357_3360_3360_3360_3360_3363_3364_3364_3365_3366_3369_3370_3373_3374_3376_3376_3378_3378_3380_3382_3383_3384_3385_3385_3385_3388_3388_3388_3388_3391_3391_3391_3393_3393_3393_3395_3397_3397_3397_3397_3400_3401_3405_3405_3405_3405_3409_3410_3410_3410_3410_3413_3414_3415_3418_3420_3421_3421_3427_3431_3431_3431_3432_3432_3432_3433_3433_3434_3434_3435_3435_3436_3436_3437_3439_3441_3443_3443_3443_3446_3448_3448_3448_3448_3452_3453_3453_3453_3453_3457_3458_3460_3462_3463_3464_3466_3467_3468_3470_3470_3471_3472_3475_3477_3477_3477_3478_3479_3479_3480_3481_3481_3482_3487_3487_3488_3489_3489_3490_3491_3491_3492_3494_3496_
3,3,來,ADV,247,263,510,4_7_8_41_44_47_52_53_58_96_100_150_164_169_186_196_198_213_224_225_229_230_234_248_248_258_258_269_271_279_281_288_288_289_308_312_316_322_335_339_374_374_391_391_398_401_406_410_435_438_445_447_453_455_461_462_465_480_482_483_489_491_492_511_518_525_527_534_536_546_546_546_550_554_555_555_555_559_563_569_572_578_581_628_628_630_631_641_641_644_662_668_670_674_701_701_702_707_717_728_732_743_745_756_758_779_783_783_787_788_789_792_793_796_802_808_815_828_832_842_875_883_885_885_887_887_887_887_889_889_893_893_895_895_895_895_897_897_902_906_907_907_907_910_912_913_917_921_923_925_931_933_934_940_943_945_945_963_967_974_995_996_1005_1005_1010_1010_1020_1030_1032_1039_1062_1081_1087_1088_1089_1089_1095_1097_1098_1113_1114_1115_1115_1121_1163_1164_1165_1166_1168_1168_1171_1175_1175_1178_1181_1187_1195_1197_1198_1200_1208_1208_1211_1244_1248_1249_1249_1253_1259_1262_1278_1279_1281_1285_1286_1288_1311_1315_1316_1321_1326_1326_1329_1329_1347_1355_1356_1360_1361_1378_1393_1399_1402_1409_1423_1423_1425_1428_1429_1430_1451_1475_1482_1497_1499_1500_,2011_2017_2036_2037_2037_2037_2037_2055_2057_2066_2069_2081_2083_2101_2102_2106_2127_2134_2161_2162_2162_2163_2190_2192_2198_2205_2208_2228_2229_2232_2232_2235_2236_2244_2245_2247_2252_2253_2258_2259_2264_2266_2269_2272_2273_2289_2291_2295_2299_2302_2305_2308_2309_2309_2309_2312_2315_2359_2359_2360_2360_2361_2361_2387_2388_2390_2390_2390_2391_2391_2391_2392_2445_2446_2457_2483_2483_2489_2494_2495_2509_2516_2516_2518_2518_2521_2521_2534_2544_2547_2547_2548_2551_2553_2561_2561_2562_2562_2569_2571_2589_2598_2598_2606_2615_2621_2637_2638_2642_2646_2671_2684_2687_2714_2731_2731_2742_2742_2746_2746_2746_2746_2746_2746_2746_2746_2746_2746_2746_2746_2750_2750_2759_2767_2769_2769_2769_2770_2770_2770_2771_2776_2776_2776_2783_2784_2791_2791_2798_2800_2802_2809_2815_2824_2826_2828_2836_2861_2861_2861_2867_2892_2902_2904_2909_2910_2914_2924_2928_2934_2939_2940_2949_2956_2957_2988_2997_3001_3001_3009_3010_3019_3032_3033_3037_3037_3087_3103_3103_3129_3129_3130_3130_3133_3133_3163_3163_3182_3183_3184_3184_3186_3186_3186_3188_3188_3188_3213_3213_3218_3218_3223_3225_3225_3231_3231_3233_3243_3246_3247_3253_3253_3255_3256_3257_3266_3282_3288_3291_3292_3294_3304_3308_3319_3327_3327_3347_3347_3347_3347_3352_3354_3385_3386_3386_3388_3403_3405_3405_3405_3408_3410_3410_3410_3422_3433_3435_3443_3443_3443_3451_3456_
3,3,補充,Vt,74,120,194,7_9_51_115_133_186_196_227_246_256_287_287_334_364_369_551_560_588_590_611_620_631_641_711_715_721_725_732_795_798_821_885_891_893_899_901_902_949_962_977_1011_1029_1031_1034_1038_1048_1072_1073_1079_1080_1081_1082_1149_1156_1169_1169_1176_1176_1202_1203_1208_1270_1273_1343_1428_1428_1429_1437_1474_1480_1487_1489_1492_,2038_2040_2057_2081_2083_2122_2134_2134_2154_2193_2197_2261_2263_2283_2299_2299_2302_2302_2314_2317_2345_2350_2360_2361_2368_2369_2436_2450_2453_2464_2466_2473_2475_2484_2503_2516_2518_2534_2547_2551_2565_2573_2608_2609_2630_2647_2752_2765_2779_2794_2815_2815_2816_2818_2827_2831_2832_2842_2843_2845_2854_2877_2878_2889_2890_2909_2910_2941_2945_2956_2957_2976_3013_3014_3029_3038_3039_3055_3055_3065_3067_3071_3084_3103_3103_3115_3119_3124_3129_3130_3158_3165_3203_3205_3232_3254_3257_3258_3269_3274_3296_3316_3327_3327_3333_3345_3353_3355_3373_3374_3418_3423_3424_3433_3435_3443_3444_3480_3482_
3,3,沒有,Vt,343,968,1311,4_7_8_16_16_16_22_30_37_41_44_47_54_57_59_62_66_73_80_82_86_88_104_112_112_115_122_130_135_140_150_150_152_162_163_163_167_168_168_172_178_188_203_209_211_220_229_229_242_252_253_253_253_276_279_280_281_281_281_283_286_308_312_316_320_321_326_328_331_333_341_347_357_365_365_370_370_379_379_379_380_381_383_384_388_391_407_408_411_417_424_424_427_427_431_431_434_434_434_435_435_449_451_457_459_460_462_462_478_480_481_481_487_489_494_497_499_508_521_530_538_551_560_584_584_592_599_599_601_608_608_612_612_618_621_621_627_629_630_630_631_646_649_652_655_661_662_662_665_669_670_677_677_687_692_710_711_711_713_714_716_720_721_721_723_724_726_732_736_736_736_745_745_745_749_749_750_753_756_756_758_758_762_770_771_772_773_774_775_776_777_779_783_784_788_792_795_798_799_806_811_814_817_839_839_839_841_841_846_847_848_871_872_879_880_885_887_888_889_889_890_893_895_896_897_897_898_902_923_923_923_924_931_931_931_932_939_943_952_953_957_959_959_973_973_981_990_993_1001_1005_1011_1019_1020_1054_1054_1054_1057_1072_1073_1073_1073_1073_1079_1080_1080_1080_1080_1081_1081_1083_1087_1088_1088_1088_1088_1090_1091_1099_1105_1106_1114_1114_1139_1169_1169_1176_1176_1203_1217_1234_1238_1240_1251_1259_1270_1272_1273_1275_1282_1289_1290_1293_1293_1294_1296_1298_1300_1319_1319_1324_1324_1337_1337_1342_1346_1350_1350_1350_1350_1352_1391_1392_1393_1398_1400_1401_1402_1407_1409_1423_1423_1425_1428_1428_1430_1431_1431_1463_1468_1469_1470_1496_,2002_2011_2013_2015_2015_2016_2016_2017_2020_2022_2023_2029_2029_2037_2037_2037_2037_2038_2038_2040_2040_2043_2045_2048_2050_2051_2053_2054_2057_2059_2062_2062_2065_2070_2072_2072_2081_2083_2089_2089_2095_2097_2099_2101_2102_2104_2105_2106_2107_2112_2114_2117_2123_2123_2124_2125_2126_2130_2132_2134_2134_2144_2145_2149_2159_2159_2159_2161_2161_2162_2162_2163_2165_2167_2167_2170_2179_2179_2183_2189_2195_2195_2195_2198_2198_2198_2198_2198_2201_2206_2206_2208_2208_2209_2209_2209_2209_2210_2210_2210_2210_2211_2215_2219_2221_2227_2231_2231_2231_2235_2235_2236_2236_2241_2246_2246_2247_2247_2247_2249_2251_2252_2252_2252_2253_2253_2253_2258_2259_2271_2274_2274_2278_2280_2280_2281_2281_2282_2282_2284_2284_2287_2288_2289_2291_2291_2291_2294_2295_2298_2299_2301_2302_2312_2313_2315_2316_2318_2319_2322_2322_2322_2323_2323_2323_2332_2333_2334_2339_2342_2342_2345_2350_2359_2360_2360_2361_2361_2365_2372_2375_2376_2376_2383_2387_2388_2390_2391_2392_2394_2395_2396_2398_2411_2411_2416_2416_2417_2418_2419_2424_2434_2434_2436_2439_2439_2445_2445_2445_2446_2446_2446_2450_2450_2450_2450_2450_2452_2453_2453_2453_2453_2453_2454_2454_2454_2455_2455_2455_2457_2460_2461_2464_2466_2475_2480_2483_2483_2489_2493_2494_2495_2498_2498_2500_2501_2509_2509_2512_2513_2517_2517_2517_2517_2517_2517_2517_2519_2519_2519_2519_2519_2519_2519_2521_2526_2528_2529_2532_2533_2534_2534_2543_2544_2544_2547_2548_2549_2549_2550_2550_2553_2564_2564_2565_2565_2565_2567_2567_2569_2571_2571_2572_2582_2582_2584_2584_2585_2587_2593_2596_2597_2601_2604_2607_2611_2616_2624_2629_2631_2631_2632_2633_2635_2637_2637_2637_2637_2638_2638_2638_2638_2651_2651_2651_2651_2651_2651_2651_2651_2652_2652_2654_2654_2654_2654_2654_2654_2654_2654_2655_2655_2657_2657_2662_2669_2671_2671_2671_2671_2671_2671_2671_2671_2674_2675_2677_2679_2680_2680_2680_2681_2681_2683_2686_2689_2690_2700_2701_2702_2702_2703_2707_2708_2710_2712_2714_2714_2715_2715_2716_2716_2718_2718_2718_2721_2721_2721_2730_2731_2731_2731_2731_2731_2731_2731_2731_2731_2732_2732_2738_2739_2739_2740_2740_2740_2742_2746_2746_2746_2746_2748_2748_2749_2753_2754_2754_2754_2756_2756_2757_2758_2759_2761_2762_2768_2769_2769_2769_2769_2769_2769_2769_2770_2770_2770_2770_2770_2770_2770_2771_2773_2773_2775_2775_2775_2775_2776_2776_2779_2782_2784_2784_2784_2790_2790_2791_2793_2796_2797_2797_2806_2807_2807_2812_2814_2814_2815_2815_2815_2816_2816_2816_2816_2816_2817_2818_2818_2818_2818_2818_2819_2823_2824_2824_2825_2826_2826_2828_2828_2828_2834_2835_2836_2836_2836_2836_2839_2846_2847_2861_2861_2861_2862_2863_2864_2864_2869_2869_2869_2869_2871_2871_2872_2872_2872_2872_2872_2872_2872_2872_2872_2872_2872_2872_2872_2874_2881_2881_2883_2893_2895_2899_2900_2902_2903_2904_2905_2912_2914_2916_2918_2919_2924_2927_2929_2931_2931_2931_2933_2933_2934_2934_2939_2940_2944_2944_2945_2945_2945_2945_2945_2945_2945_2946_2946_2946_2946_2946_2948_2949_2949_2951_2956_2957_2958_2958_2961_2961_2961_2961_2961_2963_2963_2963_2963_2963_2969_2972_2972_2973_2974_2976_2980_2987_2987_2987_2998_2998_2999_3001_3001_3001_3001_3001_3002_3003_3003_3005_3008_3009_3009_3010_3010_3011_3011_3012_3024_3025_3025_3026_3027_3027_3029_3031_3032_3032_3033_3033_3034_3034_3034_3034_3038_3038_3038_3039_3039_3039_3040_3040_3040_3040_3044_3047_3048_3049_3051_3052_3053_3054_3056_3056_3059_3071_3073_3073_3073_3074_3076_3076_3076_3076_3076_3076_3076_3079_3083_3083_3085_3089_3093_3095_3101_3101_3103_3103_3105_3105_3105_3105_3115_3115_3118_3119_3119_3124_3124_3129_3129_3130_3130_3132_3132_3132_3135_3139_3139_3139_3142_3144_3144_3146_3147_3149_3150_3152_3152_3153_3153_3158_3159_3159_3159_3160_3160_3161_3161_3163_3163_3163_3163_3170_3172_3174_3174_3177_3177_3178_3180_3184_3184_3184_3185_3187_3189_3194_3194_3195_3196_3196_3196_3202_3202_3203_3204_3204_3204_3204_3205_3205_3205_3208_3210_3210_3210_3212_3213_3213_3215_3215_3215_3217_3218_3218_3220_3221_3223_3223_3223_3226_3227_3227_3231_3231_3233_3237_3239_3241_3241_3243_3243_3244_3245_3246_3246_3246_3246_3246_3246_3246_3246_3246_3246_3253_3254_3255_3255_3255_3256_3256_3256_3257_3258_3260_3262_3263_3264_3264_3267_3270_3276_3278_3281_3281_3281_3281_3282_3282_3283_3286_3288_3288_3288_3289_3289_3289_3289_3289_3290_3290_3290_3290_3290_3293_3294_3296_3296_3296_3296_3296_3300_3303_3304_3306_3308_3308_3308_3310_3312_3318_3319_3319_3319_3326_3327_3327_3327_3329_3329_3329_3331_3333_3333_3337_3337_3341_3341_3341_3347_3349_3353_3355_3360_3360_3360_3360_3365_3367_3368_3369_3370_3379_3380_3383_3384_3386_3386_3389_3390_3392_3394_3395_3395_3396_3397_3397_3397_3409_3413_3414_3415_3415_3416_3419_3421_3425_3425_3425_3425_3425_3426_3427_3428_3430_3431_3431_3431_3432_3432_3432_3433_3433_3433_3433_3433_3434_3435_3435_3435_3435_3435_3436_3446_3448_3448_3448_3448_3450_3450_3452_3453_3453_3453_3453_3455_3455_3457_3458_3462_3470_3470_3470_3470_3470_3470_3470_3473_3473_3476_3478_3478_3479_3480_3481_3482_3493_
3,3,單位,N,3,7,10,7_982_,2363_2434_2483_3163_3163_3231_
3,3,高,Vi,165,121,286,7_48_69_76_91_111_114_117_123_125_131_140_140_142_142_158_161_162_164_166_167_169_176_178_181_186_188_191_196_198_198_225_229_229_245_245_245_246_255_255_255_256_275_298_306_320_324_342_352_373_374_392_433_439_444_444_449_452_452_457_482_483_491_492_539_546_548_555_557_584_610_619_674_714_724_729_740_743_753_787_795_798_815_819_828_857_866_869_876_877_884_887_887_888_895_895_896_901_902_905_906_907_920_924_932_935_957_960_962_978_981_985_1009_1012_1014_1015_1022_1045_1049_1050_1061_1065_1067_1074_1082_1089_1091_1093_1094_1095_1105_1142_1144_1149_1156_1167_1168_1168_1173_1174_1175_1175_1180_1201_1201_1214_1216_1235_1263_1282_1289_1303_1306_1317_1322_1328_1331_1337_1338_1369_1374_1378_1395_1404_,2051_2054_2057_2095_2095_2097_2097_2098_2112_2149_2153_2174_2175_2178_2181_2189_2190_2252_2253_2255_2257_2266_2269_2279_2281_2282_2284_2318_2319_2342_2400_2400_2402_2402_2473_2506_2507_2544_2547_2564_2573_2634_2636_2637_2638_2647_2651_2651_2654_2654_2658_2671_2705_2706_2714_2714_2719_2719_2722_2722_2750_2761_2762_2779_2830_2841_2941_2954_2960_2962_2967_2980_3014_3019_3025_3025_3027_3027_3032_3033_3042_3046_3050_3059_3088_3090_3091_3093_3095_3099_3100_3115_3154_3155_3158_3164_3192_3194_3209_3231_3249_3255_3256_3283_3288_3345_3345_3363_3372_3414_3430_3431_3432_3443_3450_3455_3472_3473_3480_3482_
3,3,對了,Vi,11,8,19,7_227_334_348_366_371_665_822_962_1011_,2283_2344_2349_3409_3409_3423_3424_
3,3,免費,Vi,163,96,259,7_43_57_62_67_74_91_91_108_108_109_113_118_126_171_181_191_213_215_226_235_235_272_287_287_334_345_355_391_401_407_434_434_466_482_491_520_521_521_529_530_530_547_554_554_556_563_563_599_599_608_608_628_632_639_641_660_662_663_665_672_675_681_682_707_717_730_732_756_758_771_775_780_783_794_795_797_798_806_809_813_817_819_822_842_843_844_846_851_856_857_860_865_866_873_881_888_896_901_901_915_920_923_923_923_924_924_925_928_931_931_931_932_932_933_936_941_1003_1005_1005_1010_1011_1054_1054_1083_1106_1164_1166_1197_1200_1208_1211_1224_1226_1234_1234_1235_1237_1238_1238_1239_1251_1251_1259_1271_1271_1274_1274_1277_1284_1309_1313_1328_1336_1352_1352_1353_1375_1376_1437_1495_1499_,2073_2074_2099_2106_2131_2133_2151_2162_2177_2209_2210_2211_2237_2238_2240_2269_2269_2293_2360_2360_2360_2361_2361_2361_2380_2391_2391_2391_2418_2460_2461_2467_2468_2492_2498_2517_2519_2521_2528_2553_2573_2574_2584_2623_2674_2688_2689_2695_2698_2698_2761_2762_2776_2776_2779_2806_2847_2847_2847_2851_2862_2865_2872_2965_2966_2972_2972_2972_2979_2980_3038_3039_3059_3072_3100_3118_3152_3152_3153_3171_3173_3182_3183_3196_3210_3215_3252_3252_3274_3318_3319_3423_3424_3479_3481_
3,3,硬件,N,70,62,132,7_118_126_142_240_250_279_281_288_316_339_339_409_423_445_453_480_489_502_513_517_522_531_548_557_643_686_689_691_694_703_705_710_714_720_724_731_733_744_749_808_869_875_877_883_918_924_932_968_982_982_988_1007_1013_1032_1043_1065_1066_1102_1170_1177_1201_1211_1215_1231_1236_1337_1490_1493_,2037_2047_2051_2054_2069_2070_2072_2075_2122_2153_2159_2183_2229_2229_2252_2252_2253_2253_2289_2289_2360_2361_2388_2445_2445_2446_2446_2517_2519_2544_2558_2586_2608_2608_2714_2723_2756_2824_2826_2836_2866_2873_2889_2890_2915_2945_2976_2977_2978_3069_3070_3131_3132_3233_3243_3245_3246_3272_3397_3415_3446_
3,3,能夠,ADV,9,18,27,7_108_766_924_932_1169_1176_1343_,2305_2308_2359_2388_2510_2511_2680_2816_2818_2885_2887_2921_2951_3132_3231_3253_3320_
3,3,還,ADV,947,844,1791,4_7_8_10_10_12_12_14_14_17_17_17_20_21_22_23_28_29_30_31_35_35_38_47_51_51_55_60_69_76_77_81_82_83_87_88_91_91_95_95_98_99_101_104_104_105_115_116_118_118_121_123_123_126_126_129_131_131_133_133_133_133_140_142_144_145_145_147_149_149_150_150_152_152_154_155_158_160_162_163_163_163_164_167_168_168_168_169_173_175_175_177_179_181_183_185_186_186_186_186_186_186_187_189_191_193_195_196_196_196_196_196_196_197_198_199_200_203_203_204_205_206_209_209_210_212_213_213_213_214_217_218_218_218_219_219_222_222_226_231_241_242_244_248_248_251_252_253_253_253_254_258_258_276_276_277_280_281_282_284_286_286_291_297_299_305_307_308_309_311_312_313_317_320_320_320_321_323_323_326_327_328_328_328_331_332_333_333_333_334_334_334_335_335_341_345_348_351_351_355_361_361_362_364_367_369_373_374_375_377_378_379_386_386_387_387_388_388_388_389_391_394_396_397_397_397_398_401_402_402_403_404_405_405_407_407_408_410_413_414_417_422_422_424_424_427_431_431_433_433_433_434_434_435_436_439_440_442_442_446_449_450_454_457_458_461_465_470_471_474_475_481_482_482_483_483_483_484_491_491_492_492_492_493_495_496_498_501_504_506_507_508_508_515_517_517_520_521_521_521_522_524_524_525_526_527_529_530_530_530_531_533_533_534_535_536_540_541_545_546_546_546_546_546_546_548_550_550_553_553_554_555_555_555_555_555_555_557_559_559_562_562_563_566_567_568_569_570_570_570_571_572_572_575_576_577_578_579_579_579_580_581_581_582_582_583_583_584_586_589_591_592_597_597_599_599_600_601_608_608_609_611_615_618_620_624_627_629_629_629_630_631_631_634_634_635_637_642_648_649_649_650_654_655_655_656_657_660_662_662_662_662_666_672_674_675_675_676_678_683_684_684_685_686_689_690_691_694_695_700_701_701_707_708_710_710_710_710_710_710_710_710_711_714_714_715_716_717_718_720_720_720_720_720_720_720_720_721_724_724_725_726_727_728_729_733_735_738_739_741_743_743_747_747_749_749_750_753_755_757_765_766_768_771_771_772_772_772_775_775_776_776_776_778_780_783_783_783_783_783_785_787_787_790_794_794_794_794_795_795_797_797_797_797_798_798_804_804_809_813_814_814_814_815_815_818_818_820_820_820_822_825_828_830_830_831_831_832_835_835_835_835_835_835_841_842_842_846_848_848_854_854_855_856_856_859_863_863_864_865_865_868_870_872_875_875_878_880_883_883_885_886_886_887_887_887_887_887_887_887_888_888_888_889_889_889_889_890_890_891_891_892_892_893_894_894_895_895_895_895_895_895_895_896_896_896_897_897_897_897_898_898_899_899_900_900_904_906_910_910_912_912_912_912_912_915_915_916_921_921_921_922_923_923_923_928_930_931_931_931_934_935_936_939_940_941_941_943_943_943_945_945_946_946_952_953_954_958_959_961_962_963_964_964_964_965_969_974_982_982_986_987_987_988_989_992_999_1000_1002_1005_1005_1006_1011_1012_1013_1015_1015_1016_1018_1019_1020_1020_1020_1021_1022_1026_1028_1032_1032_1038_1038_1043_1046_1049_1049_1049_1052_1053_1054_1054_1054_1054_1058_1062_1062_1062_1068_1070_1070_1073_1075_1077_1077_1080_1081_1082_1087_1088_1091_1093_1093_1094_1094_1095_1096_1099_1100_1100_1100_1100_1105_1106_1106_1106_1106_1109_1109_1110_1114_1114_1114_1114_1114_1114_1115_1117_1117_1118_1124_1129_1129_1131_1135_1136_1136_1138_1139_1141_1143_1148_1148_1148_1152_1152_1154_1155_1159_1159_1161_1162_1163_1163_1163_1165_1165_1165_1169_1171_1171_1171_1176_1178_1178_1178_1185_1191_1197_1199_1200_1202_1204_1204_1205_1209_1211_1211_1212_1212_1213_1213_1233_1238_1239_1240_1249_1249_1250_1250_1251_1251_1257_1258_1261_1270_1271_1272_1272_1273_1274_1275_1275_1277_1277_1278_1279_1282_1284_1284_1285_1286_1289_1309_1309_1311_1313_1313_1315_1317_1318_1320_1322_1323_1325_1326_1329_1332_1336_1336_1341_1341_1343_1345_1345_1345_1347_1348_1349_1356_1361_1376_1386_1388_1392_1399_1399_1399_1401_1408_1410_1412_1413_1415_1417_1418_1418_1418_1418_1421_1425_1425_1425_1426_1427_1427_1428_1428_1428_1428_1430_1430_1431_1431_1442_1447_1453_1454_1459_1462_1462_1463_1463_1464_1467_1467_1468_1468_1469_1470_1472_1472_1472_1474_1477_1477_1478_1478_1479_1479_1479_1480_1484_1484_1485_1485_1486_1486_1486_1487_1491_1494_1495_1496_1496_1498_1498_1499_,2005_2009_2009_2011_2012_2014_2015_2020_2024_2029_2029_2030_2031_2032_2034_2037_2038_2040_2047_2047_2048_2050_2051_2053_2054_2058_2059_2059_2065_2068_2071_2071_2074_2078_2081_2083_2086_2089_2094_2096_2099_2101_2102_2108_2111_2112_2113_2116_2119_2120_2121_2123_2124_2124_2125_2126_2126_2126_2126_2134_2144_2145_2148_2148_2153_2153_2161_2161_2162_2162_2162_2169_2177_2178_2180_2180_2183_2186_2190_2190_2190_2197_2197_2205_2205_2205_2206_2208_2209_2210_2211_2211_2211_2211_2215_2220_2222_2225_2226_2229_2231_2232_2232_2232_2232_2232_2235_2236_2239_2240_2241_2243_2246_2247_2249_2251_2252_2253_2255_2257_2260_2264_2264_2266_2267_2269_2270_2273_2273_2273_2273_2275_2278_2283_2283_2283_2289_2289_2290_2291_2298_2299_2301_2302_2305_2308_2309_2312_2313_2314_2315_2316_2317_2322_2322_2323_2326_2328_2330_2333_2333_2334_2334_2340_2340_2340_2341_2341_2341_2344_2344_2347_2349_2349_2353_2353_2354_2355_2356_2359_2360_2360_2361_2361_2362_2365_2372_2375_2378_2380_2382_2383_2383_2387_2391_2391_2391_2392_2400_2402_2404_2411_2411_2412_2412_2412_2414_2416_2417_2426_2432_2432_2435_2435_2436_2438_2438_2438_2440_2440_2440_2444_2448_2451_2454_2455_2458_2462_2464_2466_2475_2475_2479_2480_2483_2484_2484_2487_2488_2489_2492_2492_2494_2495_2505_2505_2509_2509_2510_2511_2516_2517_2518_2519_2522_2522_2523_2525_2526_2527_2528_2528_2530_2531_2531_2536_2541_2541_2541_2543_2543_2544_2544_2544_2549_2550_2551_2553_2558_2561_2562_2564_2567_2571_2573_2574_2576_2576_2585_2589_2589_2596_2597_2599_2603_2604_2605_2606_2606_2607_2607_2607_2609_2611_2615_2616_2623_2624_2632_2633_2634_2637_2637_2638_2638_2639_2641_2645_2647_2647_2649_2651_2654_2680_2683_2686_2688_2691_2691_2695_2698_2699_2702_2702_2702_2707_2707_2707_2707_2708_2708_2708_2708_2709_2711_2714_2714_2718_2718_2721_2721_2723_2724_2730_2730_2739_2740_2742_2744_2745_2746_2748_2750_2752_2753_2753_2756_2767_2769_2770_2773_2774_2775_2776_2779_2782_2783_2787_2789_2790_2791_2794_2794_2796_2805_2806_2806_2809_2809_2809_2813_2815_2815_2816_2816_2818_2818_2824_2824_2824_2826_2826_2826_2827_2829_2836_2836_2838_2851_2851_2855_2855_2856_2856_2861_2861_2861_2861_2861_2863_2864_2864_2866_2869_2869_2871_2871_2872_2876_2879_2879_2880_2880_2883_2883_2889_2890_2895_2898_2898_2907_2908_2908_2913_2914_2914_2915_2919_2919_2922_2924_2925_2928_2931_2931_2932_2934_2939_2940_2941_2945_2945_2945_2945_2945_2945_2946_2946_2946_2948_2951_2956_2956_2956_2957_2957_2957_2958_2958_2958_2960_2961_2961_2962_2963_2963_2964_2965_2966_2967_2968_2970_2972_2972_2972_2972_2975_2975_2976_2976_2976_2979_2980_2983_2984_2985_2987_2988_2993_2994_2997_2998_2999_2999_3000_3001_3001_3003_3006_3007_3008_3016_3025_3027_3029_3029_3031_3032_3032_3033_3033_3034_3038_3038_3038_3038_3039_3039_3039_3039_3040_3046_3047_3049_3049_3050_3051_3052_3052_3053_3053_3056_3056_3059_3063_3069_3070_3071_3071_3074_3074_3076_3076_3084_3086_3089_3095_3095_3100_3101_3103_3103_3105_3107_3107_3110_3115_3115_3116_3119_3124_3129_3129_3130_3130_3132_3137_3138_3139_3141_3146_3146_3146_3148_3149_3150_3150_3152_3153_3154_3155_3159_3159_3159_3159_3161_3163_3163_3175_3176_3177_3181_3181_3184_3184_3184_3187_3189_3190_3193_3194_3194_3195_3195_3195_3196_3201_3202_3203_3205_3205_3206_3207_3207_3212_3213_3213_3214_3214_3214_3217_3218_3218_3219_3219_3219_3222_3226_3227_3227_3227_3231_3231_3232_3235_3237_3237_3239_3243_3243_3243_3243_3243_3245_3245_3246_3253_3253_3253_3253_3254_3254_3255_3256_3257_3264_3266_3270_3274_3276_3276_3281_3281_3286_3289_3289_3289_3289_3290_3290_3290_3290_3291_3292_3293_3304_3304_3306_3307_3308_3308_3309_3313_3316_3316_3316_3319_3319_3319_3321_3322_3323_3323_3331_3331_3332_3333_3334_3337_3338_3341_3341_3341_3345_3345_3347_3351_3352_3354_3358_3360_3360_3360_3363_3363_3365_3366_3369_3369_3370_3370_3371_3371_3373_3373_3374_3374_3376_3378_3380_3380_3386_3388_3388_3389_3389_3390_3390_3392_3392_3392_3394_3394_3394_3397_3399_3399_3409_3409_3413_3413_3417_3418_3419_3419_3420_3422_3422_3422_3423_3424_3427_3431_3432_3433_3433_3433_3433_3433_3433_3433_3433_3434_3435_3435_3435_3435_3435_3435_3435_3435_3436_3437_3438_3443_3445_3446_3448_3450_3453_3454_3455_3458_3459_3459_3459_3460_3463_3466_3466_3467_3471_3471_3472_3473_3475_3475_3476_3477_3478_3479_3480_3481_3482_3485_3488_3488_3489_3489_3490_3490_3491_3491_
3,3,就,ADV,605,1005,1610,7_12_16_16_16_35_35_41_41_44_50_50_54_55_59_60_65_66_66_66_67_69_72_73_73_73_74_76_89_93_94_100_100_101_101_103_103_109_109_109_112_118_126_149_149_150_152_162_163_163_163_164_165_165_165_167_168_168_168_169_170_170_170_175_175_176_183_185_186_186_186_186_186_193_195_196_196_196_196_196_204_204_210_210_215_227_227_228_228_229_229_231_238_239_244_245_246_247_247_249_254_255_256_257_257_272_272_272_273_274_275_279_280_280_282_288_289_320_320_320_335_335_336_338_338_339_339_339_341_341_373_373_377_381_384_386_388_388_389_393_393_395_398_401_418_422_424_429_431_433_439_441_449_457_466_481_482_491_495_499_501_505_508_516_517_517_518_520_521_521_529_530_530_540_543_546_546_546_547_550_555_555_555_556_559_567_569_576_578_584_597_597_600_609_611_620_628_628_629_630_630_630_630_630_632_632_635_636_637_638_657_658_663_666_668_669_669_670_670_670_674_674_675_675_677_686_691_701_701_702_707_707_707_707_708_710_710_710_710_710_710_710_710_710_710_710_711_714_717_717_717_717_718_720_720_720_720_720_720_720_720_720_720_720_721_724_736_749_749_755_757_765_766_767_773_773_777_777_780_780_783_783_783_783_783_783_783_785_786_787_787_788_788_790_790_792_794_797_799_805_811_811_812_813_815_815_816_817_821_822_822_828_828_830_830_835_835_836_837_837_839_841_841_842_846_847_847_848_849_850_855_856_856_859_864_865_865_868_871_875_875_879_883_883_885_885_886_886_886_887_887_887_887_887_887_888_888_889_889_889_889_889_890_891_891_893_893_894_894_894_895_895_895_895_895_895_896_896_897_897_897_897_897_898_899_899_901_901_901_902_902_905_906_906_907_910_910_916_921_921_923_923_923_923_924_931_931_931_931_932_935_935_944_944_947_948_951_958_960_962_966_973_981_982_983_985_989_990_992_993_1005_1011_1011_1017_1019_1019_1020_1020_1025_1026_1026_1028_1037_1048_1051_1054_1055_1057_1060_1063_1066_1067_1074_1081_1084_1084_1084_1088_1090_1092_1092_1092_1105_1106_1106_1124_1124_1131_1131_1141_1143_1145_1145_1149_1151_1155_1156_1158_1162_1170_1177_1181_1181_1182_1186_1187_1187_1188_1192_1194_1195_1198_1201_1212_1213_1218_1228_1230_1231_1232_1232_1232_1236_1239_1239_1242_1242_1242_1243_1243_1246_1246_1246_1247_1247_1249_1251_1251_1252_1257_1258_1259_1261_1266_1270_1273_1277_1278_1279_1284_1285_1286_1304_1304_1307_1307_1311_1315_1316_1316_1319_1320_1321_1321_1324_1325_1326_1326_1328_1328_1328_1332_1335_1338_1348_1348_1348_1350_1359_1364_1366_1367_1371_1378_1383_1386_1394_1398_1403_1407_1408_1410_1413_1415_1419_1423_1427_1428_1430_1433_1433_1433_1435_1435_1435_1437_1437_1437_1437_1455_1456_1459_1464_1472_1473_1473_1474_1474_1477_1484_1495_1495_1496_1498_,2012_2012_2012_2012_2012_2012_2012_2012_2015_2017_2018_2019_2020_2022_2022_2024_2027_2030_2031_2037_2037_2037_2037_2037_2042_2042_2047_2048_2050_2053_2057_2058_2058_2059_2061_2066_2067_2069_2071_2072_2074_2074_2074_2077_2077_2081_2081_2083_2083_2090_2090_2090_2099_2099_2099_2104_2104_2104_2104_2105_2112_2112_2113_2124_2126_2127_2134_2134_2139_2143_2148_2149_2151_2153_2153_2153_2162_2162_2162_2162_2162_2162_2162_2162_2162_2162_2163_2163_2163_2163_2166_2168_2171_2174_2175_2175_2179_2183_2186_2186_2186_2189_2191_2193_2194_2198_2206_2206_2206_2209_2210_2211_2220_2220_2220_2222_2222_2222_2231_2231_2231_2231_2232_2232_2232_2232_2235_2236_2246_2246_2247_2247_2249_2251_2252_2252_2252_2253_2253_2253_2260_2260_2260_2264_2264_2264_2269_2269_2270_2272_2272_2272_2273_2273_2274_2276_2278_2279_2287_2287_2287_2287_2287_2288_2288_2288_2288_2288_2289_2289_2289_2290_2295_2296_2298_2301_2305_2308_2312_2313_2313_2313_2314_2315_2316_2316_2316_2317_2326_2326_2328_2328_2330_2330_2333_2334_2337_2337_2337_2338_2338_2342_2345_2350_2360_2360_2360_2360_2360_2361_2361_2361_2361_2361_2367_2367_2372_2372_2372_2375_2375_2375_2377_2381_2381_2383_2386_2387_2391_2391_2391_2392_2394_2394_2411_2412_2414_2417_2417_2418_2419_2421_2424_2425_2425_2426_2428_2428_2444_2445_2445_2446_2446_2447_2447_2447_2448_2450_2450_2451_2453_2453_2454_2454_2455_2455_2458_2460_2461_2463_2465_2475_2480_2483_2483_2483_2484_2484_2490_2490_2492_2493_2497_2500_2501_2504_2505_2509_2509_2509_2510_2511_2512_2513_2514_2515_2516_2517_2517_2517_2518_2519_2519_2519_2522_2523_2523_2524_2525_2525_2525_2527_2528_2528_2528_2528_2528_2529_2531_2534_2534_2534_2537_2538_2541_2541_2543_2543_2544_2547_2548_2548_2549_2549_2549_2549_2550_2550_2550_2550_2553_2553_2554_2555_2561_2562_2565_2565_2565_2569_2572_2572_2572_2573_2574_2579_2582_2587_2587_2587_2594_2595_2595_2596_2597_2601_2603_2604_2605_2606_2607_2608_2608_2609_2609_2609_2609_2615_2616_2616_2619_2620_2625_2625_2626_2630_2631_2636_2639_2647_2647_2649_2651_2651_2654_2654_2657_2657_2659_2662_2670_2671_2671_2671_2672_2674_2679_2679_2679_2684_2687_2689_2690_2690_2691_2691_2691_2698_2702_2703_2705_2706_2707_2707_2708_2708_2710_2710_2712_2712_2714_2717_2718_2720_2721_2724_2726_2727_2730_2731_2731_2731_2739_2739_2740_2740_2740_2741_2742_2742_2742_2744_2744_2746_2746_2746_2746_2746_2746_2747_2748_2748_2748_2750_2750_2753_2754_2754_2754_2756_2756_2756_2757_2757_2758_2758_2761_2761_2762_2762_2766_2767_2768_2769_2769_2769_2769_2769_2770_2770_2770_2770_2770_2771_2773_2774_2775_2790_2790_2790_2794_2798_2800_2802_2809_2809_2809_2809_2816_2817_2818_2819_2824_2824_2824_2826_2826_2826_2828_2829_2829_2841_2841_2848_2848_2857_2858_2861_2861_2861_2861_2861_2861_2862_2862_2862_2862_2863_2863_2864_2864_2864_2864_2864_2865_2867_2867_2867_2867_2867_2869_2872_2873_2876_2877_2878_2879_2879_2879_2880_2880_2880_2881_2889_2890_2892_2892_2892_2902_2902_2903_2904_2904_2905_2907_2907_2909_2910_2911_2914_2915_2917_2917_2921_2922_2922_2925_2928_2929_2930_2933_2933_2933_2933_2934_2934_2939_2940_2945_2945_2945_2945_2945_2946_2946_2952_2958_2958_2959_2959_2959_2964_2965_2966_2968_2974_2975_2976_2976_2976_2976_2976_2983_2984_2987_2987_2987_2988_2995_2995_3009_3010_3012_3012_3013_3013_3014_3019_3019_3019_3020_3029_3031_3032_3033_3034_3036_3036_3036_3038_3038_3038_3038_3038_3038_3038_3038_3039_3039_3039_3039_3039_3039_3039_3039_3040_3040_3040_3043_3049_3054_3055_3056_3056_3056_3064_3073_3074_3074_3076_3076_3076_3078_3079_3083_3083_3083_3083_3083_3083_3083_3083_3084_3086_3086_3087_3093_3096_3098_3101_3103_3103_3105_3107_3107_3107_3108_3109_3110_3110_3110_3112_3114_3119_3119_3121_3122_3124_3124_3126_3127_3132_3137_3139_3139_3141_3149_3150_3150_3152_3153_3158_3159_3159_3159_3170_3170_3170_3172_3172_3172_3182_3183_3184_3184_3184_3184_3184_3184_3184_3184_3184_3184_3186_3186_3186_3187_3187_3188_3188_3188_3189_3189_3194_3194_3195_3196_3196_3196_3202_3205_3205_3210_3215_3222_3226_3226_3227_3227_3231_3231_3232_3233_3234_3235_3242_3243_3243_3243_3243_3245_3246_3246_3246_3246_3246_3253_3253_3253_3253_3253_3254_3255_3255_3255_3255_3256_3256_3256_3256_3257_3258_3272_3272_3273_3274_3277_3281_3287_3288_3289_3289_3289_3289_3289_3289_3289_3289_3289_3290_3290_3290_3290_3290_3290_3290_3290_3290_3291_3292_3298_3299_3301_3302_3304_3305_3308_3308_3308_3308_3309_3310_3312_3313_3313_3313_3313_3315_3316_3319_3319_3319_3320_3324_3324_3327_3331_3331_3331_3331_3333_3333_3338_3340_3341_3341_3344_3347_3347_3347_3351_3357_3360_3360_3360_3360_3360_3360_3360_3363_3363_3363_3366_3367_3368_3369_3369_3370_3370_3371_3376_3378_3386_3388_3388_3388_3388_3388_3389_3390_3391_3391_3393_3393_3397_3397_3397_3405_3405_3405_3410_3410_3410_3415_3415_3418_3418_3418_3418_3419_3420_3421_3422_3423_3424_3431_3431_3432_3432_3433_3433_3433_3433_3433_3433_3433_3433_3433_3433_3433_3433_3433_3433_3433_3433_3434_3434_3435_3435_3435_3435_3435_3435_3435_3435_3435_3435_3435_3435_3435_3435_3435_3435_3436_3436_3437_3439_3441_3443_3443_3443_3443_3446_3448_3448_3451_3452_3453_3453_3456_3457_3459_3463_3463_3466_3470_3471_3471_3475_3487_3487_3488_3490_3493_
3,3,電話,N,49,186,235,7_49_103_112_186_196_213_213_213_220_223_238_269_386_394_408_427_434_434_460_584_591_660_661_710_710_710_720_720_720_773_777_794_797_819_971_973_981_1057_1081_1141_1143_1168_1175_1212_1282_1289_1348_,2029_2057_2072_2072_2081_2083_2095_2095_2097_2097_2126_2161_2164_2164_2169_2190_2190_2193_2199_2212_2232_2232_2232_2252_2253_2272_2281_2281_2282_2282_2287_2288_2292_2303_2306_2313_2316_2343_2359_2360_2361_2372_2375_2391_2394_2445_2446_2483_2494_2495_2497_2498_2516_2518_2529_2534_2554_2555_2560_2573_2577_2587_2594_2606_2611_2642_2646_2671_2671_2671_2672_2690_2746_2746_2767_2775_2775_2775_2775_2775_2793_2806_2812_2812_2861_2862_2862_2867_2872_2889_2889_2890_2890_2902_2902_2904_2904_2919_2919_2923_2925_2927_2946_2946_2949_2972_2972_2972_2972_3001_3001_3001_3032_3033_3063_3076_3076_3076_3076_3098_3103_3110_3113_3119_3124_3146_3146_3158_3170_3172_3182_3183_3194_3195_3196_3203_3204_3204_3205_3207_3213_3218_3253_3253_3253_3257_3278_3281_3283_3309_3332_3360_3360_3364_3373_3374_3380_3385_3386_3388_3414_3431_3432_3433_3433_3433_3433_3433_3433_3434_3435_3435_3435_3435_3435_3435_3436_3443_3444_3459_3462_3464_3470_3470_3476_
3,3,太,ADV,262,549,811,4_7_8_11_14_15_17_23_31_35_41_54_59_77_77_83_83_93_103_103_104_110_116_118_126_144_146_150_156_157_161_166_203_209_212_217_226_238_247_257_266_268_268_270_274_280_321_342_344_345_350_352_354_355_360_363_363_368_368_374_374_379_388_397_398_399_412_415_416_417_423_424_433_433_435_443_450_458_465_495_495_499_499_506_519_522_531_544_546_555_573_611_615_617_620_624_626_628_631_649_655_666_669_697_736_737_738_750_750_762_773_777_782_785_787_795_798_806_806_806_820_825_831_841_841_842_842_843_854_856_863_865_870_875_878_883_886_887_889_890_894_895_897_898_905_912_915_920_941_943_947_949_955_958_961_971_971_981_982_982_988_1020_1021_1022_1024_1026_1026_1029_1029_1031_1032_1033_1036_1039_1039_1057_1057_1068_1069_1073_1075_1076_1080_1088_1088_1088_1090_1091_1091_1105_1112_1120_1127_1130_1134_1137_1146_1154_1155_1161_1162_1171_1171_1178_1178_1183_1189_1202_1212_1215_1216_1219_1221_1227_1229_1235_1253_1266_1266_1266_1266_1319_1324_1332_1332_1333_1334_1334_1334_1334_1348_1352_1356_1356_1361_1361_1374_1394_1394_1396_1403_1403_1405_1408_1413_1421_1423_1425_1425_1425_1428_1429_1431_1453_1456_1463_1468_1472_1472_1472_1473_,2018_2019_2020_2020_2022_2027_2033_2035_2036_2037_2037_2037_2038_2038_2040_2040_2044_2048_2049_2049_2051_2052_2052_2054_2056_2056_2057_2058_2060_2069_2069_2075_2076_2076_2076_2094_2094_2094_2096_2096_2096_2101_2102_2105_2105_2111_2120_2121_2122_2122_2127_2128_2134_2137_2141_2144_2145_2149_2151_2151_2158_2159_2161_2163_2167_2167_2167_2167_2167_2168_2169_2172_2175_2179_2179_2179_2183_2184_2191_2193_2195_2195_2202_2204_2205_2207_2208_2211_2215_2229_2231_2231_2237_2238_2242_2264_2266_2271_2273_2274_2275_2286_2289_2290_2296_2298_2301_2312_2312_2315_2315_2327_2329_2344_2345_2345_2345_2349_2350_2350_2350_2362_2370_2373_2378_2378_2381_2383_2384_2389_2390_2390_2392_2393_2397_2405_2405_2407_2407_2412_2414_2416_2418_2432_2435_2450_2450_2450_2450_2452_2453_2453_2453_2453_2454_2455_2475_2478_2483_2483_2490_2490_2492_2492_2498_2500_2501_2516_2518_2521_2522_2522_2523_2525_2527_2536_2536_2546_2546_2547_2553_2559_2563_2568_2571_2571_2572_2572_2573_2574_2574_2576_2585_2586_2586_2586_2586_2592_2598_2606_2606_2623_2630_2632_2633_2637_2638_2648_2649_2657_2658_2659_2659_2662_2662_2662_2666_2667_2671_2690_2690_2703_2705_2706_2713_2714_2714_2714_2717_2717_2717_2718_2720_2720_2720_2721_2726_2726_2727_2727_2728_2729_2733_2738_2740_2743_2744_2746_2750_2760_2761_2762_2766_2773_2774_2777_2779_2780_2780_2783_2784_2791_2791_2791_2794_2794_2794_2795_2803_2804_2806_2807_2809_2809_2815_2816_2818_2820_2824_2824_2826_2826_2828_2831_2831_2831_2832_2832_2832_2839_2845_2847_2853_2859_2862_2864_2864_2865_2868_2871_2871_2874_2874_2875_2882_2882_2883_2884_2886_2908_2913_2915_2915_2918_2919_2919_2919_2920_2922_2922_2923_2923_2925_2928_2932_2938_2938_2941_2946_2951_2951_2952_2953_2953_2954_2954_2955_2968_2970_2975_2975_2977_2978_2986_2986_2993_2994_2998_2999_3001_3005_3011_3011_3029_3029_3031_3032_3032_3033_3033_3038_3039_3040_3044_3048_3055_3060_3061_3064_3072_3074_3080_3083_3089_3091_3094_3102_3103_3104_3105_3108_3109_3114_3114_3119_3123_3123_3124_3133_3137_3140_3149_3154_3155_3158_3158_3159_3159_3161_3164_3175_3175_3176_3176_3177_3184_3185_3187_3189_3201_3202_3202_3205_3207_3208_3211_3213_3216_3218_3224_3224_3226_3237_3243_3243_3245_3246_3246_3246_3249_3249_3249_3249_3252_3253_3253_3255_3256_3257_3257_3278_3281_3282_3282_3282_3284_3285_3287_3287_3293_3294_3297_3297_3300_3300_3303_3303_3304_3304_3310_3311_3313_3313_3319_3319_3319_3320_3321_3322_3323_3325_3331_3332_3333_3335_3336_3338_3339_3339_3340_3343_3345_3347_3350_3351_3360_3363_3363_3366_3376_3378_3383_3384_3387_3389_3390_3396_3397_3397_3401_3403_3406_3408_3409_3409_3409_3411_3414_3414_3414_3415_3416_3417_3417_3421_3422_3425_3426_3427_3428_3430_3431_3431_3431_3432_3432_3432_3440_3442_3443_3444_3450_3452_3455_3457_3458_3458_3458_3458_3458_3458_3463_3467_3471_3472_3472_3485_3486_
3,3,好,Vi,884,511,1395,3_4_7_7_8_9_10_11_12_12_16_16_17_19_19_20_20_21_22_24_26_28_28_29_30_32_34_36_38_38_39_39_40_42_43_44_51_51_51_52_53_53_58_58_64_67_67_68_68_71_74_74_75_75_77_79_79_83_85_85_90_91_92_94_94_98_101_101_102_103_103_107_107_108_108_109_109_114_114_118_118_121_121_126_126_129_129_135_139_139_139_140_141_142_144_146_147_148_155_156_156_157_158_160_163_168_171_171_173_176_177_177_177_179_181_182_183_184_185_186_187_187_189_191_192_193_194_195_196_197_197_199_205_211_212_212_212_215_216_217_218_223_225_225_227_230_230_231_232_234_235_236_237_239_239_239_240_241_244_245_245_245_245_246_246_247_247_247_249_249_249_250_251_254_255_255_255_255_256_256_257_257_257_259_259_261_261_264_264_265_265_266_267_270_273_273_274_274_276_279_280_281_281_283_290_290_295_297_298_303_305_306_308_312_315_317_317_318_320_324_328_333_335_335_335_335_336_337_339_339_339_339_340_341_342_342_343_343_344_344_345_348_348_350_352_352_353_353_354_354_355_360_362_364_365_366_366_367_369_370_371_371_373_374_374_376_377_381_382_382_384_385_385_388_390_393_393_394_396_397_401_401_403_407_408_409_413_414_415_417_420_421_422_422_427_427_428_429_430_434_436_444_445_448_449_450_451_451_452_453_456_457_458_459_459_462_466_467_477_477_482_482_484_486_486_491_491_493_494_496_496_497_501_505_505_520_520_521_521_521_521_522_522_522_526_526_526_527_529_529_530_530_530_530_531_531_531_535_535_535_536_538_541_544_546_548_551_551_552_552_553_553_554_554_555_557_560_560_561_561_562_562_563_563_566_566_567_572_573_573_573_575_575_576_581_584_584_585_589_593_596_600_602_605_609_611_617_620_626_628_628_629_630_631_632_634_640_641_642_644_644_648_648_650_654_654_656_657_657_658_661_662_663_663_663_663_663_663_664_665_667_668_669_671_674_678_678_684_685_686_690_691_696_699_701_704_706_708_710_714_714_716_718_720_724_724_726_730_731_732_733_734_738_739_741_744_744_746_747_751_753_754_754_754_761_763_765_773_773_777_777_779_780_782_783_784_785_792_793_794_794_794_795_796_797_797_797_798_799_799_800_801_802_802_803_803_809_814_817_819_820_821_824_824_828_828_828_831_834_839_842_843_843_843_843_845_845_847_847_852_852_856_856_857_859_859_859_861_861_865_865_866_868_868_868_869_870_870_872_872_872_873_874_875_875_877_878_878_880_880_880_881_882_883_883_888_889_889_890_890_890_896_897_897_898_898_898_901_902_910_912_912_912_912_914_914_914_916_919_920_921_923_924_924_928_931_932_932_934_934_935_936_939_939_939_944_944_947_950_951_952_953_955_955_956_960_960_961_973_979_981_981_982_983_984_984_990_993_1002_1005_1005_1005_1007_1010_1015_1017_1020_1022_1025_1031_1031_1033_1036_1036_1037_1039_1042_1042_1043_1043_1046_1048_1050_1056_1057_1061_1063_1066_1067_1068_1069_1072_1074_1075_1076_1079_1081_1082_1084_1084_1085_1087_1091_1092_1093_1094_1103_1105_1105_1107_1109_1112_1112_1113_1117_1120_1120_1121_1124_1124_1126_1131_1131_1133_1139_1141_1143_1149_1149_1151_1152_1153_1156_1156_1158_1159_1160_1164_1166_1167_1167_1168_1171_1173_1174_1174_1175_1178_1180_1181_1181_1187_1187_1201_1204_1208_1209_1211_1211_1212_1212_1215_1220_1222_1228_1230_1235_1236_1236_1237_1238_1238_1239_1241_1242_1242_1245_1246_1246_1250_1251_1251_1252_1252_1253_1254_1254_1268_1278_1279_1280_1281_1285_1286_1287_1288_1295_1296_1297_1299_1300_1301_1302_1304_1304_1305_1307_1307_1308_1311_1311_1312_1315_1315_1319_1319_1319_1319_1324_1324_1324_1324_1328_1330_1332_1334_1344_1345_1346_1347_1348_1348_1350_1352_1353_1366_1366_1374_1378_1383_1392_1394_1395_1396_1397_1398_1398_1399_1401_1403_1404_1405_1406_1407_1407_1408_1408_1413_1413_1421_1421_1423_1423_1423_1425_1425_1429_1436_1436_1436_1440_1440_1445_1445_1452_1457_1459_1461_1461_1464_1466_1466_1471_1472_1473_1474_1474_1477_1480_1484_1487_1489_1491_1492_1494_1495_1495_1496_1496_1499_1499_1500_1500_,2008_2014_2018_2025_2036_2037_2037_2038_2040_2043_2044_2045_2050_2050_2050_2053_2053_2053_2055_2056_2058_2058_2060_2066_2069_2070_2078_2079_2081_2083_2084_2085_2089_2095_2097_2098_2099_2101_2102_2104_2104_2104_2105_2108_2109_2110_2116_2119_2134_2138_2144_2145_2151_2151_2154_2154_2161_2161_2161_2162_2162_2164_2168_2174_2175_2175_2177_2179_2180_2183_2183_2189_2197_2198_2198_2198_2199_2201_2207_2211_2211_2211_2212_2220_2222_2229_2231_2231_2232_2232_2234_2239_2244_2245_2246_2247_2252_2253_2260_2260_2260_2260_2264_2266_2267_2267_2268_2276_2276_2278_2283_2294_2310_2311_2312_2313_2315_2316_2324_2338_2340_2341_2342_2343_2346_2347_2351_2360_2361_2387_2387_2387_2414_2414_2432_2435_2439_2444_2445_2445_2445_2446_2446_2446_2450_2452_2453_2458_2458_2458_2464_2464_2466_2466_2474_2475_2479_2484_2484_2484_2489_2489_2492_2500_2500_2501_2501_2505_2505_2514_2520_2520_2522_2523_2525_2529_2537_2538_2539_2543_2546_2547_2549_2550_2553_2556_2559_2561_2562_2566_2573_2578_2608_2609_2609_2611_2626_2630_2630_2630_2637_2638_2641_2645_2647_2665_2670_2671_2680_2691_2698_2702_2703_2704_2705_2706_2715_2716_2717_2717_2718_2720_2720_2721_2742_2743_2746_2747_2753_2756_2759_2761_2762_2769_2769_2769_2770_2770_2770_2772_2774_2775_2775_2775_2792_2793_2795_2797_2797_2802_2802_2803_2803_2804_2807_2807_2807_2809_2814_2814_2815_2815_2815_2816_2818_2823_2825_2827_2829_2837_2838_2846_2846_2847_2848_2857_2858_2866_2869_2869_2870_2873_2877_2878_2881_2882_2883_2883_2884_2886_2889_2890_2892_2896_2896_2898_2898_2902_2904_2914_2925_2925_2943_2945_2946_2953_2955_2961_2961_2961_2963_2963_2963_2967_2969_2977_2990_2992_2998_3003_3005_3012_3016_3031_3032_3033_3038_3039_3041_3054_3055_3056_3056_3059_3059_3060_3065_3067_3076_3076_3076_3076_3083_3086_3086_3091_3095_3095_3096_3101_3103_3107_3112_3112_3117_3119_3121_3124_3126_3131_3134_3137_3138_3139_3140_3144_3145_3146_3149_3151_3152_3153_3156_3161_3163_3166_3178_3184_3184_3186_3186_3188_3188_3194_3196_3196_3196_3202_3205_3210_3210_3215_3215_3223_3225_3228_3229_3231_3232_3232_3246_3246_3246_3246_3247_3252_3254_3255_3256_3259_3267_3268_3280_3281_3287_3294_3308_3309_3312_3313_3318_3318_3318_3319_3324_3324_3329_3333_3333_3333_3334_3347_3347_3351_3352_3354_3360_3360_3360_3364_3365_3367_3368_3376_3376_3378_3378_3383_3383_3383_3384_3384_3384_3397_3413_3413_3415_3417_3418_3418_3423_3424_3429_3431_3431_3432_3432_3433_3433_3433_3433_3433_3433_3433_3433_3435_3435_3435_3435_3435_3435_3435_3435_3437_3443_3448_3448_3453_3453_3459_3463_3463_3466_3466_3468_3468_3470_3471_3471_3479_3481_3487_3488_3489_3490_3491_3494_3495_3496_3497_
3,3,性價,N,108,60,168,7_69_76_91_111_117_125_140_156_164_169_176_231_245_255_287_298_306_324_373_391_402_439_447_451_455_459_548_557_611_620_686_691_732_750_787_795_798_814_815_820_828_833_836_869_877_890_898_901_902_903_905_906_907_924_932_940_962_985_986_1020_1045_1049_1050_1065_1067_1073_1074_1080_1093_1094_1105_1139_1149_1156_1163_1165_1167_1168_1173_1173_1174_1175_1180_1180_1216_1262_1268_1277_1281_1282_1284_1288_1289_1317_1320_1322_1325_1327_1328_1341_1353_1369_1374_1378_1418_1473_,2074_2075_2089_2252_2253_2281_2282_2318_2319_2320_2409_2410_2478_2522_2571_2607_2658_2671_2671_2671_2703_2728_2729_2740_2840_2920_2941_2980_3042_3057_3059_3065_3067_3080_3090_3091_3095_3154_3155_3158_3164_3171_3173_3177_3192_3231_3255_3256_3304_3320_3333_3340_3345_3345_3372_3400_3409_3466_3492_
3,3,點評,N,104,153,257,7_9_51_115_133_136_137_183_186_193_196_227_241_246_251_256_287_320_320_334_364_369_434_434_435_443_551_551_560_560_588_590_611_620_630_630_631_641_662_711_711_713_715_721_721_723_725_732_795_798_803_821_842_888_891_896_899_901_902_913_949_962_976_977_978_1011_1029_1031_1034_1038_1048_1061_1072_1073_1079_1080_1081_1082_1114_1149_1156_1169_1176_1202_1202_1203_1208_1270_1273_1311_1311_1315_1315_1343_1428_1429_1437_1474_1480_1487_1489_1492_1495_,2037_2038_2040_2057_2081_2083_2122_2134_2154_2193_2197_2261_2263_2283_2289_2299_2299_2299_2302_2302_2302_2314_2317_2345_2350_2360_2361_2368_2369_2417_2436_2445_2446_2450_2453_2464_2466_2473_2475_2475_2484_2484_2503_2516_2518_2534_2547_2551_2565_2573_2587_2593_2596_2597_2608_2609_2621_2630_2647_2684_2684_2687_2687_2733_2733_2737_2765_2779_2791_2794_2815_2827_2831_2832_2842_2843_2852_2854_2877_2878_2889_2890_2909_2910_2941_2945_2956_2957_2976_2976_2976_3000_3013_3014_3029_3037_3037_3038_3039_3055_3059_3065_3067_3071_3084_3103_3115_3119_3124_3129_3130_3158_3165_3203_3205_3206_3232_3232_3233_3253_3254_3257_3258_3269_3274_3288_3296_3296_3316_3327_3333_3345_3353_3355_3373_3373_3374_3374_3417_3418_3423_3424_3431_3432_3433_3435_3444_3448_3453_3480_3482_3483_
3,3,這樣,Vi,57,198,255,7_89_118_126_152_154_163_168_173_213_279_321_346_347_356_357_381_384_389_427_708_718_836_842_888_896_903_945_968_1002_1002_1005_1051_1054_1060_1069_1076_1087_1088_1091_1095_1186_1192_1208_1211_1211_1213_1214_1214_1215_1293_1319_1324_1328_1350_1472_,2037_2057_2062_2069_2070_2081_2083_2089_2105_2114_2117_2151_2161_2161_2175_2211_2211_2225_2226_2229_2232_2252_2252_2253_2253_2264_2305_2308_2335_2360_2361_2372_2375_2387_2391_2411_2425_2428_2454_2455_2460_2461_2480_2481_2482_2483_2486_2504_2510_2511_2525_2531_2531_2535_2537_2538_2558_2560_2565_2568_2569_2569_2569_2573_2590_2609_2609_2609_2609_2611_2625_2647_2647_2647_2690_2700_2701_2715_2716_2724_2724_2745_2746_2748_2750_2750_2753_2754_2771_2771_2806_2815_2816_2818_2824_2824_2824_2824_2824_2824_2824_2826_2826_2826_2826_2826_2826_2826_2836_2857_2858_2864_2869_2872_2872_2872_2902_2904_2908_2914_2922_2928_2933_2933_2934_2946_2958_2976_2976_3025_3027_3031_3038_3039_3057_3065_3067_3071_3076_3076_3076_3083_3084_3101_3102_3103_3103_3107_3116_3123_3132_3170_3172_3180_3181_3184_3193_3194_3210_3215_3226_3245_3246_3246_3253_3282_3291_3292_3296_3308_3319_3327_3327_3327_3344_3345_3359_3360_3363_3366_3366_3397_3405_3410_3425_3431_3432_3439_3440_3441_3442_3445_3448_3453_3458_3470_3472_
3,3,乾淨,Vi,198,87,285,4_7_8_12_16_18_40_45_52_65_66_68_72_73_75_82_88_91_92_94_99_100_103_109_133_139_175_176_181_183_191_193_198_199_205_216_233_246_253_256_280_294_297_302_305_307_309_311_313_328_333_366_371_374_388_392_400_407_408_411_422_429_431_434_438_465_470_471_474_475_524_533_570_579_629_639_640_678_686_691_695_698_699_727_735_740_746_755_757_762_767_768_773_777_780_787_787_791_804_806_820_823_828_835_843_849_885_887_888_889_893_895_896_897_903_907_907_910_912_913_919_923_931_955_957_966_972_981_982_983_985_998_1018_1020_1024_1037_1044_1051_1054_1056_1068_1070_1075_1077_1082_1086_1088_1091_1113_1121_1139_1141_1143_1151_1158_1181_1185_1187_1191_1211_1232_1235_1241_1242_1245_1246_1252_1266_1267_1276_1277_1283_1284_1309_1311_1313_1315_1327_1337_1346_1349_1350_1358_1388_1392_1394_1401_1403_1409_1419_1421_1425_1433_1435_1452_1480_1487_,2038_2040_2078_2116_2119_2139_2143_2161_2184_2198_2231_2291_2344_2349_2380_2392_2412_2412_2460_2461_2484_2484_2528_2528_2534_2549_2550_2556_2567_2606_2607_2647_2705_2706_2718_2721_2742_2756_2783_2809_2839_2883_2913_2951_2967_2974_2975_3013_3014_3030_3056_3092_3099_3101_3112_3118_3119_3124_3134_3153_3162_3168_3169_3177_3178_3184_3201_3202_3202_3205_3207_3207_3293_3294_3304_3318_3318_3344_3358_3388_3417_3417_3443_3452_3457_3485_
3,3,剛好,ADV,8,6,14,7_203_209_223_268_288_1049_,2649_2753_2753_2952_3274_
3,3,服務員,N,216,422,638,7_12_12_15_79_85_89_92_99_102_103_107_109_144_155_155_158_161_166_173_181_186_186_186_191_196_196_196_211_214_215_217_226_230_242_246_252_256_281_281_281_281_316_316_363_363_368_368_373_377_379_379_413_422_451_459_470_474_520_520_521_521_522_522_529_529_530_530_531_531_548_551_553_557_560_562_610_619_629_639_640_641_641_701_707_710_710_710_710_710_714_714_714_714_714_714_717_720_720_720_720_720_724_724_724_724_724_724_736_745_749_749_755_757_787_793_794_796_797_799_835_871_879_910_943_950_964_966_973_982_984_989_992_1003_1019_1020_1025_1029_1033_1045_1050_1055_1057_1060_1060_1061_1062_1062_1072_1079_1081_1087_1088_1088_1091_1112_1120_1145_1149_1156_1164_1166_1168_1169_1175_1176_1181_1182_1187_1188_1194_1208_1211_1213_1228_1230_1232_1235_1266_1290_1296_1300_1302_1305_1309_1311_1313_1315_1319_1324_1330_1340_1366_1366_1378_1383_1386_1418_1430_1430_1430_1430_1431_1431_1438_1451_1452_1462_1467_1471_1481_1488_1495_1498_1499_,2016_2016_2016_2016_2019_2019_2019_2033_2035_2036_2036_2037_2037_2037_2038_2039_2040_2041_2048_2057_2072_2072_2072_2081_2081_2081_2083_2083_2083_2084_2084_2085_2085_2086_2095_2097_2107_2110_2126_2131_2133_2136_2139_2139_2140_2143_2143_2147_2153_2155_2155_2158_2170_2175_2183_2186_2186_2186_2196_2205_2205_2211_2220_2220_2220_2222_2222_2222_2225_2225_2225_2225_2226_2226_2226_2226_2228_2231_2231_2232_2246_2247_2258_2258_2258_2258_2258_2258_2259_2259_2259_2259_2259_2259_2260_2270_2284_2287_2288_2291_2296_2296_2309_2322_2322_2333_2334_2339_2362_2362_2363_2383_2387_2392_2398_2411_2445_2445_2445_2445_2445_2445_2445_2445_2445_2445_2446_2446_2446_2446_2446_2446_2446_2446_2446_2446_2450_2450_2453_2453_2460_2461_2471_2471_2471_2475_2489_2497_2509_2509_2516_2517_2518_2519_2521_2521_2522_2523_2525_2531_2531_2540_2541_2544_2552_2553_2560_2561_2562_2565_2581_2582_2594_2594_2594_2594_2594_2608_2608_2609_2609_2611_2616_2631_2637_2637_2638_2638_2674_2674_2674_2680_2683_2686_2691_2700_2701_2703_2707_2708_2718_2721_2724_2724_2742_2742_2747_2749_2753_2753_2754_2754_2759_2759_2769_2769_2769_2769_2769_2769_2770_2770_2770_2770_2770_2770_2803_2807_2809_2809_2827_2828_2828_2828_2828_2828_2828_2829_2829_2829_2847_2849_2853_2853_2855_2856_2861_2861_2861_2862_2862_2865_2869_2873_2873_2879_2880_2897_2898_2907_2914_2914_2914_2923_2923_2923_2924_2928_2928_2928_2933_2933_2933_2938_2942_2946_2946_2953_2958_2958_2960_2962_2979_2987_2988_2993_2994_3011_3012_3013_3020_3031_3040_3040_3049_3049_3058_3062_3073_3073_3076_3076_3083_3084_3087_3093_3095_3097_3103_3105_3112_3115_3115_3153_3163_3170_3172_3174_3179_3184_3184_3184_3185_3202_3213_3213_3218_3218_3223_3231_3237_3245_3245_3246_3246_3246_3257_3278_3280_3281_3286_3288_3288_3289_3289_3289_3289_3290_3290_3290_3290_3293_3296_3306_3308_3308_3308_3308_3313_3316_3327_3333_3341_3341_3341_3360_3360_3360_3360_3360_3373_3373_3374_3374_3386_3386_3386_3388_3397_3397_3397_3397_3413_3422_3431_3432_3433_3433_3433_3433_3433_3435_3435_3435_3435_3435_3443_3446_3446_3446_3446_3447_3448_3448_3450_3451_3451_3453_3453_3455_3456_3456_3460_3462_3464_3465_3473_3475_3483_3494_3496_
3,3,我,N,873,2235,3108,7_9_12_12_13_14_16_16_16_23_23_31_31_35_35_35_35_41_42_42_42_43_51_51_52_52_52_52_52_52_67_67_74_74_92_92_105_106_109_109_112_113_115_119_119_119_119_119_127_127_127_127_127_137_137_139_144_147_147_151_153_153_155_155_155_155_162_162_163_163_163_163_167_167_168_168_168_168_173_173_175_176_178_182_186_186_186_186_186_186_186_186_186_186_186_186_186_188_192_196_196_196_196_196_196_196_196_196_196_196_196_196_199_203_203_203_204_205_209_209_209_210_211_213_213_215_222_223_225_225_226_227_229_229_229_231_231_231_235_238_238_238_240_242_250_252_263_269_281_289_289_290_295_298_298_298_303_306_306_306_308_309_312_313_316_316_316_316_316_320_320_320_320_320_320_320_320_320_321_321_321_321_324_334_336_339_339_351_351_361_361_364_364_365_369_369_370_377_379_379_381_384_388_388_388_388_388_390_396_397_397_401_401_404_407_407_407_408_408_410_410_412_427_429_431_434_434_434_434_434_434_434_434_451_459_460_460_461_461_468_472_482_482_491_491_497_498_499_508_521_521_521_521_521_522_526_528_530_530_530_530_530_531_535_537_540_540_546_546_546_546_546_546_546_546_551_554_554_554_555_555_555_555_555_555_555_555_560_563_563_563_568_570_570_573_577_579_579_587_591_592_599_601_608_611_611_620_620_628_628_628_630_630_630_630_630_634_649_649_655_655_662_662_663_663_665_666_674_674_701_701_701_701_701_701_701_701_704_704_706_706_707_709_710_710_710_710_710_710_710_710_710_710_710_710_710_710_711_714_714_714_714_714_714_714_714_714_714_714_714_714_714_715_716_716_717_719_720_720_720_720_720_720_720_720_720_720_720_720_720_720_721_724_724_724_724_724_724_724_724_724_724_724_724_724_724_725_726_726_736_736_736_736_738_738_739_745_745_747_747_755_757_765_771_771_772_775_775_776_779_779_779_782_783_784_787_787_787_787_788_788_788_788_793_793_793_793_794_794_794_794_794_794_794_796_796_796_796_797_797_797_797_797_797_797_799_803_813_813_817_819_828_828_835_835_835_835_835_835_835_837_841_842_843_843_846_848_852_852_856_857_861_861_865_866_870_871_872_872_874_876_876_878_879_880_880_882_884_884_885_885_885_885_885_885_885_885_887_887_887_887_887_888_889_889_889_891_893_893_893_893_893_893_893_893_895_895_895_895_895_896_897_897_897_899_901_901_902_902_907_910_910_912_912_914_923_923_923_924_924_924_924_931_931_931_932_932_932_932_934_935_938_939_939_941_944_944_945_948_956_964_971_974_978_981_982_982_982_983_984_986_990_990_993_993_1002_1007_1019_1020_1020_1020_1020_1021_1025_1025_1025_1025_1025_1029_1033_1034_1038_1049_1049_1049_1054_1055_1057_1060_1060_1060_1062_1062_1062_1066_1067_1067_1069_1070_1072_1074_1074_1076_1077_1079_1082_1082_1082_1083_1084_1088_1088_1088_1088_1088_1088_1088_1088_1089_1096_1097_1097_1098_1106_1106_1112_1112_1112_1114_1115_1115_1115_1115_1115_1120_1120_1120_1124_1124_1127_1130_1131_1131_1134_1135_1137_1139_1141_1141_1141_1143_1143_1143_1146_1167_1167_1168_1168_1168_1169_1169_1169_1169_1169_1170_1170_1170_1172_1172_1173_1173_1174_1174_1175_1175_1175_1176_1176_1176_1176_1176_1177_1177_1177_1179_1179_1180_1180_1195_1198_1203_1203_1203_1204_1208_1208_1208_1208_1208_1211_1211_1211_1211_1211_1211_1211_1211_1211_1220_1222_1232_1235_1235_1236_1240_1240_1242_1242_1246_1246_1249_1254_1259_1259_1259_1259_1266_1270_1273_1309_1309_1311_1311_1311_1311_1313_1313_1315_1315_1315_1315_1318_1319_1319_1319_1319_1319_1319_1319_1319_1323_1324_1324_1324_1324_1324_1324_1324_1324_1328_1332_1336_1336_1338_1356_1361_1366_1367_1367_1367_1371_1387_1387_1387_1393_1398_1398_1398_1402_1407_1407_1407_1411_1416_1418_1418_1423_1423_1423_1423_1423_1423_1428_1428_1428_1428_1429_1430_1430_1433_1433_1433_1435_1435_1435_1436_1437_1452_1454_1457_1459_1461_1462_1464_1466_1467_1469_1469_1469_1470_1470_1470_1472_1472_1472_1472_1472_1472_1472_1472_1472_1472_1472_1473_1495_1495_1495_1495_1495_1497_1497_1499_,2005_2009_2009_2009_2012_2012_2015_2015_2016_2016_2016_2016_2016_2016_2016_2016_2019_2020_2024_2029_2029_2030_2031_2037_2037_2037_2037_2037_2037_2037_2037_2037_2037_2037_2037_2037_2037_2037_2038_2038_2040_2040_2042_2043_2043_2043_2044_2045_2045_2045_2048_2049_2052_2058_2058_2059_2059_2063_2069_2069_2069_2069_2070_2070_2070_2071_2071_2072_2072_2072_2072_2072_2072_2074_2075_2081_2081_2081_2081_2081_2081_2081_2081_2081_2081_2081_2081_2081_2081_2081_2081_2081_2081_2081_2081_2081_2081_2081_2083_2083_2083_2083_2083_2083_2083_2083_2083_2083_2083_2083_2083_2083_2083_2083_2083_2083_2083_2083_2083_2083_2083_2084_2085_2090_2090_2090_2090_2095_2095_2095_2097_2097_2097_2098_2099_2099_2099_2099_2099_2099_2099_2099_2099_2099_2101_2102_2104_2104_2104_2104_2104_2104_2104_2104_2104_2104_2104_2104_2104_2106_2114_2116_2117_2119_2124_2124_2124_2126_2126_2126_2126_2126_2126_2126_2126_2126_2126_2126_2126_2126_2126_2126_2126_2126_2126_2127_2134_2134_2134_2135_2144_2145_2146_2146_2148_2148_2149_2149_2151_2155_2155_2155_2159_2159_2161_2162_2162_2162_2162_2162_2162_2162_2162_2164_2165_2167_2174_2175_2175_2175_2175_2175_2175_2175_2175_2177_2177_2177_2177_2177_2178_2178_2178_2184_2186_2190_2192_2193_2193_2195_2197_2200_2201_2201_2206_2207_2208_2208_2211_2211_2211_2211_2211_2211_2211_2211_2211_2211_2220_2220_2220_2222_2222_2222_2225_2225_2225_2226_2226_2226_2229_2231_2231_2231_2231_2231_2231_2232_2232_2233_2234_2239_2244_2244_2244_2244_2244_2245_2245_2245_2245_2245_2246_2247_2247_2247_2247_2247_2247_2252_2252_2252_2252_2252_2252_2252_2252_2252_2252_2252_2252_2252_2252_2252_2253_2253_2253_2253_2253_2253_2253_2253_2253_2253_2253_2253_2253_2253_2253_2255_2257_2258_2258_2258_2258_2259_2259_2259_2259_2260_2260_2260_2260_2261_2263_2264_2266_2269_2269_2269_2269_2269_2269_2269_2269_2271_2271_2273_2273_2275_2276_2276_2276_2279_2279_2280_2283_2283_2283_2284_2287_2287_2287_2287_2288_2288_2288_2288_2290_2290_2290_2290_2290_2291_2294_2297_2298_2298_2298_2299_2300_2301_2301_2301_2302_2305_2308_2309_2309_2309_2309_2309_2309_2309_2309_2309_2309_2309_2309_2309_2309_2309_2309_2309_2313_2313_2314_2314_2314_2316_2316_2317_2317_2317_2322_2322_2322_2322_2325_2326_2333_2334_2335_2335_2338_2338_2338_2338_2342_2342_2342_2342_2342_2342_2342_2342_2342_2342_2342_2342_2342_2342_2344_2344_2349_2349_2353_2353_2354_2354_2354_2355_2355_2355_2356_2359_2359_2359_2360_2360_2360_2360_2360_2360_2360_2360_2360_2360_2360_2360_2360_2360_2360_2361_2361_2361_2361_2361_2361_2361_2361_2361_2361_2361_2361_2361_2361_2361_2372_2372_2372_2372_2372_2372_2372_2372_2372_2375_2375_2375_2375_2375_2375_2375_2375_2375_2376_2376_2376_2383_2383_2383_2383_2383_2384_2384_2384_2386_2386_2387_2387_2387_2391_2391_2391_2391_2391_2392_2392_2394_2394_2394_2398_2406_2408_2411_2411_2411_2412_2412_2416_2416_2416_2417_2417_2417_2417_2417_2419_2425_2428_2434_2436_2436_2439_2445_2445_2445_2445_2445_2445_2445_2445_2445_2445_2445_2446_2446_2446_2446_2446_2446_2446_2446_2446_2446_2446_2450_2450_2450_2450_2450_2450_2450_2452_2452_2452_2453_2453_2453_2453_2453_2453_2453_2454_2454_2454_2454_2454_2454_2455_2455_2455_2455_2455_2455_2458_2458_2458_2462_2462_2473_2475_2475_2475_2475_2477_2483_2483_2483_2483_2484_2491_2494_2494_2494_2494_2494_2494_2494_2494_2494_2495_2495_2495_2495_2495_2495_2495_2495_2495_2500_2501_2502_2502_2510_2510_2510_2510_2510_2511_2511_2511_2511_2511_2513_2516_2516_2516_2516_2516_2516_2516_2516_2516_2516_2516_2516_2516_2516_2516_2516_2516_2517_2517_2518_2518_2518_2518_2518_2518_2518_2518_2518_2518_2518_2518_2518_2518_2518_2518_2518_2519_2519_2521_2521_2521_2521_2522_2522_2522_2525_2526_2526_2527_2527_2527_2527_2527_2527_2527_2527_2528_2528_2528_2529_2529_2529_2529_2530_2530_2530_2530_2530_2530_2530_2530_2531_2532_2533_2536_2536_2540_2540_2541_2544_2544_2544_2544_2549_2549_2549_2549_2549_2549_2549_2549_2549_2549_2549_2549_2549_2549_2549_2549_2549_2549_2550_2550_2550_2550_2550_2550_2550_2550_2550_2550_2550_2550_2550_2550_2550_2550_2550_2550_2551_2553_2553_2554_2554_2554_2554_2554_2554_2555_2555_2555_2555_2555_2555_2561_2562_2565_2565_2565_2565_2567_2572_2572_2572_2572_2572_2573_2573_2573_2575_2579_2579_2579_2579_2579_2582_2582_2582_2582_2582_2582_2582_2582_2582_2587_2590_2592_2593_2594_2596_2596_2596_2596_2596_2596_2596_2596_2597_2597_2597_2597_2597_2597_2597_2597_2603_2603_2604_2604_2604_2604_2604_2604_2604_2604_2604_2605_2605_2606_2608_2608_2608_2608_2608_2608_2608_2608_2608_2608_2608_2608_2609_2609_2609_2609_2609_2609_2609_2609_2609_2609_2609_2609_2609_2609_2609_2609_2609_2609_2611_2611_2615_2615_2615_2615_2615_2616_2616_2616_2616_2616_2616_2616_2621_2623_2625_2631_2631_2632_2633_2636_2636_2637_2637_2637_2637_2637_2637_2638_2638_2638_2638_2638_2638_2639_2640_2642_2646_2647_2647_2647_2647_2647_2648_2648_2650_2651_2651_2653_2654_2654_2657_2657_2657_2662_2662_2662_2669_2669_2671_2671_2671_2671_2671_2675_2675_2677_2677_2680_2680_2680_2680_2680_2680_2680_2680_2680_2680_2680_2680_2680_2683_2686_2688_2690_2690_2691_2691_2691_2691_2691_2698_2700_2700_2700_2701_2701_2701_2702_2703_2703_2703_2704_2704_2705_2705_2706_2706_2707_2708_2717_2717_2718_2720_2720_2721_2723_2725_2730_2731_2731_2731_2731_2731_2731_2731_2731_2731_2731_2731_2731_2731_2731_2731_2731_2731_2731_2731_2731_2731_2731_2731_2735_2736_2739_2739_2739_2739_2739_2740_2740_2742_2742_2742_2742_2742_2742_2743_2743_2744_2744_2745_2746_2746_2746_2746_2746_2746_2746_2746_2746_2746_2746_2746_2746_2746_2746_2746_2746_2746_2746_2748_2748_2748_2750_2750_2753_2753_2754_2754_2754_2754_2754_2754_2754_2754_2756_2757_2758_2759_2759_2759_2761_2761_2761_2761_2762_2762_2762_2762_2766_2767_2767_2767_2767_2767_2767_2767_2767_2769_2769_2770_2770_2771_2771_2773_2775_2775_2775_2775_2775_2775_2775_2775_2775_2775_2775_2775_2775_2775_2777_2779_2779_2784_2784_2784_2786_2787_2788_2789_2791_2791_2791_2791_2791_2791_2797_2798_2798_2798_2800_2800_2800_2802_2803_2803_2803_2804_2806_2806_2806_2806_2809_2809_2809_2809_2809_2809_2809_2809_2809_2812_2814_2815_2816_2816_2816_2816_2816_2816_2816_2817_2818_2818_2818_2818_2818_2818_2818_2819_2822_2824_2824_2824_2824_2824_2824_2824_2824_2826_2826_2826_2826_2826_2826_2826_2826_2835_2835_2835_2836_2836_2837_2838_2838_2841_2842_2842_2842_2843_2843_2843_2846_2846_2846_2846_2846_2846_2846_2847_2848_2850_2850_2852_2852_2852_2852_2862_2862_2862_2862_2863_2864_2864_2864_2866_2867_2869_2869_2869_2872_2872_2872_2872_2872_2872_2882_2892_2897_2897_2902_2902_2902_2902_2902_2902_2902_2902_2902_2903_2903_2904_2904_2904_2904_2904_2904_2904_2904_2904_2905_2905_2908_2909_2910_2914_2914_2914_2914_2914_2915_2916_2922_2924_2925_2925_2925_2928_2934_2934_2934_2934_2938_2941_2941_2941_2945_2945_2945_2946_2946_2946_2946_2946_2946_2946_2946_2946_2946_2946_2949_2949_2953_2956_2956_2956_2956_2956_2957_2957_2957_2957_2957_2958_2958_2959_2960_2961_2962_2963_2964_2964_2967_2967_2967_2968_2968_2968_2970_2972_2972_2976_2976_2976_2978_2987_2995_2997_2997_2998_3000_3000_3000_3001_3001_3001_3001_3001_3001_3001_3001_3001_3001_3001_3001_3001_3001_3001_3001_3001_3001_3001_3001_3001_3001_3001_3003_3005_3005_3005_3007_3007_3008_3008_3009_3009_3009_3009_3010_3010_3010_3010_3016_3029_3031_3032_3032_3032_3032_3032_3033_3033_3033_3033_3033_3036_3037_3037_3037_3038_3038_3038_3039_3039_3039_3040_3040_3040_3040_3040_3040_3040_3041_3043_3043_3044_3044_3048_3048_3049_3049_3049_3055_3055_3055_3055_3055_3055_3057_3059_3059_3060_3062_3063_3063_3063_3063_3065_3065_3065_3067_3067_3067_3069_3070_3071_3071_3071_3071_3071_3072_3072_3072_3072_3072_3076_3076_3076_3076_3076_3076_3076_3076_3078_3079_3079_3079_3079_3082_3083_3083_3083_3083_3083_3083_3083_3083_3083_3083_3083_3083_3083_3083_3083_3083_3083_3083_3083_3084_3084_3084_3084_3085_3087_3087_3095_3095_3095_3095_3096_3098_3098_3099_3099_3099_3099_3099_3101_3103_3103_3103_3103_3103_3103_3103_3103_3103_3104_3105_3105_3105_3105_3105_3107_3108_3108_3108_3109_3109_3109_3110_3110_3110_3111_3111_3112_3112_3113_3119_3119_3119_3119_3124_3124_3124_3124_3132_3132_3132_3132_3132_3132_3140_3142_3142_3149_3149_3149_3150_3150_3150_3150_3150_3150_3150_3150_3150_3150_3150_3152_3158_3159_3159_3159_3159_3159_3161_3163_3163_3163_3170_3170_3172_3172_3175_3176_3177_3184_3184_3184_3184_3184_3184_3184_3184_3184_3185_3185_3185_3187_3187_3189_3189_3193_3194_3195_3195_3195_3195_3195_3195_3195_3196_3196_3196_3196_3196_3196_3210_3210_3210_3210_3210_3210_3212_3213_3213_3215_3215_3215_3215_3215_3215_3217_3218_3218_3224_3226_3226_3227_3227_3227_3227_3227_3227_3227_3227_3227_3231_3231_3231_3231_3231_3231_3231_3231_3231_3231_3231_3231_3231_3232_3232_3232_3232_3232_3232_3232_3232_3232_3232_3233_3233_3233_3234_3237_3242_3242_3242_3242_3243_3243_3243_3243_3243_3243_3243_3243_3244_3244_3245_3246_3246_3246_3253_3253_3253_3253_3253_3253_3253_3253_3253_3253_3253_3253_3254_3254_3254_3254_3254_3254_3255_3255_3255_3255_3255_3255_3255_3255_3255_3255_3255_3255_3255_3255_3255_3256_3256_3256_3256_3256_3256_3256_3256_3256_3256_3256_3256_3256_3256_3256_3257_3257_3257_3257_3257_3260_3260_3261_3262_3263_3264_3264_3266_3267_3268_3268_3268_3268_3270_3270_3270_3274_3274_3274_3274_3274_3274_3274_3275_3276_3276_3276_3278_3278_3278_3279_3279_3279_3279_3281_3281_3281_3281_3281_3281_3281_3281_3281_3281_3282_3282_3282_3282_3283_3283_3283_3283_3283_3283_3283_3283_3283_3287_3288_3288_3289_3289_3289_3289_3289_3289_3289_3289_3289_3289_3289_3289_3289_3290_3290_3290_3290_3290_3290_3290_3290_3290_3290_3290_3290_3290_3291_3291_3291_3291_3291_3291_3291_3292_3292_3292_3292_3292_3292_3292_3294_3294_3294_3296_3296_3296_3296_3298_3298_3301_3301_3305_3308_3308_3308_3308_3308_3308_3308_3308_3312_3312_3313_3324_3324_3325_3327_3327_3327_3327_3327_3327_3327_3329_3329_3329_3329_3329_3329_3329_3329_3329_3329_3329_3329_3331_3331_3331_3333_3333_3333_3333_3333_3333_3337_3340_3341_3341_3341_3341_3341_3341_3341_3341_3341_3344_3344_3345_3345_3345_3347_3347_3347_3347_3347_3349_3349_3360_3360_3360_3360_3360_3360_3360_3360_3361_3361_3362_3362_3363_3363_3363_3371_3372_3372_3373_3374_3379_3379_3386_3388_3388_3388_3388_3388_3388_3388_3388_3388_3388_3389_3389_3389_3390_3390_3390_3392_3392_3394_3394_3396_3397_3397_3397_3409_3409_3409_3409_3409_3409_3409_3413_3415_3415_3418_3418_3418_3418_3418_3418_3418_3421_3421_3423_3423_3423_3423_3424_3424_3424_3424_3431_3431_3431_3432_3432_3432_3433_3433_3433_3433_3433_3433_3433_3433_3433_3433_3433_3433_3433_3433_3433_3433_3433_3433_3433_3433_3433_3433_3433_3433_3433_3433_3433_3433_3433_3433_3433_3433_3433_3433_3433_3433_3433_3433_3433_3433_3433_3433_3433_3433_3433_3433_3434_3434_3435_3435_3435_3435_3435_3435_3435_3435_3435_3435_3435_3435_3435_3435_3435_3435_3435_3435_3435_3435_3435_3435_3435_3435_3435_3435_3435_3435_3435_3435_3435_3435_3435_3435_3435_3435_3435_3435_3435_3435_3435_3435_3435_3435_3435_3435_3436_3436_3440_3440_3442_3442_3443_3443_3443_3443_3443_3443_3443_3443_3443_3443_3443_3443_3443_3443_3443_3443_3443_3443_3443_3443_3445_3446_3446_3446_3446_3446_3446_3447_3447_3447_3447_3448_3448_3448_3448_3448_3451_3453_3453_3453_3453_3453_3456_3458_3458_3458_3458_3458_3458_3458_3458_3459_3459_3459_3460_3460_3460_3462_3462_3462_3462_3462_3462_3462_3466_3466_3466_3466_3466_3466_3470_3470_3470_3471_3473_3475_3475_3477_3478_3478_3478_3478_3478_3478_3478_3479_3481_3487_3487_3487_3487_3487_3487_3487_3488_3488_3489_3489_3490_3490_3491_3491_3495_3497_
3,3,4日,N,6,10,16,7_435_436_923_931_,2083_2299_2302_2589_2740_2746_2814_3133_3288_
3,3,3月,N,16,23,39,7_115_116_584_772_776_800_800_949_1034_1114_1347_1450_1469_1470_,2154_2305_2308_2432_2435_2473_2475_2575_2703_3084_3252_3253_3353_3355_3431_3432_3438_3443_3448_3448_3453_3453_
3,3,我們,N,424,711,1135,7_16_35_42_43_44_50_89_89_89_89_89_89_100_100_100_109_109_115_116_119_127_157_157_163_168_179_184_184_184_186_186_187_189_194_194_194_196_196_197_198_201_207_213_213_213_213_213_213_213_217_217_217_217_217_219_232_242_242_242_242_252_252_252_252_276_281_281_286_316_316_316_316_316_320_374_374_381_384_386_388_388_402_424_427_435_436_437_437_438_441_442_443_443_449_457_466_470_474_477_477_481_486_486_512_515_515_515_516_522_522_531_531_568_568_577_577_592_592_601_601_628_632_632_632_674_674_675_675_681_682_707_707_707_707_707_707_707_707_707_707_707_707_707_707_710_710_710_710_710_710_710_710_710_711_711_714_714_714_714_714_714_714_714_717_717_717_717_717_717_717_717_717_717_717_717_717_717_720_720_720_720_720_720_720_720_720_721_721_724_724_724_724_724_724_724_724_736_743_743_743_743_749_753_773_777_787_792_802_805_814_814_814_815_817_835_835_871_872_872_872_872_879_880_880_880_880_886_886_886_886_887_887_887_887_888_889_889_889_894_894_894_894_895_895_895_895_896_897_897_897_910_912_912_912_914_915_923_928_928_931_936_936_942_944_944_944_944_944_957_964_964_982_982_982_982_1028_1028_1028_1029_1029_1029_1030_1030_1030_1030_1031_1031_1031_1031_1031_1031_1031_1032_1032_1032_1032_1042_1054_1054_1054_1054_1054_1054_1054_1054_1054_1054_1054_1057_1057_1057_1060_1061_1061_1061_1061_1061_1061_1061_1061_1062_1062_1062_1062_1087_1087_1088_1088_1088_1088_1091_1091_1091_1091_1106_1112_1120_1124_1126_1126_1129_1131_1133_1133_1136_1145_1150_1157_1169_1169_1169_1170_1171_1172_1176_1176_1176_1177_1178_1179_1201_1211_1212_1212_1224_1226_1234_1238_1238_1250_1251_1251_1270_1273_1309_1309_1313_1313_1316_1319_1319_1319_1319_1321_1324_1324_1324_1324_1328_1332_1333_1333_1343_1343_1352_1371_1383_1383_1383_1425_1425_1430_1437_1437_1437_1443_1448_1450_1451_1451_1451_1469_1470_1472_1472_1472_1472_1472_1497_1497_1499_1499_,2037_2037_2037_2037_2037_2042_2047_2047_2047_2047_2047_2047_2047_2070_2070_2073_2090_2126_2126_2126_2134_2134_2134_2134_2134_2134_2134_2134_2134_2134_2134_2134_2161_2161_2177_2177_2191_2193_2193_2198_2204_2204_2204_2225_2226_2231_2231_2231_2231_2231_2231_2231_2231_2231_2232_2237_2238_2244_2245_2246_2258_2258_2258_2258_2258_2258_2258_2258_2259_2259_2259_2259_2259_2259_2259_2259_2264_2264_2264_2264_2264_2273_2284_2289_2289_2289_2289_2291_2291_2291_2295_2295_2295_2295_2295_2295_2305_2305_2305_2305_2305_2308_2308_2308_2308_2308_2309_2309_2322_2322_2322_2322_2322_2322_2333_2333_2334_2334_2337_2359_2359_2359_2359_2359_2359_2359_2359_2359_2360_2360_2361_2361_2377_2387_2390_2390_2406_2408_2411_2416_2416_2416_2432_2432_2435_2435_2445_2445_2445_2445_2445_2445_2446_2446_2446_2446_2446_2446_2454_2455_2464_2466_2467_2468_2475_2475_2481_2482_2483_2483_2483_2502_2504_2504_2509_2516_2517_2517_2517_2517_2518_2519_2519_2519_2519_2523_2523_2530_2530_2530_2530_2531_2574_2576_2582_2582_2582_2589_2589_2589_2590_2590_2590_2590_2594_2594_2594_2594_2595_2596_2597_2606_2606_2608_2609_2609_2611_2618_2623_2624_2624_2626_2630_2636_2671_2671_2671_2671_2671_2671_2671_2671_2671_2671_2672_2672_2702_2724_2731_2731_2731_2731_2737_2737_2740_2740_2742_2742_2746_2746_2746_2746_2746_2746_2746_2746_2746_2747_2747_2747_2750_2756_2759_2759_2761_2761_2761_2762_2762_2762_2769_2769_2769_2769_2770_2770_2770_2770_2771_2771_2779_2782_2796_2796_2798_2798_2800_2800_2814_2824_2824_2826_2826_2828_2828_2828_2828_2828_2836_2836_2836_2838_2840_2853_2857_2857_2857_2858_2858_2858_2861_2861_2861_2861_2861_2861_2862_2862_2862_2862_2862_2862_2863_2863_2863_2863_2864_2865_2869_2869_2869_2869_2869_2881_2881_2881_2908_2914_2914_2924_2928_2933_2933_2933_2933_2933_2933_2933_2934_2946_2946_2946_2956_2956_2956_2957_2957_2957_2965_2966_2967_2974_2974_2976_2976_2979_2983_2984_2987_2987_2987_2996_2999_3000_3007_3024_3024_3024_3026_3026_3026_3029_3029_3038_3038_3038_3038_3038_3039_3039_3039_3039_3039_3049_3049_3052_3052_3053_3053_3065_3067_3074_3076_3083_3084_3100_3100_3100_3101_3104_3115_3115_3115_3115_3115_3115_3115_3115_3115_3115_3115_3115_3115_3115_3129_3129_3129_3129_3129_3129_3129_3130_3130_3130_3130_3130_3130_3130_3139_3146_3146_3146_3146_3146_3146_3146_3146_3146_3146_3146_3146_3146_3163_3163_3163_3163_3163_3163_3163_3163_3168_3169_3177_3180_3180_3180_3182_3183_3184_3184_3184_3184_3184_3184_3184_3184_3184_3184_3185_3185_3202_3202_3205_3205_3213_3213_3213_3213_3213_3218_3218_3218_3218_3218_3223_3223_3223_3231_3233_3233_3233_3240_3243_3246_3246_3253_3253_3253_3253_3253_3253_3253_3253_3253_3253_3253_3253_3253_3253_3253_3253_3253_3253_3254_3272_3272_3274_3277_3279_3282_3288_3288_3293_3294_3308_3308_3308_3313_3313_3313_3315_3318_3318_3319_3319_3319_3319_3319_3324_3324_3324_3324_3324_3334_3345_3345_3345_3345_3345_3345_3345_3345_3351_3351_3351_3351_3351_3351_3351_3357_3360_3360_3360_3360_3360_3360_3360_3360_3360_3360_3360_3360_3360_3360_3360_3360_3360_3360_3360_3360_3360_3366_3367_3367_3367_3367_3367_3368_3368_3368_3368_3368_3371_3371_3383_3384_3392_3392_3394_3394_3397_3397_3397_3397_3397_3397_3405_3410_3414_3415_3421_3421_3423_3424_3431_3431_3431_3431_3432_3432_3432_3432_3433_3433_3433_3433_3433_3433_3433_3433_3433_3433_3433_3433_3433_3433_3433_3433_3433_3433_3433_3433_3433_3434_3434_3434_3435_3435_3435_3435_3435_3435_3435_3435_3435_3435_3435_3435_3435_3435_3435_3435_3435_3435_3435_3435_3435_3436_3436_3436_3437_3443_3448_3448_3448_3448_3448_3448_3448_3448_3448_3453_3453_3453_3453_3453_3453_3453_3453_3453_3458_3458_3462_3462_3462_3462_3462_3471_3489_3491_
3,3,位置,N,250,104,354,7_12_48_50_51_53_56_58_61_63_67_69_70_74_76_78_81_84_87_90_91_94_96_98_104_117_118_121_124_125_126_129_132_149_150_159_165_170_171_176_204_210_225_226_231_233_234_239_244_249_254_264_265_267_270_273_274_275_275_276_279_280_280_284_288_336_338_339_364_369_373_391_391_393_403_405_408_410_413_420_422_423_444_452_467_469_473_496_503_507_512_520_524_526_529_533_535_541_544_546_551_552_555_560_561_567_576_593_599_602_608_617_618_626_627_628_629_630_641_642_644_657_659_661_668_686_691_696_733_735_741_742_749_752_763_764_765_788_801_808_826_828_834_838_847_869_874_875_877_882_883_885_892_893_900_904_906_912_915_921_939_942_943_947_951_952_953_954_957_964_966_980_990_993_1007_1023_1024_1070_1073_1077_1080_1081_1084_1092_1093_1094_1100_1124_1129_1131_1136_1139_1140_1153_1154_1155_1160_1161_1162_1167_1173_1174_1180_1199_1218_1224_1226_1231_1234_1241_1242_1245_1246_1259_1261_1267_1281_1288_1302_1304_1305_1307_1308_1312_1328_1331_1332_1335_1336_1344_1345_1348_1351_1362_1374_1376_1377_1378_1385_1386_1393_1402_1431_1455_1463_1468_1495_1496_1498_,2027_2104_2113_2153_2159_2168_2175_2177_2179_2235_2236_2247_2359_2400_2402_2424_2426_2442_2444_2445_2446_2450_2450_2453_2453_2505_2541_2581_2586_2587_2588_2592_2598_2607_2631_2641_2645_2671_2702_2705_2706_2713_2714_2718_2721_2766_2781_2792_2795_2795_2805_2815_2815_2821_2822_2827_2829_2838_2844_2845_2846_2847_2850_2882_2895_2901_2913_2918_2939_2940_2943_2967_2973_3011_3012_3012_3041_3059_3098_3099_3108_3109_3145_3148_3175_3176_3195_3196_3237_3244_3278_3279_3318_3319_3320_3347_3352_3354_3360_3417_3422_3423_3424_
3,3,墊子,N,4,1,5,7_1411_1416_,
3,3,2008年,N,119,130,249,7_9_40_42_43_44_44_109_113_115_116_133_186_186_196_196_213_217_227_242_246_252_256_316_425_426_427_428_434_435_436_437_438_439_440_441_442_443_515_516_517_551_560_568_577_592_601_611_620_628_711_715_721_725_795_798_838_891_899_901_902_949_962_977_982_1028_1029_1029_1030_1031_1031_1032_1034_1038_1048_1054_1061_1081_1082_1149_1150_1156_1157_1167_1168_1169_1169_1170_1171_1172_1173_1174_1175_1176_1176_1177_1178_1179_1180_1202_1203_1208_1309_1313_1319_1324_1428_1437_1450_1451_1451_1469_1470_1474_1480_1487_1489_1492_,2005_2037_2037_2086_2122_2154_2177_2193_2193_2204_2225_2226_2258_2259_2261_2263_2305_2308_2314_2317_2322_2322_2360_2360_2361_2361_2368_2369_2406_2408_2432_2435_2436_2445_2446_2447_2473_2475_2475_2484_2503_2510_2511_2516_2518_2534_2547_2551_2552_2575_2589_2590_2616_2623_2624_2630_2671_2672_2702_2737_2744_2746_2747_2753_2759_2779_2798_2800_2831_2832_2840_2842_2843_2857_2858_2862_2877_2878_2924_2941_2945_3013_3024_3026_3049_3055_3055_3065_3067_3071_3084_3119_3124_3146_3163_3168_3169_3187_3189_3203_3231_3252_3253_3254_3258_3288_3345_3345_3353_3355_3371_3373_3374_3383_3384_3418_3423_3424_3431_3432_3433_3435_3443_3448_3453_3459_3480_3482_3483_
3,3,前台,N,213,524,737,7_16_35_37_52_64_68_71_75_78_82_84_88_89_102_121_129_133_139_144_144_152_155_155_173_174_181_191_204_210_211_222_235_237_238_241_246_251_256_273_276_279_280_280_296_304_320_335_335_337_340_341_342_352_364_369_373_373_377_377_379_388_391_393_400_405_408_408_431_434_435_449_457_460_460_470_474_481_482_491_495_514_516_520_521_529_530_540_546_546_555_555_568_577_584_592_593_593_601_602_602_610_617_619_626_628_630_630_634_640_665_678_709_719_731_737_738_745_748_749_753_759_764_772_776_779_787_792_813_826_843_845_870_871_872_873_878_879_880_881_887_887_887_888_895_895_895_896_938_944_961_976_982_982_983_989_992_995_996_1003_1008_1018_1019_1025_1041_1047_1054_1054_1057_1060_1061_1072_1073_1079_1080_1088_1089_1093_1094_1099_1113_1114_1121_1127_1134_1135_1184_1190_1237_1277_1284_1319_1319_1324_1324_1327_1341_1343_1359_1364_1383_1393_1395_1396_1402_1404_1405_1423_1472_1496_1498_1499_,2003_2005_2009_2015_2016_2016_2017_2019_2019_2029_2037_2037_2047_2048_2059_2059_2072_2072_2072_2079_2084_2085_2086_2089_2089_2089_2095_2095_2097_2097_2099_2099_2104_2107_2126_2128_2134_2134_2134_2136_2136_2140_2140_2149_2151_2161_2161_2161_2161_2162_2167_2175_2186_2209_2210_2211_2211_2215_2220_2222_2229_2229_2229_2231_2232_2239_2244_2245_2258_2258_2258_2259_2259_2259_2264_2272_2272_2273_2273_2287_2287_2287_2288_2288_2288_2289_2289_2290_2291_2295_2295_2295_2295_2296_2298_2301_2309_2309_2314_2317_2324_2338_2339_2353_2359_2360_2360_2360_2360_2360_2361_2361_2361_2361_2361_2362_2363_2363_2372_2372_2375_2375_2376_2377_2381_2384_2384_2385_2390_2391_2391_2392_2392_2397_2398_2400_2402_2406_2406_2408_2408_2412_2416_2416_2438_2440_2447_2452_2452_2454_2454_2454_2455_2455_2455_2483_2483_2485_2494_2494_2494_2494_2495_2495_2495_2495_2498_2500_2501_2502_2502_2508_2509_2516_2516_2518_2518_2526_2527_2527_2527_2531_2539_2547_2549_2549_2550_2550_2552_2553_2553_2554_2554_2555_2555_2560_2566_2571_2572_2584_2589_2592_2598_2599_2606_2608_2608_2608_2608_2608_2609_2609_2615_2616_2630_2630_2637_2638_2640_2640_2640_2640_2649_2649_2651_2654_2665_2671_2671_2671_2671_2672_2675_2677_2680_2700_2701_2707_2707_2708_2708_2718_2721_2723_2724_2731_2731_2731_2740_2740_2740_2740_2745_2746_2746_2746_2747_2756_2767_2767_2767_2767_2775_2775_2775_2775_2775_2782_2806_2807_2816_2818_2827_2828_2829_2835_2836_2836_2836_2836_2836_2838_2838_2838_2846_2846_2846_2857_2857_2858_2858_2861_2861_2863_2863_2867_2872_2872_2879_2880_2902_2902_2902_2904_2904_2904_2911_2914_2914_2914_2914_2924_2928_2947_2948_2949_2949_2950_2995_2996_3002_3012_3013_3025_3027_3031_3031_3031_3031_3032_3032_3032_3033_3033_3033_3034_3038_3038_3038_3039_3039_3039_3040_3055_3063_3074_3083_3083_3095_3095_3099_3099_3101_3103_3105_3107_3115_3115_3115_3115_3115_3115_3119_3119_3124_3124_3129_3129_3129_3130_3130_3130_3132_3133_3133_3146_3146_3146_3150_3150_3150_3153_3158_3158_3160_3162_3163_3170_3170_3170_3170_3172_3172_3172_3172_3184_3184_3193_3193_3195_3204_3205_3210_3215_3227_3227_3239_3243_3243_3243_3243_3243_3245_3245_3254_3254_3255_3256_3264_3279_3282_3288_3288_3289_3290_3296_3297_3297_3308_3308_3308_3319_3323_3324_3330_3331_3331_3335_3341_3341_3347_3349_3349_3349_3351_3351_3351_3357_3360_3360_3360_3360_3363_3364_3364_3367_3367_3368_3368_3371_3373_3373_3374_3374_3380_3387_3388_3389_3390_3391_3393_3406_3411_3413_3413_3414_3417_3423_3424_3431_3432_3433_3433_3433_3433_3433_3433_3433_3433_3433_3433_3433_3433_3435_3435_3435_3435_3435_3435_3435_3435_3435_3435_3435_3435_3443_3446_3467_3467_3468_3470_3470_3471_3473_3473_3478_3480_3482_3483_3486_3487_3487_3487_
3,3,態度,N,178,252,430,7_16_51_64_68_71_75_79_85_89_107_109_119_121_127_129_158_160_181_183_191_193_211_225_230_232_242_246_252_256_296_304_317_335_335_388_391_393_394_400_422_424_427_460_522_523_526_531_532_535_546_553_555_562_600_609_610_610_619_619_628_628_635_637_641_657_658_663_665_678_680_699_699_731_733_741_746_749_751_756_758_773_777_802_814_819_824_828_843_873_881_888_888_890_890_892_896_896_898_898_900_910_914_928_936_939_950_960_985_989_992_1005_1036_1050_1057_1070_1077_1081_1082_1087_1088_1092_1095_1099_1107_1112_1120_1148_1164_1166_1182_1188_1194_1207_1228_1230_1236_1266_1282_1289_1296_1300_1319_1324_1327_1330_1334_1337_1350_1359_1359_1364_1364_1371_1386_1392_1394_1395_1396_1401_1403_1404_1405_1408_1413_1426_1431_1433_1435_1440_1445_1451_1452_1472_1496_1498_1498_,2015_2020_2059_2072_2081_2081_2083_2083_2084_2085_2089_2104_2104_2106_2134_2144_2145_2147_2155_2162_2164_2193_2193_2205_2220_2222_2223_2232_2232_2244_2245_2246_2252_2253_2258_2259_2260_2264_2269_2273_2279_2291_2291_2297_2300_2322_2327_2329_2333_2334_2339_2340_2341_2345_2347_2350_2353_2363_2388_2389_2412_2416_2436_2438_2440_2447_2450_2453_2471_2483_2483_2485_2486_2494_2495_2530_2539_2547_2548_2554_2555_2566_2581_2582_2590_2604_2608_2608_2608_2608_2630_2637_2637_2638_2638_2648_2651_2654_2665_2674_2680_2683_2686_2691_2725_2734_2740_2746_2748_2757_2757_2758_2758_2764_2774_2775_2776_2779_2803_2803_2807_2814_2823_2825_2829_2829_2830_2833_2837_2846_2846_2848_2849_2852_2855_2856_2867_2881_2881_2889_2890_2897_2902_2904_2911_2914_2917_2924_2928_2948_2949_2950_2951_2958_2969_3001_3001_3001_3002_3002_3004_3007_3012_3012_3031_3032_3033_3034_3049_3054_3056_3083_3083_3084_3086_3093_3101_3101_3107_3112_3115_3115_3119_3122_3124_3127_3137_3146_3146_3150_3161_3184_3184_3186_3188_3202_3210_3213_3215_3218_3226_3245_3254_3260_3279_3282_3306_3308_3318_3329_3329_3331_3331_3334_3342_3347_3347_3351_3351_3360_3361_3362_3367_3368_3373_3373_3374_3374_3376_3378_3409_3413_3417_3422_3433_3433_3435_3435_3443_3450_3451_3455_3456_3463_3470_3471_3471_3475_3478_3494_3496_
3,3,上網,Vi,27,49,76,7_10_50_66_66_67_69_73_73_74_76_231_277_630_710_720_806_806_939_1007_1011_1018_1018_1153_1160_1349_,2099_2108_2155_2170_2232_2232_2491_2606_2606_2606_2606_2635_2666_2698_2698_2698_2698_2734_2734_2829_2851_2851_2865_2895_2956_2957_2968_2980_3074_3119_3124_3141_3174_3174_3177_3195_3204_3274_3282_3289_3290_3318_3319_3397_3399_3431_3432_3459_
3,3,算,Vt,154,126,280,4_7_8_22_30_116_117_118_125_126_133_133_152_198_222_231_237_275_286_291_297_299_305_328_333_375_391_395_397_397_407_429_430_450_458_484_493_502_507_521_522_526_530_531_535_570_579_584_584_597_611_620_629_635_637_641_645_651_657_666_684_686_689_691_694_708_718_742_747_747_747_784_787_790_806_808_815_818_818_818_820_826_831_831_842_842_849_875_883_888_889_892_896_897_900_903_905_907_912_917_917_935_939_954_962_968_969_999_1002_1053_1054_1054_1068_1075_1081_1081_1095_1110_1114_1114_1118_1141_1141_1143_1143_1148_1171_1178_1186_1192_1204_1204_1272_1275_1303_1306_1308_1312_1328_1329_1332_1334_1334_1425_1427_1427_1453_1454_1463_1468_1491_1494_1495_,2015_2020_2081_2083_2136_2140_2184_2260_2266_2281_2282_2283_2287_2287_2288_2288_2289_2291_2298_2301_2390_2400_2402_2426_2438_2440_2517_2519_2544_2547_2549_2549_2550_2550_2576_2590_2590_2603_2605_2607_2640_2640_2651_2654_2683_2686_2742_2746_2748_2763_2774_2780_2783_2798_2800_2806_2809_2816_2818_2861_2868_2907_2908_2922_2928_2936_2937_2939_2940_2941_2955_2960_2962_2964_2965_2966_2975_2976_2983_2984_3025_3027_3049_3074_3083_3098_3150_3159_3163_3187_3187_3189_3189_3190_3223_3227_3231_3242_3245_3253_3262_3263_3289_3290_3291_3292_3293_3307_3323_3341_3392_3394_3397_3397_3397_3397_3422_3422_3423_3424_3433_3435_3478_3479_3481_
3,3,硬,Vi,8,24,32,7_324_698_1217_1332_1348_1418_,2335_2445_2446_2547_2586_2611_2611_2651_2654_2700_2701_2714_2829_2852_2967_2967_3044_3048_3137_3242_3418_3443_3459_
4,3,水果,N,60,23,83,8_154_162_167_186_196_287_308_312_334_345_355_373_434_437_568_568_568_568_577_577_577_577_710_714_720_724_760_803_804_813_813_856_865_943_1000_1084_1091_1091_1194_1217_1235_1237_1238_1240_1240_1259_1272_1275_1311_1315_1375_1376_1378_1419_1459_1464_1477_1484_,2177_2239_2309_2309_2309_2391_2391_2596_2597_2651_2651_2654_2654_2731_2790_2864_2997_3013_3014_3289_3290_3315_
4,3,大家,N,44,104,148,8_43_227_229_238_239_249_280_320_408_434_468_472_665_670_684_699_701_710_710_710_711_714_720_720_720_721_724_807_846_923_931_1009_1067_1074_1083_1124_1131_1208_1211_1211_1249_1500_,2012_2012_2043_2044_2045_2151_2153_2162_2193_2208_2231_2231_2232_2252_2252_2253_2253_2260_2276_2295_2312_2313_2313_2315_2316_2316_2323_2384_2384_2398_2486_2516_2518_2522_2526_2549_2550_2573_2593_2606_2630_2631_2710_2712_2731_2748_2759_2773_2779_2782_2791_2812_2817_2819_2824_2826_2842_2842_2843_2843_2852_2881_2906_2941_2941_2941_2946_3001_3001_3013_3037_3056_3071_3071_3072_3072_3072_3072_3076_3103_3115_3144_3144_3160_3163_3193_3231_3244_3253_3264_3266_3267_3288_3294_3294_3313_3316_3342_3347_3359_3419_3446_3477_
4,3,走,Vi,58,61,119,8_12_182_192_219_227_228_272_283_341_347_357_395_418_431_501_670_698_707_717_823_835_835_872_875_880_883_886_886_888_889_891_894_894_896_897_899_902_916_917_923_931_1025_1053_1061_1088_1320_1325_1328_1359_1359_1364_1364_1423_1433_1435_1474_,2069_2105_2108_2134_2162_2175_2206_2206_2206_2220_2222_2229_2231_2333_2334_2384_2384_2450_2453_2514_2544_2547_2594_2601_2623_2731_2746_2746_2746_2753_2754_2769_2770_2772_2772_2934_2946_2946_2987_3049_3083_3095_3101_3210_3215_3243_3246_3249_3253_3289_3289_3290_3290_3313_3333_3337_3341_3386_3447_3475_
4,3,買,Vt,29,31,60,8_103_281_418_635_637_786_786_786_813_820_852_861_875_883_889_897_902_990_993_1113_1121_1186_1192_1359_1364_1450_1450_,2095_2097_2099_2155_2159_2193_2229_2231_2231_2231_2232_2387_2399_2401_2502_2553_2566_2640_2730_2784_2812_2816_2818_2902_2904_3103_3243_3277_3327_3477_
4,3,附近,N,74,38,112,8_39_53_58_63_70_99_101_103_222_228_272_394_422_465_480_489_525_534_571_580_642_648_654_668_670_786_786_790_801_804_814_815_820_820_837_841_843_857_866_886_887_889_890_894_895_897_898_904_904_906_943_980_1057_1093_1094_1141_1143_1201_1201_1251_1266_1269_1282_1289_1326_1349_1386_1399_1457_1457_1474_1495_,2008_2163_2163_2188_2246_2368_2369_2409_2410_2426_2434_2483_2508_2525_2606_2652_2655_2671_2690_2690_2791_2881_2881_2893_2933_2949_2996_3032_3033_3055_3055_3088_3135_3360_3454_3488_3490_
4,3,可以,ADV,411,300,711,8_14_17_22_30_35_38_41_44_47_51_66_67_67_68_69_73_74_74_75_76_92_98_101_104_110_112_133_140_144_154_160_163_164_164_168_169_169_173_173_186_186_186_196_196_196_219_219_226_227_227_228_231_239_239_242_244_247_249_249_252_254_257_266_269_269_269_276_315_323_323_326_331_335_335_338_339_341_346_346_356_356_363_364_364_368_369_369_374_375_376_386_387_387_391_391_391_402_407_411_412_422_431_433_448_449_456_457_469_473_482_482_483_491_491_492_499_501_506_507_509_515_516_516_521_521_530_530_540_546_546_547_551_553_555_555_556_560_562_566_570_573_575_579_582_583_597_599_599_608_608_610_619_631_648_654_662_662_662_662_669_669_669_674_675_683_684_689_694_699_710_710_714_714_720_720_724_724_728_729_730_732_732_747_767_768_769_771_771_772_772_775_775_776_776_778_780_780_782_783_783_783_783_786_788_790_790_792_800_813_815_817_817_817_818_820_821_822_828_828_831_835_836_837_842_842_842_842_844_846_849_851_854_856_856_857_860_863_865_865_866_871_875_875_875_875_879_883_883_883_883_887_887_887_888_888_889_889_891_891_891_895_895_895_896_896_897_897_899_899_899_901_904_906_910_917_921_923_923_923_923_924_931_931_931_931_932_940_951_960_961_963_963_964_970_986_999_1002_1005_1011_1018_1020_1020_1020_1021_1032_1054_1054_1054_1055_1057_1069_1076_1081_1086_1087_1091_1093_1094_1101_1105_1107_1108_1109_1109_1113_1116_1117_1117_1121_1124_1125_1129_1131_1132_1136_1141_1143_1147_1151_1154_1155_1158_1161_1162_1167_1171_1174_1178_1185_1191_1204_1218_1223_1225_1227_1229_1237_1238_1240_1242_1246_1254_1261_1266_1266_1270_1273_1309_1313_1319_1324_1326_1328_1328_1329_1335_1336_1336_1337_1345_1353_1356_1361_1391_1400_1408_1413_1419_1423_1428_1429_1430_1436_1451_1454_1457_1463_1468_1469_1470_1479_1481_1481_1481_1486_1488_1488_1488_1496_,2037_2037_2048_2048_2084_2085_2101_2102_2105_2113_2120_2121_2136_2140_2165_2178_2205_2206_2229_2229_2229_2231_2231_2231_2231_2244_2245_2252_2253_2258_2259_2266_2266_2266_2267_2269_2269_2298_2301_2318_2318_2319_2319_2322_2339_2339_2354_2355_2360_2361_2363_2382_2386_2386_2391_2404_2445_2445_2446_2446_2450_2450_2452_2452_2453_2453_2479_2484_2484_2489_2494_2495_2502_2517_2517_2519_2519_2522_2528_2529_2531_2536_2544_2547_2549_2550_2553_2554_2555_2572_2574_2576_2576_2587_2595_2596_2597_2604_2606_2630_2637_2638_2641_2645_2647_2649_2651_2651_2651_2651_2651_2654_2654_2654_2654_2654_2662_2683_2686_2698_2699_2702_2707_2708_2709_2711_2714_2714_2714_2724_2731_2739_2746_2746_2746_2748_2748_2749_2750_2761_2761_2762_2762_2776_2807_2813_2815_2815_2815_2816_2816_2816_2816_2817_2818_2818_2818_2818_2819_2822_2824_2824_2824_2826_2826_2826_2829_2838_2838_2844_2847_2847_2857_2858_2861_2861_2866_2889_2890_2892_2892_2914_2923_2931_2933_2933_2945_2946_2946_2946_2955_2960_2962_2964_2983_2983_2984_2984_2985_2993_2994_2997_2998_2999_3000_3011_3011_3019_3019_3029_3030_3032_3033_3037_3046_3050_3059_3066_3068_3072_3074_3074_3098_3112_3115_3137_3146_3159_3161_3163_3177_3178_3179_3187_3187_3189_3189_3223_3231_3246_3252_3253_3253_3253_3254_3281_3281_3281_3281_3289_3289_3289_3290_3290_3290_3293_3294_3299_3302_3304_3306_3313_3319_3327_3330_3332_3344_3347_3347_3364_3369_3370_3371_3376_3376_3378_3378_3379_3380_3386_3392_3394_3412_3415_3422_3431_3431_3432_3432_3443_3448_3451_3453_3456_3460_3467_3478_3485_3487_
4,3,吃,Vt,127,132,259,8_47_102_112_186_186_196_196_239_249_253_253_276_288_308_312_350_360_364_369_388_395_395_395_401_435_481_501_508_518_520_529_540_630_633_664_669_669_670_677_707_710_710_711_714_714_717_720_720_721_724_724_749_786_786_792_813_835_856_856_857_865_865_866_886_887_889_894_895_897_904_907_910_917_977_982_983_990_993_1005_1005_1005_1028_1037_1054_1086_1087_1088_1088_1091_1105_1124_1124_1130_1131_1131_1137_1171_1178_1211_1211_1217_1242_1242_1246_1246_1296_1300_1316_1316_1321_1321_1326_1333_1334_1345_1425_1425_1425_1425_1428_1457_1472_1472_1472_1474_,2048_2072_2101_2102_2105_2123_2127_2127_2139_2143_2196_2199_2231_2231_2231_2231_2246_2247_2252_2253_2291_2291_2291_2304_2305_2307_2308_2312_2315_2338_2343_2360_2361_2365_2445_2445_2446_2446_2448_2451_2517_2519_2543_2566_2596_2597_2630_2662_2742_2742_2757_2758_2779_2782_2782_2784_2798_2800_2816_2816_2816_2818_2818_2818_2829_2861_2861_2867_2897_2912_2926_2946_2951_2979_2998_3029_3034_3062_3083_3083_3083_3111_3119_3124_3129_3130_3132_3135_3145_3149_3161_3175_3175_3176_3176_3184_3184_3195_3197_3199_3207_3253_3253_3269_3269_3272_3288_3289_3289_3290_3290_3293_3331_3331_3347_3360_3360_3360_3360_3360_3365_3388_3388_3414_3458_3471_3471_3479_3479_3481_3481_
4,1,蘑菇,N,2,0,2,8_,
4,3,窗戶,N,48,61,109,8_17_50_68_69_75_76_229_242_242_244_252_252_254_308_312_342_352_374_374_386_408_546_546_546_555_555_555_660_670_734_785_838_875_883_922_930_947_955_966_1015_1026_1112_1120_1252_1342_1343_,2050_2053_2060_2112_2192_2198_2198_2205_2286_2289_2289_2390_2393_2421_2483_2487_2488_2517_2519_2615_2683_2686_2732_2740_2740_2748_2748_2750_2750_2750_2753_2766_2784_2841_2863_2863_2889_2890_2898_2953_2953_2996_3076_3083_3139_3146_3152_3194_3210_3215_3405_3410_3428_3443_3443_3476_3485_3487_3487_3487_
4,3,遠,Vi,92,72,164,8_23_31_44_65_72_113_145_148_150_182_182_192_192_213_248_258_268_272_288_316_316_363_368_420_427_465_467_502_521_525_530_534_610_619_649_655_657_666_786_787_788_790_800_804_813_814_818_819_820_826_841_854_856_857_858_859_863_865_866_867_868_885_886_893_894_922_930_935_935_957_962_983_1028_1082_1090_1139_1183_1189_1231_1235_1266_1320_1325_1337_1394_1403_1454_1469_1470_1500_,2071_2104_2154_2154_2162_2198_2211_2213_2269_2299_2302_2324_2367_2426_2505_2509_2531_2592_2615_2649_2659_2698_2717_2718_2720_2721_2725_2734_2754_2760_2763_2766_2772_2809_2829_2848_2849_2851_2864_2867_2870_2877_2878_2907_2944_2953_3011_3074_3086_3119_3124_3159_3210_3215_3253_3274_3282_3287_3331_3333_3359_3361_3362_3385_3392_3394_3409_3433_3435_3448_3453_
4,3,都,ADV,592,872,1464,8_9_9_14_17_23_26_31_34_42_44_51_51_51_52_52_53_53_56_57_58_58_61_62_64_67_67_71_74_74_82_88_89_89_91_94_96_98_99_100_100_102_103_103_106_106_109_112_112_116_116_118_120_123_126_128_131_134_136_136_137_138_139_139_142_150_150_158_158_163_163_168_168_178_179_180_182_186_186_186_186_187_187_188_189_190_192_196_196_196_196_197_197_201_207_213_217_217_225_229_238_241_242_248_251_252_253_258_260_262_263_267_270_271_272_272_272_276_280_280_281_283_283_284_285_286_288_288_296_304_321_324_328_333_335_339_339_342_345_345_348_349_352_355_355_359_363_365_368_370_374_379_390_392_396_400_406_409_410_410_416_423_427_439_439_440_442_447_455_461_468_468_471_472_472_475_481_482_491_499_499_505_507_509_510_513_517_520_522_524_525_525_528_529_531_533_534_534_537_538_540_540_546_550_550_554_555_559_559_563_568_573_577_591_592_593_593_594_596_599_601_602_602_603_605_608_618_627_628_630_630_630_630_631_634_641_644_648_648_654_654_657_658_660_662_662_663_663_670_670_674_674_674_674_674_675_677_678_679_686_691_699_701_702_707_707_707_708_709_709_710_710_710_711_711_711_713_713_713_714_714_714_714_717_717_717_718_719_719_720_720_720_721_721_721_723_723_723_724_724_724_724_728_730_736_746_747_756_758_759_764_771_775_782_783_783_786_786_787_787_793_793_793_795_796_796_796_798_804_804_806_811_814_814_816_817_826_830_837_841_845_846_847_853_856_856_857_862_865_865_866_875_875_875_875_883_883_883_883_885_889_889_889_889_889_889_890_891_892_892_892_893_897_897_897_897_897_897_898_899_900_900_900_901_902_904_906_910_910_915_917_918_923_923_923_923_923_925_931_931_931_931_931_933_939_939_944_946_958_962_963_963_970_974_976_978_985_985_989_992_1010_1011_1013_1013_1015_1018_1019_1019_1020_1020_1021_1021_1024_1028_1029_1031_1045_1047_1049_1057_1057_1058_1060_1061_1070_1073_1077_1080_1086_1088_1088_1088_1088_1088_1088_1088_1088_1090_1090_1090_1091_1091_1091_1091_1093_1094_1098_1098_1101_1105_1112_1112_1113_1114_1120_1120_1121_1124_1124_1131_1131_1135_1163_1165_1170_1173_1177_1180_1182_1188_1195_1197_1198_1200_1205_1207_1211_1211_1212_1215_1220_1222_1232_1238_1243_1247_1251_1254_1262_1263_1264_1267_1272_1275_1282_1289_1293_1309_1311_1313_1315_1319_1319_1319_1324_1324_1324_1326_1328_1329_1332_1334_1337_1338_1339_1340_1345_1350_1350_1356_1359_1359_1359_1361_1364_1364_1364_1366_1367_1376_1392_1396_1396_1398_1398_1401_1405_1405_1407_1407_1412_1417_1418_1423_1428_1430_1431_1437_1442_1443_1447_1448_1450_1461_1465_1466_1471_1471_1472_1473_1477_1479_1481_1484_1486_1488_1490_1493_1495_1497_1497_,2002_2003_2004_2005_2006_2011_2012_2012_2012_2012_2012_2014_2016_2019_2019_2020_2020_2023_2027_2029_2029_2037_2042_2042_2044_2048_2048_2050_2050_2053_2053_2057_2057_2058_2058_2059_2059_2070_2070_2070_2074_2086_2090_2095_2097_2099_2099_2115_2116_2116_2116_2118_2119_2119_2119_2124_2124_2126_2126_2127_2127_2127_2129_2131_2133_2134_2134_2138_2148_2149_2151_2151_2151_2151_2153_2155_2158_2158_2159_2159_2161_2162_2162_2162_2162_2163_2163_2167_2175_2180_2181_2181_2188_2189_2196_2201_2204_2204_2206_2206_2208_2209_2209_2210_2210_2211_2211_2211_2215_2219_2221_2225_2226_2231_2231_2232_2232_2233_2233_2235_2236_2240_2241_2246_2246_2246_2246_2247_2247_2252_2252_2253_2253_2258_2259_2260_2260_2261_2263_2264_2264_2264_2266_2269_2269_2269_2270_2271_2271_2271_2272_2276_2280_2281_2282_2287_2288_2291_2291_2294_2305_2308_2322_2322_2326_2332_2335_2338_2340_2341_2342_2343_2343_2343_2353_2360_2360_2360_2360_2361_2361_2361_2361_2362_2367_2376_2378_2381_2382_2382_2384_2386_2386_2386_2388_2389_2390_2391_2391_2392_2394_2399_2401_2417_2419_2421_2425_2426_2426_2426_2428_2432_2434_2434_2435_2436_2439_2445_2446_2450_2450_2450_2450_2450_2450_2452_2452_2452_2452_2453_2453_2453_2453_2453_2453_2454_2455_2460_2461_2462_2469_2471_2477_2480_2480_2483_2484_2489_2490_2492_2493_2510_2511_2512_2515_2515_2515_2516_2516_2517_2517_2518_2518_2519_2519_2521_2523_2525_2526_2532_2532_2533_2533_2536_2537_2538_2540_2540_2540_2541_2546_2548_2549_2549_2550_2550_2551_2554_2555_2560_2565_2566_2572_2573_2573_2574_2576_2576_2582_2584_2584_2585_2587_2587_2590_2596_2596_2597_2597_2600_2604_2606_2606_2607_2607_2610_2616_2616_2631_2631_2631_2649_2651_2651_2654_2654_2658_2659_2662_2666_2669_2671_2671_2671_2679_2679_2688_2690_2690_2690_2700_2700_2701_2701_2703_2704_2707_2708_2709_2709_2711_2711_2715_2715_2716_2716_2717_2718_2720_2721_2723_2731_2731_2731_2731_2731_2731_2734_2739_2742_2745_2745_2746_2746_2747_2748_2748_2750_2753_2753_2753_2754_2756_2756_2759_2760_2768_2769_2769_2769_2770_2770_2770_2771_2773_2773_2773_2775_2775_2777_2779_2780_2781_2782_2782_2790_2791_2793_2794_2798_2800_2802_2803_2803_2803_2814_2815_2816_2818_2820_2821_2824_2824_2824_2824_2824_2826_2826_2826_2826_2826_2828_2828_2835_2835_2836_2836_2852_2855_2856_2857_2857_2857_2858_2858_2858_2861_2861_2862_2862_2862_2862_2863_2863_2863_2863_2864_2865_2867_2867_2867_2867_2867_2867_2872_2872_2872_2872_2883_2883_2883_2883_2883_2889_2889_2890_2890_2892_2893_2898_2899_2899_2903_2905_2914_2914_2914_2914_2916_2917_2922_2922_2923_2924_2933_2933_2939_2939_2939_2940_2940_2940_2941_2945_2945_2945_2945_2946_2946_2948_2953_2956_2956_2956_2957_2957_2957_2958_2958_2967_2967_2968_2969_2969_2972_2972_2973_2973_2975_2976_2987_2987_2987_2987_2990_2992_2993_2994_3000_3001_3007_3007_3008_3011_3014_3015_3015_3022_3023_3025_3025_3025_3027_3027_3027_3030_3031_3038_3038_3038_3039_3039_3039_3040_3040_3047_3049_3049_3051_3052_3052_3052_3052_3053_3053_3053_3053_3056_3057_3059_3066_3068_3071_3074_3074_3076_3076_3078_3083_3083_3085_3085_3087_3088_3088_3088_3089_3089_3089_3094_3095_3098_3099_3099_3103_3103_3104_3108_3109_3110_3110_3111_3112_3114_3117_3119_3119_3119_3124_3124_3124_3129_3130_3132_3132_3132_3132_3132_3132_3132_3132_3132_3135_3138_3138_3142_3142_3146_3149_3150_3150_3152_3156_3159_3159_3160_3161_3161_3161_3161_3163_3167_3170_3171_3172_3173_3175_3175_3176_3176_3177_3180_3182_3183_3184_3184_3184_3187_3187_3189_3189_3190_3195_3195_3196_3197_3199_3202_3205_3205_3210_3214_3214_3215_3219_3219_3231_3231_3232_3233_3234_3236_3239_3239_3240_3242_3243_3244_3245_3246_3246_3246_3246_3246_3246_3249_3253_3253_3253_3253_3253_3253_3253_3254_3254_3259_3266_3270_3274_3276_3276_3278_3279_3288_3289_3289_3290_3290_3291_3292_3293_3294_3296_3300_3303_3304_3306_3306_3309_3313_3316_3319_3319_3325_3327_3327_3327_3331_3333_3333_3336_3341_3342_3345_3347_3347_3347_3347_3347_3353_3355_3357_3359_3360_3360_3360_3360_3360_3360_3360_3363_3363_3363_3364_3365_3371_3371_3371_3376_3378_3379_3383_3383_3384_3384_3385_3386_3387_3389_3390_3392_3392_3394_3394_3395_3396_3397_3403_3408_3409_3409_3409_3409_3413_3414_3415_3415_3417_3418_3418_3418_3422_3428_3431_3432_3433_3433_3433_3433_3433_3433_3433_3433_3434_3434_3434_3435_3435_3435_3435_3435_3435_3435_3435_3436_3436_3436_3443_3443_3445_3445_3448_3448_3448_3448_3453_3453_3453_3453_3462_3462_3466_3466_3466_3470_3471_3475_3475_3479_3479_3479_3481_3481_3481_3487_3487_3493_3495_3495_3497_3497_
4,3,酸,Vi,2,1,3,8_,
4,3,夠,ADV,63,54,117,8_91_91_163_168_230_259_261_281_298_306_308_312_395_478_487_510_550_559_588_707_717_732_743_759_790_802_802_814_830_873_874_881_882_891_899_910_935_976_987_1019_1042_1086_1124_1129_1131_1136_1140_1195_1198_1204_1228_1230_1236_1236_1304_1307_1319_1324_1428_1430_1436_,2084_2085_2086_2106_2258_2259_2299_2299_2302_2302_2342_2359_2380_2388_2467_2468_2504_2544_2544_2651_2654_2656_2718_2721_2723_2756_2761_2762_2773_2775_2824_2826_2868_2869_2885_2887_2936_2937_2953_2967_3153_3187_3189_3202_3207_3213_3218_3388_3397_3419_3448_3453_3492_
4,3,定,ADV,54,58,112,8_16_162_165_167_170_285_309_313_460_460_710_720_771_775_792_814_843_873_876_881_884_885_893_912_935_964_1034_1069_1069_1076_1076_1088_1099_1106_1114_1186_1192_1195_1195_1195_1195_1198_1198_1198_1198_1311_1311_1311_1315_1315_1315_1431_,2112_2116_2119_2162_2170_2206_2284_2284_2289_2372_2375_2377_2383_2394_2421_2426_2557_2582_2601_2601_2624_2625_2635_2698_2704_2733_2769_2770_2866_2903_2905_2925_2932_2932_2946_3040_3047_3051_3056_3086_3105_3115_3119_3124_3149_3255_3255_3256_3256_3341_3360_3382_3423_3424_3458_3459_3466_
4,3,整潔,Vi,51,6,57,8_68_75_101_102_133_139_176_233_297_305_326_331_374_392_434_464_523_532_570_579_629_735_773_777_791_823_849_982_1020_1068_1075_1093_1094_1113_1114_1121_1139_1141_1143_1197_1200_1235_1327_1328_1349_1386_1427_1439_1444_,2311_2883_3011_3344_3380_
4,3,餐廳,N,152,122,274,8_44_44_44_91_91_91_92_99_100_100_106_114_122_122_130_130_156_158_162_163_167_168_187_197_211_211_239_249_288_288_388_393_398_399_428_428_465_480_489_500_520_529_571_580_591_630_641_648_654_663_701_701_707_708_710_711_711_715_717_718_720_721_721_725_740_744_745_750_753_771_771_771_771_775_775_775_775_790_801_805_814_815_815_819_828_835_837_844_849_854_857_863_866_921_921_988_988_1020_1020_1033_1041_1063_1070_1077_1081_1087_1087_1088_1088_1088_1096_1097_1097_1104_1114_1115_1167_1168_1174_1175_1181_1187_1212_1212_1223_1225_1227_1229_1235_1251_1296_1300_1326_1326_1333_1334_1359_1364_1383_1399_1437_1437_1437_1450_1452_1452_1471_1472_1490_1493_,2014_2095_2097_2101_2102_2123_2131_2131_2133_2133_2188_2191_2191_2201_2231_2231_2231_2235_2236_2272_2272_2291_2291_2297_2300_2323_2332_2335_2365_2389_2411_2414_2445_2445_2445_2445_2445_2445_2446_2446_2446_2446_2446_2446_2487_2488_2499_2517_2519_2520_2527_2531_2534_2565_2565_2584_2594_2671_2674_2705_2706_2749_2754_2769_2769_2769_2770_2770_2770_2790_2793_2798_2800_2802_2813_2822_2829_2830_2835_2845_2861_2897_2946_2953_2954_2967_2968_2979_2986_3069_3070_3121_3126_3136_3147_3149_3162_3184_3184_3184_3237_3253_3259_3318_3323_3331_3347_3353_3355_3360_3360_3360_3360_3375_3377_3380_3414_3419_3423_3424_3471_
4,3,方便,Vi,380,134,514,8_9_17_17_20_24_28_32_36_38_44_50_52_52_56_61_65_66_67_69_72_73_74_76_78_81_84_87_91_93_95_98_100_102_103_103_103_104_106_122_123_124_130_131_132_145_146_149_155_156_162_163_167_168_173_173_204_210_218_219_225_226_226_228_228_230_231_232_238_264_265_268_270_271_276_284_286_286_288_288_296_304_315_335_343_344_350_353_354_360_363_368_374_375_378_386_388_394_397_402_406_406_412_414_429_430_445_453_461_471_475_480_483_489_492_498_498_508_512_520_520_522_524_525_529_529_531_533_534_539_546_550_550_555_559_559_567_571_576_580_584_584_588_588_590_596_605_633_641_657_662_669_670_676_679_686_691_697_704_706_727_728_732_741_745_749_749_750_754_754_762_767_769_771_775_780_782_783_784_786_787_788_790_791_792_801_802_804_805_808_812_813_814_814_815_817_818_818_819_820_821_823_824_828_830_834_837_841_842_842_842_843_848_849_850_854_855_857_863_864_866_875_883_885_886_886_888_890_891_892_893_894_894_896_898_899_900_901_901_901_901_906_907_910_914_915_916_916_919_921_922_923_924_928_930_931_932_935_936_940_942_943_950_957_958_958_959_962_964_967_973_983_991_994_997_1006_1011_1011_1029_1042_1053_1054_1055_1057_1064_1067_1068_1074_1075_1082_1093_1094_1100_1104_1113_1121_1124_1131_1135_1135_1148_1168_1175_1186_1192_1206_1208_1208_1228_1230_1232_1233_1241_1242_1243_1245_1246_1247_1263_1264_1266_1266_1267_1280_1287_1292_1304_1307_1309_1311_1313_1315_1320_1325_1328_1329_1333_1338_1341_1344_1345_1345_1346_1350_1359_1359_1362_1364_1364_1377_1385_1389_1392_1393_1401_1402_1419_1427_1429_1430_1437_1440_1445_1455_1455_1457_1457_1461_1463_1465_1466_1468_1473_1473_1474_1491_1494_1495_1496_,2005_2011_2022_2037_2042_2048_2058_2139_2143_2154_2154_2154_2154_2162_2162_2163_2189_2198_2200_2232_2237_2238_2273_2283_2283_2299_2302_2359_2360_2361_2414_2442_2454_2455_2498_2500_2501_2516_2518_2537_2538_2547_2576_2588_2589_2610_2637_2638_2649_2678_2695_2698_2705_2706_2714_2714_2730_2737_2745_2749_2754_2756_2794_2795_2810_2811_2812_2812_2815_2829_2847_2882_2883_2895_2901_2909_2910_2918_2939_2940_2944_2948_2950_3007_3019_3022_3023_3032_3033_3040_3049_3055_3074_3132_3135_3137_3148_3149_3163_3167_3175_3176_3214_3219_3225_3232_3252_3254_3259_3273_3293_3293_3294_3295_3304_3307_3330_3339_3366_3405_3405_3405_3410_3410_3410_3418_3431_3432_3443_3471_3472_3488_3490_
4,3,超市,N,36,11,47,8_38_378_483_492_543_642_697_711_721_786_844_846_856_857_865_866_901_943_962_1005_1005_1070_1077_1090_1124_1131_1186_1192_1243_1247_1251_1349_1427_1450_,2022_2048_2104_2235_2236_2492_2730_2739_3074_3277_
5,1,川沙,N,1,0,1,,
9,3,環境,N,276,156,432,10_10_17_20_23_28_31_35_35_40_47_63_70_77_77_83_83_101_104_108_109_110_111_112_114_114_116_123_131_144_148_154_176_177_180_190_216_232_236_239_245_249_255_263_264_265_266_267_274_275_277_279_280_280_281_294_295_296_302_303_304_308_309_312_313_324_325_326_330_331_334_335_335_341_342_343_344_350_352_353_354_360_362_365_367_370_374_375_376_386_387_387_388_391_391_400_402_404_406_411_415_428_439_466_479_488_505_510_518_522_522_531_531_546_547_552_555_556_561_566_575_582_583_585_600_609_645_649_650_651_655_656_660_665_667_669_713_723_738_739_739_740_744_745_749_751_753_754_779_783_786_789_801_804_814_818_819_824_826_831_846_847_858_859_859_867_868_868_876_884_904_914_914_923_928_931_936_951_957_961_981_982_982_983_1010_1017_1020_1023_1026_1031_1032_1043_1045_1070_1071_1077_1078_1088_1088_1088_1090_1091_1105_1105_1106_1106_1107_1109_1112_1114_1114_1115_1117_1120_1141_1142_1143_1144_1145_1151_1154_1158_1161_1164_1166_1184_1186_1190_1192_1206_1211_1231_1297_1301_1303_1306_1318_1319_1323_1324_1331_1334_1335_1337_1338_1343_1344_1366_1366_1367_1408_1413_1423_1430_1431_1433_1435_1438_1439_1440_1441_1442_1444_1445_1446_1447_1457_1459_1462_1463_1464_1465_1467_1468_1473_,2064_2071_2074_2093_2120_2121_2126_2138_2161_2162_2168_2178_2198_2213_2227_2231_2255_2257_2260_2312_2313_2314_2315_2316_2317_2320_2327_2329_2359_2365_2371_2374_2376_2387_2389_2417_2417_2458_2469_2479_2493_2493_2506_2507_2509_2510_2511_2514_2522_2525_2530_2547_2548_2574_2576_2576_2592_2592_2606_2610_2642_2646_2652_2655_2691_2714_2717_2720_2728_2729_2739_2742_2746_2749_2753_2760_2763_2764_2772_2772_2787_2787_2789_2789_2796_2797_2814_2815_2835_2851_2882_2883_2883_2896_2900_2942_2964_2965_2966_2995_2996_2998_3006_3011_3012_3012_3012_3031_3074_3076_3076_3087_3091_3164_3168_3169_3178_3186_3188_3203_3209_3225_3243_3246_3254_3267_3267_3272_3283_3305_3306_3318_3318_3320_3356_3387_3414_3423_3423_3423_3424_3424_3424_3431_3432_3433_3434_3435_3436_3480_3482_3494_3496_3498_3500_
9,3,會不會,ADV,3,2,5,89_921_,2550_
9,3,辦,Vt,15,34,49,16_52_144_184_194_280_280_391_714_724_890_898_960_1496_,2252_2253_2314_2317_2353_2360_2361_2554_2555_2567_2596_2596_2597_2597_2609_2641_2645_2691_2707_2708_2776_2822_2828_2828_2828_2835_2836_2970_3243_3282_3288_3295_3443_
9,3,地鐵,N,49,24,73,98_397_783_786_788_788_800_811_813_813_814_815_817_818_819_819_820_841_846_847_848_886_886_888_889_894_894_896_897_902_902_904_910_910_912_916_917_924_932_935_935_943_944_1053_1054_1431_1473_1496_,2154_2154_2154_2159_2161_2162_2360_2361_2365_2432_2435_2695_2705_2706_2892_2892_3149_3170_3172_3306_3307_3405_3410_
9,3,酒店,N,1696,2372,4068,11_12_16_17_18_19_23_25_26_31_33_34_36_37_37_37_41_41_41_41_43_44_44_44_47_48_49_51_51_52_52_52_53_53_56_58_58_61_63_65_65_66_68_69_69_69_70_72_72_73_75_76_76_76_77_78_78_78_79_81_81_81_81_81_83_84_84_84_85_87_87_87_87_87_90_91_91_91_92_94_94_105_107_108_108_108_109_109_109_109_109_109_110_111_112_112_113_114_114_114_116_116_116_116_116_117_118_118_118_119_119_119_120_121_124_124_125_126_126_126_127_127_127_128_129_132_132_133_134_137_137_141_145_147_149_150_150_154_155_155_155_155_155_156_157_157_157_158_159_162_162_163_163_163_163_163_164_164_164_167_167_168_168_168_168_168_169_169_169_173_174_175_175_175_175_176_176_176_178_178_179_179_180_181_181_182_182_182_182_183_183_183_183_184_184_185_185_185_185_185_186_186_186_187_188_188_189_189_190_191_191_192_192_192_192_193_193_193_193_194_194_195_195_195_195_195_196_196_196_197_198_200_201_201_203_204_206_207_207_209_210_211_213_213_213_214_215_216_217_217_219_222_227_227_229_229_230_231_236_236_238_238_238_238_238_239_239_240_241_242_247_247_248_248_248_248_249_249_250_251_252_253_253_257_257_258_258_258_258_259_260_260_261_262_262_266_271_272_272_273_273_274_274_275_275_276_276_278_278_278_279_279_280_280_281_281_281_281_281_281_283_283_284_284_285_287_287_288_292_292_292_293_293_294_295_296_298_300_300_300_301_301_302_303_304_306_315_316_317_318_320_320_321_321_322_323_324_326_326_328_331_331_333_334_336_337_338_338_338_339_340_340_341_341_341_342_342_346_347_348_349_350_351_352_352_356_357_359_360_361_363_363_365_368_368_370_372_373_373_374_375_377_377_381_381_381_384_384_384_386_387_388_391_391_391_391_391_391_391_391_391_391_391_391_391_391_392_394_394_397_397_399_402_402_403_406_407_407_408_408_409_409_410_410_413_414_420_422_422_422_423_424_424_424_425_426_427_427_427_427_427_427_428_429_429_431_432_433_433_434_434_434_434_434_434_434_435_435_435_435_436_437_438_438_438_439_439_439_440_440_441_441_441_441_442_443_443_443_444_445_445_447_450_451_451_451_452_453_453_455_458_459_459_459_461_461_464_465_466_468_468_470_470_472_472_474_474_478_479_480_480_481_481_481_482_484_487_488_489_489_491_493_499_499_500_500_501_503_505_505_507_508_509_511_511_512_518_519_521_521_525_526_530_530_534_535_546_546_546_546_546_550_550_551_551_553_554_555_555_555_555_555_559_559_560_560_562_563_567_568_571_573_576_577_580_582_582_582_583_583_583_584_586_587_587_588_592_592_592_592_593_594_597_600_601_601_601_601_602_603_607_609_610_610_611_612_612_613_618_618_619_619_620_621_621_622_627_627_628_628_628_628_628_630_630_632_632_632_632_633_634_634_634_635_637_641_642_642_644_644_645_648_650_651_654_656_660_663_663_663_663_663_665_666_667_668_669_669_669_669_669_669_670_670_670_671_671_672_672_674_674_674_675_675_676_686_691_696_702_703_704_705_706_707_707_707_707_707_707_707_707_707_707_707_707_707_707_707_707_709_709_709_710_710_710_710_710_710_710_710_710_710_710_710_710_711_711_711_711_711_711_711_711_714_714_714_714_715_716_717_717_717_717_717_717_717_717_717_717_717_717_717_717_717_717_719_719_719_720_720_720_720_720_720_720_720_720_720_720_720_720_721_721_721_721_721_721_721_721_724_724_724_724_725_726_727_730_733_733_735_738_738_738_739_739_740_743_743_743_743_745_745_749_750_751_752_753_753_753_753_753_755_756_756_757_758_758_762_762_762_762_762_762_765_766_768_769_773_777_778_779_779_780_780_780_780_780_782_782_783_783_783_783_783_783_783_785_786_786_786_787_787_787_789_790_791_793_793_793_793_794_795_796_796_796_796_797_798_799_800_801_806_811_812_812_812_813_813_814_814_814_814_814_815_815_815_815_816_817_818_819_819_819_820_820_820_821_822_823_823_825_826_828_828_828_828_828_831_833_833_833_834_835_835_836_837_837_837_837_838_838_838_839_841_841_842_842_842_842_842_842_842_842_842_842_845_845_846_846_846_846_847_847_847_848_849_850_850_851_854_854_855_856_856_856_856_856_856_856_856_856_856_856_857_857_857_857_858_859_859_859_859_860_863_863_864_865_865_865_865_865_865_865_865_865_865_865_866_866_866_866_867_868_868_868_868_869_870_871_872_872_872_872_874_874_874_875_875_876_877_878_879_880_880_880_880_882_882_882_883_883_884_885_885_885_885_885_885_886_886_886_886_887_887_887_887_887_887_887_888_888_888_888_889_889_889_891_891_893_893_893_893_893_893_894_894_894_894_895_895_895_895_895_895_895_896_896_896_896_897_897_897_899_899_901_901_901_901_901_901_902_902_902_902_902_903_904_905_905_906_907_907_910_910_913_913_914_915_915_916_918_918_919_921_921_921_923_923_923_923_923_924_924_924_924_924_928_929_931_931_931_931_931_932_932_932_932_932_934_936_937_938_938_939_939_939_940_940_940_941_942_944_944_945_945_945_946_947_947_948_951_956_956_959_960_960_966_966_969_973_974_974_984_985_986_988_989_989_990_990_992_992_993_993_1002_1003_1004_1005_1005_1005_1005_1005_1005_1005_1005_1005_1005_1006_1010_1010_1013_1013_1014_1015_1017_1018_1018_1018_1020_1020_1020_1020_1020_1020_1023_1023_1025_1030_1030_1031_1031_1031_1031_1031_1032_1033_1037_1037_1038_1038_1038_1040_1040_1042_1043_1045_1054_1054_1054_1054_1054_1054_1054_1054_1055_1057_1060_1060_1061_1061_1061_1061_1061_1061_1062_1062_1062_1062_1063_1063_1066_1067_1070_1072_1073_1073_1073_1074_1077_1079_1080_1080_1080_1081_1081_1081_1081_1081_1081_1082_1082_1082_1082_1082_1082_1082_1084_1084_1087_1088_1088_1088_1088_1088_1088_1090_1091_1091_1091_1091_1091_1092_1093_1094_1096_1097_1101_1101_1102_1102_1103_1103_1104_1105_1106_1106_1106_1106_1107_1110_1111_1112_1112_1118_1119_1120_1120_1124_1124_1124_1124_1124_1126_1126_1127_1129_1129_1129_1131_1131_1131_1131_1131_1133_1133_1134_1135_1135_1136_1136_1136_1139_1139_1140_1142_1144_1147_1147_1149_1149_1151_1151_1151_1155_1156_1156_1158_1158_1158_1162_1163_1164_1165_1166_1167_1167_1168_1168_1168_1168_1168_1168_1169_1169_1169_1170_1170_1170_1170_1170_1172_1172_1173_1173_1173_1173_1174_1174_1175_1175_1175_1175_1175_1175_1176_1176_1176_1177_1177_1177_1177_1177_1179_1179_1180_1180_1180_1180_1181_1185_1185_1186_1186_1187_1191_1191_1192_1192_1193_1195_1197_1198_1199_1200_1201_1201_1203_1203_1207_1208_1209_1211_1211_1211_1211_1211_1211_1212_1212_1215_1218_1219_1220_1221_1222_1231_1231_1232_1233_1236_1237_1237_1238_1238_1238_1239_1244_1248_1249_1249_1249_1250_1250_1251_1251_1251_1253_1254_1254_1255_1256_1257_1259_1259_1262_1263_1263_1264_1267_1268_1278_1279_1281_1281_1285_1286_1288_1288_1290_1292_1297_1301_1304_1304_1307_1307_1309_1309_1310_1311_1311_1311_1313_1313_1314_1315_1315_1315_1316_1317_1318_1319_1319_1319_1319_1319_1320_1321_1322_1323_1324_1324_1324_1324_1324_1325_1326_1326_1326_1326_1328_1328_1329_1330_1330_1334_1337_1337_1337_1338_1338_1341_1345_1345_1348_1348_1348_1348_1350_1350_1352_1352_1353_1356_1359_1359_1361_1362_1362_1364_1364_1366_1367_1371_1374_1376_1378_1378_1383_1383_1386_1389_1391_1393_1393_1394_1397_1397_1398_1398_1398_1398_1398_1399_1399_1400_1402_1402_1403_1406_1406_1407_1407_1407_1407_1407_1409_1409_1412_1417_1423_1423_1423_1427_1428_1428_1428_1428_1428_1429_1429_1429_1429_1430_1433_1433_1433_1433_1433_1435_1435_1435_1435_1435_1436_1436_1437_1437_1437_1437_1438_1450_1450_1450_1451_1451_1455_1455_1457_1459_1459_1464_1464_1469_1469_1469_1469_1470_1470_1470_1470_1472_1472_1472_1472_1479_1479_1480_1481_1481_1481_1481_1486_1486_1487_1488_1488_1488_1488_1489_1492_1495_1495_1495_1495_1497_1497_1497_1497_1498_1498_1499_1500_1500_1500_,2003_2003_2005_2005_2009_2009_2010_2010_2011_2011_2015_2017_2019_2020_2021_2023_2024_2024_2026_2029_2029_2029_2029_2033_2035_2037_2037_2037_2037_2037_2037_2037_2037_2037_2038_2038_2038_2039_2040_2040_2040_2041_2042_2042_2043_2043_2043_2044_2045_2045_2045_2047_2048_2048_2048_2050_2050_2050_2050_2051_2053_2053_2053_2053_2054_2055_2055_2057_2057_2058_2058_2059_2060_2061_2061_2061_2061_2061_2062_2062_2062_2062_2062_2063_2063_2065_2065_2066_2070_2071_2072_2072_2072_2072_2074_2075_2076_2081_2081_2081_2081_2083_2083_2083_2083_2084_2085_2086_2089_2089_2090_2090_2093_2093_2095_2097_2098_2098_2099_2099_2103_2104_2104_2104_2104_2104_2104_2104_2105_2105_2107_2107_2107_2108_2108_2108_2108_2108_2108_2112_2114_2115_2116_2116_2117_2118_2119_2119_2123_2123_2124_2124_2126_2126_2126_2126_2126_2126_2126_2129_2129_2134_2134_2134_2136_2136_2136_2137_2137_2137_2137_2139_2140_2140_2140_2141_2141_2141_2141_2143_2144_2145_2146_2147_2148_2151_2151_2151_2151_2151_2153_2153_2153_2153_2153_2155_2159_2159_2159_2159_2161_2161_2161_2161_2161_2161_2162_2162_2162_2162_2162_2162_2162_2162_2162_2162_2162_2162_2163_2163_2163_2166_2168_2172_2177_2179_2180_2180_2181_2183_2186_2190_2190_2190_2191_2191_2191_2192_2192_2193_2194_2195_2195_2195_2195_2196_2196_2196_2198_2199_2200_2201_2202_2204_2204_2206_2208_2211_2211_2216_2219_2221_2225_2225_2225_2225_2225_2226_2226_2226_2226_2226_2227_2229_2229_2229_2231_2231_2231_2231_2231_2231_2231_2231_2232_2232_2232_2232_2232_2232_2232_2232_2235_2235_2235_2236_2236_2236_2239_2243_2244_2244_2244_2244_2244_2244_2245_2245_2245_2245_2245_2245_2246_2246_2246_2246_2247_2247_2247_2247_2247_2249_2251_2252_2252_2252_2252_2252_2252_2252_2252_2252_2252_2252_2252_2253_2253_2253_2253_2253_2253_2253_2253_2253_2253_2253_2253_2254_2254_2256_2256_2258_2258_2258_2258_2258_2259_2259_2259_2259_2259_2260_2265_2266_2266_2267_2267_2267_2267_2269_2269_2269_2269_2270_2270_2271_2272_2272_2272_2273_2273_2273_2275_2278_2278_2283_2283_2284_2284_2284_2284_2284_2284_2285_2287_2287_2287_2287_2287_2287_2288_2288_2288_2288_2288_2288_2290_2291_2291_2291_2291_2292_2294_2295_2298_2298_2301_2301_2304_2305_2305_2305_2305_2305_2305_2305_2305_2305_2305_2307_2308_2308_2308_2308_2308_2308_2308_2308_2308_2308_2313_2313_2316_2316_2318_2318_2318_2318_2318_2319_2319_2319_2319_2319_2322_2322_2322_2322_2322_2323_2328_2328_2330_2330_2332_2333_2333_2333_2333_2334_2334_2334_2334_2335_2337_2337_2338_2338_2340_2340_2340_2341_2341_2341_2347_2347_2353_2358_2360_2360_2360_2360_2360_2360_2360_2360_2360_2360_2360_2361_2361_2361_2361_2361_2361_2361_2361_2361_2361_2361_2362_2362_2363_2364_2367_2367_2372_2375_2377_2381_2383_2383_2384_2384_2384_2384_2385_2386_2386_2387_2388_2388_2391_2391_2391_2391_2391_2392_2394_2395_2398_2398_2398_2399_2399_2399_2400_2400_2401_2401_2401_2402_2402_2403_2403_2405_2406_2406_2406_2406_2407_2408_2408_2408_2408_2409_2409_2409_2410_2410_2410_2411_2411_2411_2411_2412_2412_2412_2412_2412_2414_2414_2416_2417_2417_2417_2417_2417_2417_2417_2417_2417_2417_2418_2418_2419_2419_2419_2421_2421_2424_2425_2426_2426_2428_2432_2432_2434_2434_2435_2435_2436_2436_2444_2444_2444_2445_2445_2445_2445_2445_2445_2446_2446_2446_2446_2446_2446_2447_2447_2447_2447_2447_2450_2450_2450_2450_2450_2450_2450_2450_2452_2452_2453_2453_2453_2453_2453_2453_2453_2453_2454_2454_2454_2454_2455_2455_2455_2455_2457_2459_2460_2460_2460_2461_2461_2461_2463_2464_2464_2465_2466_2466_2469_2470_2471_2473_2473_2473_2475_2475_2475_2476_2480_2484_2484_2485_2486_2486_2486_2486_2486_2491_2492_2493_2494_2494_2494_2494_2494_2495_2495_2495_2495_2495_2497_2502_2502_2503_2503_2503_2503_2504_2506_2507_2508_2509_2509_2509_2509_2510_2510_2511_2511_2516_2516_2516_2516_2516_2516_2516_2517_2517_2517_2518_2518_2518_2518_2518_2518_2518_2519_2519_2519_2521_2521_2522_2522_2522_2523_2523_2524_2524_2525_2525_2525_2525_2526_2526_2527_2528_2528_2528_2528_2529_2530_2530_2530_2530_2530_2531_2531_2531_2531_2534_2535_2535_2535_2535_2535_2536_2536_2536_2537_2538_2540_2541_2541_2544_2547_2549_2549_2549_2549_2549_2549_2549_2549_2549_2549_2549_2550_2550_2550_2550_2550_2550_2550_2550_2550_2550_2550_2551_2552_2552_2552_2553_2554_2554_2554_2554_2554_2554_2554_2555_2555_2555_2555_2555_2555_2555_2556_2557_2559_2559_2559_2559_2560_2561_2562_2564_2564_2565_2566_2569_2569_2569_2571_2571_2571_2572_2572_2572_2572_2572_2572_2573_2575_2575_2576_2576_2576_2576_2578_2579_2579_2579_2581_2585_2585_2586_2587_2587_2587_2587_2587_2587_2589_2589_2589_2589_2590_2590_2590_2590_2592_2593_2594_2595_2595_2596_2596_2596_2596_2596_2597_2597_2597_2597_2597_2600_2600_2603_2603_2605_2605_2606_2606_2606_2607_2608_2609_2609_2609_2609_2609_2609_2609_2609_2609_2609_2611_2613_2616_2616_2616_2616_2616_2616_2618_2618_2619_2620_2623_2623_2625_2625_2625_2626_2629_2630_2631_2631_2634_2635_2637_2638_2639_2640_2641_2641_2641_2642_2642_2642_2642_2645_2645_2645_2646_2646_2646_2646_2647_2647_2647_2647_2647_2648_2648_2649_2650_2651_2651_2651_2651_2651_2651_2651_2651_2651_2651_2651_2651_2651_2651_2651_2651_2651_2651_2653_2654_2654_2654_2654_2654_2654_2654_2654_2654_2654_2654_2654_2654_2654_2654_2654_2654_2654_2656_2658_2658_2658_2659_2662_2662_2669_2669_2670_2670_2671_2671_2671_2671_2671_2671_2671_2671_2671_2671_2671_2671_2671_2671_2672_2672_2674_2680_2683_2683_2684_2684_2686_2686_2687_2687_2688_2689_2690_2690_2690_2690_2690_2690_2691_2695_2698_2698_2700_2700_2700_2701_2701_2701_2702_2702_2702_2702_2702_2702_2705_2705_2705_2706_2706_2706_2707_2707_2707_2707_2707_2708_2708_2708_2708_2708_2709_2711_2713_2713_2714_2714_2715_2716_2717_2717_2717_2718_2719_2720_2720_2720_2721_2722_2724_2726_2727_2731_2731_2731_2731_2731_2731_2731_2731_2731_2731_2731_2731_2731_2733_2737_2737_2738_2739_2740_2740_2740_2740_2740_2742_2743_2744_2744_2744_2744_2745_2745_2745_2745_2745_2746_2746_2746_2746_2746_2746_2746_2746_2746_2746_2746_2746_2747_2747_2747_2748_2748_2748_2748_2750_2753_2753_2753_2753_2753_2754_2754_2756_2757_2757_2758_2758_2759_2759_2759_2759_2759_2759_2759_2759_2759_2759_2759_2759_2760_2760_2761_2761_2761_2761_2761_2762_2762_2762_2762_2762_2763_2764_2765_2765_2767_2767_2768_2771_2771_2771_2771_2771_2771_2773_2773_2773_2775_2775_2775_2775_2775_2776_2776_2776_2776_2777_2779_2779_2779_2779_2780_2784_2784_2784_2786_2786_2787_2787_2788_2788_2789_2789_2790_2790_2790_2790_2791_2791_2791_2791_2791_2791_2792_2794_2795_2797_2797_2798_2798_2798_2798_2798_2799_2800_2800_2800_2800_2800_2802_2802_2803_2803_2804_2805_2805_2806_2810_2811_2815_2815_2815_2815_2815_2816_2816_2816_2816_2816_2816_2817_2817_2818_2818_2818_2818_2818_2818_2819_2819_2821_2822_2822_2824_2824_2824_2824_2824_2824_2824_2826_2826_2826_2826_2826_2826_2826_2828_2828_2828_2828_2829_2829_2830_2830_2835_2835_2836_2836_2837_2838_2838_2838_2839_2840_2840_2841_2841_2842_2842_2842_2843_2843_2843_2847_2847_2847_2848_2849_2851_2851_2851_2851_2851_2852_2854_2857_2857_2857_2857_2857_2857_2857_2858_2858_2858_2858_2858_2858_2858_2859_2860_2861_2861_2861_2861_2861_2861_2862_2862_2862_2864_2864_2866_2866_2867_2869_2869_2869_2869_2869_2869_2871_2872_2872_2872_2872_2872_2872_2872_2872_2873_2874_2874_2879_2879_2879_2879_2879_2879_2880_2880_2880_2880_2880_2880_2881_2881_2881_2881_2881_2881_2881_2881_2882_2882_2882_2889_2889_2890_2890_2892_2892_2896_2897_2899_2899_2901_2908_2908_2908_2908_2908_2909_2910_2915_2915_2916_2916_2918_2918_2919_2919_2921_2922_2922_2922_2923_2923_2923_2923_2924_2924_2924_2924_2925_2925_2925_2929_2929_2930_2931_2932_2939_2939_2940_2940_2941_2941_2941_2944_2945_2945_2946_2946_2946_2946_2946_2946_2946_2946_2947_2948_2949_2949_2949_2949_2950_2951_2951_2953_2953_2956_2956_2956_2956_2956_2956_2957_2957_2957_2957_2957_2957_2959_2961_2963_2967_2967_2967_2968_2968_2969_2972_2972_2972_2972_2974_2975_2975_2975_2975_2976_2976_2976_2976_2976_2976_2976_2978_2981_2981_2982_2982_2985_2988_2988_2995_2996_2996_2999_3000_3001_3001_3001_3001_3001_3001_3001_3001_3001_3001_3004_3007_3007_3009_3009_3009_3009_3010_3010_3010_3010_3011_3013_3013_3013_3013_3013_3014_3015_3015_3019_3020_3020_3024_3024_3024_3026_3026_3026_3029_3029_3029_3030_3030_3031_3032_3032_3032_3032_3033_3033_3033_3033_3037_3037_3037_3038_3038_3038_3038_3038_3038_3038_3038_3038_3038_3039_3039_3039_3039_3039_3039_3039_3039_3039_3039_3040_3040_3041_3043_3044_3044_3047_3048_3048_3049_3049_3049_3049_3049_3049_3049_3051_3052_3053_3054_3055_3055_3055_3055_3055_3055_3055_3056_3056_3059_3059_3060_3062_3069_3069_3069_3069_3069_3069_3069_3070_3070_3070_3070_3070_3070_3070_3071_3071_3071_3071_3071_3071_3071_3072_3073_3073_3073_3073_3073_3073_3073_3074_3074_3074_3074_3076_3076_3076_3076_3076_3076_3076_3076_3076_3077_3079_3082_3083_3083_3083_3083_3083_3083_3084_3084_3084_3084_3084_3087_3089_3090_3091_3093_3093_3094_3095_3095_3096_3096_3098_3098_3098_3098_3099_3099_3099_3099_3099_3099_3102_3103_3103_3103_3103_3103_3103_3103_3103_3105_3105_3105_3105_3105_3105_3105_3106_3106_3107_3107_3110_3110_3111_3113_3114_3115_3115_3116_3118_3118_3118_3119_3119_3124_3124_3132_3132_3132_3132_3132_3132_3132_3132_3132_3132_3132_3133_3136_3139_3139_3139_3140_3140_3141_3141_3142_3142_3144_3145_3145_3146_3146_3146_3146_3146_3146_3146_3146_3146_3146_3146_3147_3149_3149_3149_3149_3150_3150_3152_3153_3153_3154_3155_3159_3159_3160_3161_3161_3163_3163_3163_3165_3165_3170_3172_3175_3175_3175_3176_3176_3176_3178_3180_3180_3180_3184_3184_3185_3185_3185_3185_3185_3187_3187_3187_3189_3189_3189_3191_3191_3192_3192_3193_3193_3193_3193_3193_3194_3194_3195_3195_3195_3196_3197_3199_3201_3202_3205_3206_3212_3213_3217_3218_3220_3220_3221_3221_3223_3223_3223_3223_3223_3225_3225_3225_3226_3227_3227_3227_3228_3229_3231_3231_3231_3231_3231_3231_3231_3231_3231_3231_3231_3231_3232_3232_3232_3232_3232_3232_3233_3233_3233_3233_3233_3233_3237_3239_3240_3241_3242_3242_3242_3243_3243_3244_3244_3246_3246_3246_3246_3247_3249_3253_3253_3253_3253_3253_3253_3253_3253_3253_3253_3254_3254_3254_3254_3254_3254_3254_3255_3255_3255_3255_3255_3255_3255_3255_3255_3255_3255_3256_3256_3256_3256_3256_3256_3256_3256_3256_3256_3256_3257_3257_3259_3260_3260_3260_3260_3264_3264_3264_3265_3266_3267_3270_3270_3271_3272_3272_3272_3272_3272_3273_3273_3276_3277_3277_3278_3279_3281_3281_3282_3282_3283_3283_3283_3287_3288_3288_3288_3288_3288_3288_3288_3288_3289_3289_3289_3289_3290_3290_3290_3290_3291_3292_3293_3293_3294_3294_3294_3294_3296_3296_3296_3296_3296_3296_3296_3296_3296_3296_3296_3297_3305_3305_3306_3306_3308_3308_3308_3309_3313_3319_3319_3319_3319_3320_3320_3324_3324_3326_3326_3327_3327_3327_3327_3329_3329_3329_3329_3333_3333_3334_3337_3341_3341_3342_3342_3343_3344_3344_3345_3345_3345_3345_3345_3345_3345_3345_3345_3345_3347_3347_3347_3347_3347_3347_3347_3347_3347_3347_3349_3352_3353_3354_3355_3357_3359_3359_3359_3359_3360_3360_3360_3360_3360_3360_3360_3360_3360_3361_3361_3361_3362_3362_3362_3363_3364_3364_3364_3364_3364_3364_3365_3365_3365_3366_3366_3367_3367_3368_3368_3371_3371_3371_3371_3371_3371_3371_3372_3373_3373_3373_3373_3374_3374_3374_3374_3375_3377_3379_3382_3383_3384_3385_3385_3385_3386_3386_3387_3388_3388_3388_3388_3388_3388_3389_3389_3389_3389_3389_3390_3390_3390_3390_3390_3391_3392_3393_3394_3397_3397_3397_3397_3399_3402_3403_3407_3408_3409_3409_3409_3412_3413_3413_3415_3415_3415_3415_3415_3415_3415_3415_3417_3417_3417_3417_3419_3419_3419_3421_3421_3421_3423_3423_3423_3423_3424_3424_3424_3424_3426_3429_3431_3431_3431_3431_3432_3432_3432_3432_3433_3433_3433_3433_3433_3433_3433_3433_3433_3433_3433_3433_3433_3433_3433_3433_3433_3433_3434_3434_3434_3435_3435_3435_3435_3435_3435_3435_3435_3435_3435_3435_3435_3435_3435_3435_3435_3435_3435_3436_3436_3436_3437_3437_3438_3438_3440_3442_3443_3443_3443_3446_3446_3446_3446_3446_3446_3446_3448_3448_3453_3453_3458_3458_3458_3458_3458_3458_3458_3458_3460_3460_3462_3466_3466_3467_3467_3471_3471_3471_3475_3475_3475_3475_3476_3476_3477_3478_3478_3479_3479_3479_3480_3481_3481_3481_3482_3483_3483_3487_3488_3489_3489_3489_3489_3489_3489_3489_3490_3491_3491_3491_3491_3491_3491_3491_3495_3495_3495_3495_3497_3497_3497_3497_3498_3500_
9,3,人,N,200,472,672,11_15_16_35_35_51_52_68_68_75_75_78_84_103_106_110_112_113_115_151_155_158_161_163_163_166_168_168_180_190_215_218_227_227_231_239_249_281_281_287_287_288_288_290_308_312_320_321_335_339_364_364_369_369_372_374_391_394_414_424_427_434_439_439_481_511_517_518_518_522_522_531_531_546_546_546_546_551_551_551_555_555_555_555_560_560_560_585_628_630_634_639_639_670_707_708_710_710_710_711_714_717_718_720_720_720_721_724_740_749_749_788_793_796_801_804_813_813_818_827_828_842_847_856_865_872_880_888_889_896_897_901_902_916_924_932_945_974_976_981_983_990_993_1003_1005_1005_1005_1018_1019_1023_1031_1031_1033_1045_1056_1057_1062_1081_1091_1101_1112_1112_1112_1120_1120_1120_1124_1127_1131_1134_1145_1211_1211_1211_1220_1222_1232_1238_1242_1246_1316_1321_1334_1336_1343_1348_1366_1369_1421_1430_1469_1470_1472_1472_1473_1479_1486_1495_1496_,2016_2016_2037_2042_2043_2045_2048_2060_2064_2089_2090_2090_2090_2095_2097_2098_2104_2106_2122_2127_2127_2144_2145_2148_2153_2161_2161_2161_2161_2162_2163_2171_2174_2180_2195_2195_2205_2205_2208_2208_2211_2220_2222_2229_2229_2231_2231_2249_2251_2252_2252_2253_2253_2267_2269_2269_2269_2273_2284_2284_2289_2289_2291_2295_2296_2298_2301_2304_2307_2313_2316_2320_2335_2335_2342_2344_2344_2349_2349_2359_2362_2370_2372_2373_2375_2386_2388_2388_2390_2395_2411_2416_2434_2436_2445_2446_2450_2450_2453_2453_2454_2455_2476_2487_2488_2489_2502_2502_2508_2509_2510_2510_2511_2511_2516_2518_2522_2523_2527_2527_2528_2531_2534_2534_2534_2534_2534_2535_2548_2551_2552_2565_2576_2585_2585_2594_2596_2597_2603_2605_2608_2608_2609_2611_2616_2616_2616_2616_2624_2637_2637_2638_2638_2647_2647_2649_2662_2671_2683_2683_2686_2686_2690_2691_2698_2700_2700_2701_2701_2715_2716_2718_2721_2725_2731_2731_2740_2740_2742_2745_2746_2746_2751_2753_2754_2756_2757_2758_2761_2761_2762_2762_2769_2769_2770_2770_2771_2776_2776_2782_2784_2790_2794_2795_2807_2814_2815_2817_2819_2828_2830_2836_2852_2854_2857_2858_2861_2861_2862_2862_2863_2863_2863_2864_2865_2869_2871_2873_2873_2874_2882_2889_2890_2898_2898_2902_2902_2904_2904_2911_2911_2912_2912_2915_2916_2917_2918_2919_2922_2923_2925_2926_2928_2928_2932_2936_2936_2937_2937_2939_2940_2945_2946_2946_2946_2946_2951_2951_2952_2974_2976_2976_2977_2978_2979_2986_2986_2986_2987_3000_3001_3001_3003_3013_3014_3015_3016_3032_3033_3038_3039_3040_3041_3043_3047_3049_3049_3049_3051_3052_3053_3055_3056_3062_3077_3080_3098_3098_3101_3101_3101_3101_3103_3103_3104_3107_3115_3115_3116_3118_3132_3132_3132_3133_3138_3149_3150_3159_3159_3163_3163_3163_3163_3174_3175_3176_3177_3186_3187_3188_3189_3190_3196_3202_3203_3205_3205_3205_3207_3210_3213_3215_3218_3223_3228_3229_3231_3231_3231_3232_3232_3233_3237_3241_3243_3243_3246_3246_3246_3246_3246_3253_3253_3253_3253_3254_3260_3262_3263_3267_3272_3274_3274_3278_3279_3282_3282_3282_3288_3289_3289_3289_3289_3290_3290_3290_3290_3294_3295_3296_3304_3306_3316_3321_3322_3324_3333_3333_3341_3341_3345_3345_3347_3352_3352_3352_3354_3354_3354_3360_3360_3360_3360_3379_3383_3383_3384_3384_3388_3388_3388_3392_3392_3392_3392_3394_3394_3394_3394_3397_3405_3410_3414_3415_3418_3418_3421_3430_3433_3433_3433_3433_3434_3434_3435_3435_3435_3435_3436_3436_3443_3443_3447_3452_3457_3458_3460_3470_3475_3477_3487_
9,1,好奇,Vi,1,0,1,,
9,3,有點,ADV,183,74,257,10_40_45_52_114_118_118_126_126_148_185_195_204_210_211_213_231_233_241_242_248_251_252_258_273_281_289_297_305_315_323_324_334_342_343_349_352_353_359_364_369_374_381_384_388_407_410_410_418_422_434_435_444_452_460_469_473_483_483_492_492_495_495_507_517_521_530_544_546_555_566_570_572_575_579_581_588_591_600_609_618_627_628_631_631_660_660_662_662_670_674_675_698_699_710_711_711_720_721_721_740_747_751_764_769_772_776_783_783_787_795_795_798_798_820_830_839_843_857_866_875_883_887_888_889_889_891_895_896_897_897_899_915_921_921_957_957_957_966_970_970_1001_1007_1007_1013_1049_1058_1084_1111_1119_1139_1145_1155_1162_1163_1165_1199_1228_1230_1238_1264_1266_1270_1270_1273_1273_1278_1279_1285_1286_1303_1306_1311_1315_1328_1341_1346_1384_1384_1418_1423_1496_,2057_2091_2092_2109_2134_2193_2219_2221_2266_2277_2299_2299_2302_2302_2324_2324_2426_2541_2543_2549_2549_2550_2550_2576_2587_2592_2641_2642_2645_2646_2719_2722_2730_2735_2736_2802_2809_2817_2819_2840_2848_2851_2869_2927_2941_2952_2968_3032_3033_3078_3105_3108_3109_3120_3125_3132_3132_3158_3187_3189_3196_3223_3223_3277_3295_3319_3319_3330_3335_3403_3408_3448_3453_
9,3,先,ADV,12,79,91,184_194_217_280_391_611_620_923_931_962_1430_,2015_2037_2037_2039_2041_2047_2047_2134_2201_2208_2220_2222_2229_2239_2240_2252_2253_2287_2288_2416_2483_2516_2516_2518_2518_2534_2548_2554_2555_2582_2582_2608_2623_2698_2705_2706_2707_2708_2739_2742_2748_2754_2841_2853_2922_2939_2940_2970_2970_2972_2979_3038_3039_3049_3076_3103_3159_3196_3205_3226_3232_3253_3253_3255_3256_3289_3290_3308_3319_3341_3341_3360_3376_3378_3434_3436_3462_3477_
9,3,們,N,5,35,40,35_974_1091_1423_,2163_2264_2287_2288_2314_2317_2354_2354_2355_2355_2388_2388_2391_2416_2516_2518_2576_2595_2608_2608_2861_2908_2946_3072_3104_3108_3109_3142_3181_3246_3279_3345_3397_3409_
9,3,去,ADV,474,506,980,11_17_22_30_35_35_36_44_50_50_51_51_56_61_67_74_90_91_91_99_103_103_103_105_110_112_112_116_122_130_136_138_139_140_142_144_147_150_152_152_163_163_163_163_168_168_168_168_171_173_177_177_179_186_186_187_189_196_196_197_203_203_204_204_204_209_209_210_210_210_211_212_215_225_225_226_227_227_228_228_229_231_232_240_242_250_252_253_263_270_271_271_271_275_275_276_276_277_281_281_282_282_282_284_285_288_289_295_296_297_297_303_304_305_305_308_312_320_321_321_324_334_338_341_351_361_364_369_388_390_408_419_434_446_447_454_455_469_470_471_473_474_475_480_489_494_498_505_508_520_521_521_521_522_522_522_524_526_529_530_530_530_531_531_531_533_535_544_546_548_551_554_555_557_560_563_582_583_584_584_586_586_589_590_611_620_629_630_630_632_632_644_644_648_654_665_669_669_669_669_670_670_670_674_677_677_678_684_702_707_708_710_710_711_711_711_711_713_715_716_716_717_718_720_720_721_721_721_721_723_725_726_726_738_740_745_772_773_776_777_782_783_785_785_786_786_786_786_786_793_795_796_798_802_804_807_814_814_814_814_815_821_822_830_830_835_837_842_842_842_842_842_849_852_856_856_856_859_859_859_859_861_865_865_865_868_868_868_868_871_872_872_872_873_875_879_880_880_880_881_883_886_887_887_887_887_888_888_889_889_889_890_891_892_894_895_895_895_895_896_896_897_897_897_898_899_900_904_910_910_910_912_912_912_916_917_918_921_921_921_923_925_928_928_931_933_935_935_936_936_956_958_965_980_983_1003_1005_1011_1020_1020_1025_1025_1031_1031_1040_1042_1043_1044_1046_1049_1053_1057_1058_1061_1070_1077_1082_1088_1088_1088_1093_1094_1100_1112_1112_1120_1120_1124_1124_1124_1124_1130_1131_1131_1131_1131_1137_1147_1148_1149_1156_1170_1171_1171_1172_1177_1178_1178_1179_1197_1200_1204_1205_1209_1211_1211_1211_1212_1220_1222_1236_1238_1251_1251_1254_1259_1264_1268_1271_1274_1276_1283_1311_1311_1311_1315_1315_1315_1319_1320_1324_1325_1327_1328_1343_1343_1350_1388_1388_1392_1401_1409_1421_1425_1425_1430_1437_1437_1442_1447_1450_1462_1467_1469_1470_1473_1473_1477_1477_1481_1484_1484_1488_,2009_2009_2009_2009_2015_2024_2030_2031_2044_2055_2057_2066_2068_2070_2072_2072_2072_2081_2081_2083_2083_2089_2099_2104_2104_2114_2117_2123_2124_2126_2126_2126_2126_2134_2139_2143_2154_2154_2159_2159_2161_2162_2162_2162_2162_2167_2167_2167_2175_2192_2196_2201_2201_2211_2219_2219_2220_2221_2221_2222_2231_2231_2231_2232_2235_2236_2255_2257_2260_2260_2264_2266_2268_2272_2272_2272_2272_2276_2279_2279_2289_2290_2291_2294_2299_2302_2309_2309_2314_2314_2314_2317_2317_2317_2318_2319_2322_2328_2330_2333_2334_2340_2341_2360_2360_2360_2360_2360_2360_2360_2360_2360_2360_2360_2361_2361_2361_2361_2361_2361_2361_2361_2361_2361_2361_2362_2390_2391_2400_2402_2411_2425_2428_2436_2436_2445_2445_2445_2446_2446_2446_2458_2458_2458_2458_2463_2463_2465_2465_2484_2487_2488_2500_2501_2509_2516_2517_2518_2519_2521_2522_2522_2525_2525_2528_2534_2540_2549_2550_2554_2555_2558_2566_2566_2572_2578_2579_2587_2589_2589_2589_2594_2598_2599_2604_2606_2606_2606_2608_2608_2609_2609_2613_2613_2626_2630_2631_2632_2633_2637_2637_2637_2638_2638_2638_2648_2650_2650_2653_2653_2659_2680_2680_2684_2684_2687_2687_2688_2698_2698_2698_2700_2700_2700_2700_2701_2701_2701_2701_2703_2710_2712_2715_2716_2718_2719_2721_2722_2730_2731_2731_2737_2747_2749_2767_2767_2769_2770_2771_2775_2779_2779_2782_2782_2784_2785_2791_2793_2794_2795_2798_2800_2809_2812_2815_2824_2824_2824_2826_2826_2826_2827_2835_2835_2842_2843_2852_2853_2860_2861_2864_2865_2869_2881_2881_2881_2881_2881_2881_2882_2883_2883_2889_2889_2890_2890_2897_2898_2900_2915_2919_2919_2923_2925_2925_2933_2933_2933_2933_2933_2933_2933_2934_2945_2946_2964_2968_2968_2976_2977_2979_2987_2995_2997_2999_3000_3000_3013_3013_3013_3013_3015_3019_3020_3022_3023_3034_3040_3040_3041_3047_3051_3055_3056_3056_3058_3069_3070_3074_3079_3083_3083_3095_3095_3095_3096_3110_3122_3127_3132_3133_3158_3159_3159_3159_3159_3163_3167_3179_3184_3185_3185_3185_3185_3185_3185_3187_3189_3195_3205_3206_3210_3213_3213_3214_3215_3218_3218_3219_3222_3223_3231_3231_3231_3232_3232_3234_3243_3243_3243_3243_3243_3244_3246_3246_3246_3249_3253_3255_3255_3256_3256_3257_3268_3272_3274_3274_3281_3281_3291_3292_3295_3306_3308_3308_3308_3319_3319_3321_3322_3327_3329_3329_3332_3340_3341_3347_3352_3354_3358_3360_3360_3360_3360_3360_3360_3360_3363_3366_3367_3367_3368_3368_3369_3370_3383_3383_3384_3384_3391_3391_3392_3393_3393_3394_3409_3409_3417_3418_3418_3418_3418_3418_3418_3418_3420_3421_3425_3431_3432_3433_3433_3433_3433_3433_3435_3435_3435_3435_3435_3438_3438_3443_3446_3447_3448_3453_3454_3458_3462_3465_3466_3478_3480_3482_
9,3,台,N,13,24,37,67_67_74_74_144_153_658_842_1062_1109_1117_1474_,2084_2085_2333_2334_2549_2550_2814_2835_2976_2986_2996_3046_3049_3050_3071_3090_3152_3352_3354_3418_3447_3447_3459_
9,3,拆遷,Vt,1,1,2,,
9,3,差,Vi,91,811,902,11_14_23_23_31_31_114_121_129_144_150_157_176_182_192_213_222_227_241_251_266_271_287_292_300_414_497_507_546_548_555_557_611_620_629_658_664_677_686_691_746_746_747_749_811_830_869_877_886_894_904_940_961_970_971_988_988_995_996_1009_1010_1028_1054_1073_1080_1089_1105_1109_1117_1145_1183_1189_1195_1198_1219_1221_1236_1238_1266_1332_1348_1350_1353_1367_1377_1437_1456_1463_1468_1472_,2002_2002_2004_2006_2011_2017_2020_2020_2024_2024_2025_2027_2027_2037_2044_2047_2048_2048_2050_2053_2056_2057_2059_2059_2060_2060_2070_2074_2074_2074_2074_2075_2076_2077_2079_2084_2085_2093_2093_2094_2096_2098_2099_2105_2112_2112_2114_2116_2116_2116_2116_2117_2119_2119_2119_2119_2126_2127_2134_2134_2134_2135_2135_2136_2140_2151_2151_2151_2154_2154_2154_2154_2154_2154_2158_2159_2166_2172_2177_2178_2179_2183_2183_2183_2183_2188_2196_2197_2201_2204_2207_2208_2211_2213_2215_2215_2216_2224_2227_2228_2228_2229_2231_2231_2235_2235_2236_2236_2237_2238_2239_2240_2241_2246_2246_2246_2246_2249_2249_2251_2251_2258_2259_2260_2266_2269_2270_2272_2273_2275_2279_2279_2287_2288_2289_2291_2291_2292_2294_2296_2297_2297_2298_2300_2300_2301_2304_2305_2307_2308_2310_2311_2312_2315_2320_2321_2322_2322_2322_2322_2325_2326_2327_2329_2332_2335_2335_2338_2340_2340_2341_2341_2347_2347_2353_2353_2356_2356_2356_2356_2360_2361_2365_2367_2367_2370_2370_2371_2371_2371_2373_2373_2374_2374_2374_2380_2381_2381_2382_2383_2384_2384_2388_2388_2390_2391_2393_2394_2398_2400_2402_2404_2417_2421_2426_2436_2436_2439_2444_2444_2445_2446_2447_2450_2450_2450_2450_2450_2453_2453_2453_2453_2453_2454_2455_2459_2459_2463_2464_2464_2465_2466_2466_2469_2469_2469_2469_2469_2470_2475_2483_2485_2486_2492_2493_2500_2501_2503_2506_2507_2508_2512_2516_2518_2522_2525_2526_2527_2528_2530_2530_2531_2532_2533_2540_2541_2544_2548_2556_2557_2558_2561_2562_2564_2565_2565_2565_2565_2567_2568_2571_2572_2573_2573_2574_2579_2585_2585_2587_2589_2589_2590_2601_2604_2607_2608_2608_2608_2608_2608_2608_2608_2608_2608_2609_2630_2630_2631_2631_2637_2638_2649_2650_2650_2651_2651_2653_2653_2654_2654_2657_2658_2671_2671_2675_2677_2678_2679_2684_2684_2684_2687_2687_2687_2698_2703_2704_2705_2706_2707_2707_2708_2708_2714_2725_2726_2727_2728_2728_2729_2729_2732_2732_2740_2740_2740_2740_2744_2746_2747_2749_2752_2754_2756_2765_2765_2767_2769_2770_2772_2779_2780_2782_2790_2790_2791_2791_2794_2796_2796_2803_2806_2814_2817_2817_2819_2819_2822_2824_2826_2829_2829_2835_2837_2845_2852_2857_2857_2858_2858_2862_2864_2864_2865_2867_2867_2867_2869_2874_2877_2878_2879_2879_2879_2880_2880_2880_2888_2889_2889_2889_2890_2890_2890_2896_2897_2898_2899_2903_2903_2905_2905_2907_2908_2909_2909_2910_2910_2912_2916_2916_2920_2922_2923_2923_2923_2926_2927_2929_2930_2931_2943_2944_2945_2949_2949_2951_2953_2953_2956_2957_2958_2958_2959_2960_2961_2962_2963_2965_2965_2966_2966_2967_2969_2975_2976_2976_2976_2976_2977_2978_2978_2979_2979_2981_2982_2990_2992_2995_2996_3001_3002_3004_3004_3006_3007_3007_3011_3011_3011_3012_3012_3020_3025_3027_3029_3029_3029_3030_3032_3032_3032_3033_3033_3033_3036_3037_3044_3048_3049_3055_3057_3058_3060_3060_3065_3067_3069_3069_3070_3070_3073_3074_3076_3076_3082_3083_3083_3085_3086_3087_3087_3093_3093_3095_3097_3099_3104_3107_3107_3111_3114_3115_3119_3119_3121_3122_3122_3122_3122_3124_3124_3126_3127_3127_3127_3127_3129_3130_3132_3133_3135_3135_3137_3144_3144_3147_3149_3150_3152_3152_3152_3154_3155_3156_3159_3159_3161_3163_3167_3171_3173_3174_3175_3176_3177_3179_3184_3184_3184_3184_3184_3185_3185_3194_3195_3196_3196_3201_3201_3205_3206_3207_3207_3208_3208_3209_3211_3214_3216_3219_3220_3221_3225_3226_3226_3226_3226_3227_3228_3228_3228_3229_3229_3229_3233_3233_3237_3240_3240_3243_3244_3244_3245_3246_3247_3252_3257_3259_3260_3260_3260_3260_3262_3263_3265_3266_3266_3270_3272_3272_3276_3278_3278_3279_3281_3286_3286_3287_3293_3293_3297_3305_3310_3310_3313_3317_3318_3318_3319_3321_3322_3323_3325_3325_3325_3326_3326_3329_3331_3331_3333_3334_3335_3340_3341_3341_3341_3342_3347_3351_3351_3359_3361_3361_3361_3362_3362_3362_3363_3365_3366_3366_3369_3370_3373_3374_3376_3378_3382_3385_3385_3386_3386_3387_3388_3388_3389_3389_3390_3390_3396_3396_3397_3401_3402_3406_3407_3409_3409_3409_3409_3411_3414_3415_3418_3420_3421_3425_3426_3428_3431_3431_3432_3432_3433_3435_3440_3440_3440_3442_3442_3442_3444_3445_3446_3448_3451_3453_3456_3458_3458_3458_3458_3458_3459_3460_3464_3466_3467_3467_3467_3471_3471_3479_3480_3480_3481_3482_3482_3485_3488_3488_3490_3490_3494_3496_3498_3499_3500_
9,3,小姐,N,34,111,145,35_112_148_153_155_174_216_223_290_297_305_321_321_340_482_491_521_530_634_674_872_880_887_887_895_895_956_1109_1117_1477_1480_1484_1487_,2029_2029_2029_2059_2072_2149_2272_2272_2281_2281_2282_2282_2290_2342_2342_2343_2359_2384_2387_2419_2454_2455_2500_2500_2501_2501_2537_2538_2560_2576_2599_2616_2649_2731_2731_2731_2731_2746_2746_2746_2746_2746_2746_2767_2793_2835_2835_2902_2904_2938_3032_3032_3033_3033_3034_3038_3039_3071_3132_3133_3193_3204_3239_3239_3239_3243_3243_3247_3247_3254_3255_3256_3308_3308_3308_3308_3308_3319_3323_3324_3329_3329_3331_3331_3351_3351_3357_3367_3368_3380_3380_3380_3397_3417_3433_3433_3433_3433_3433_3433_3433_3433_3435_3435_3435_3435_3435_3435_3435_3435_
9,3,鄙視,Vt,1,6,7,,2206_2295_2731_2802_3098_
9,3,交通,N,186,58,244,17_65_66_68_72_73_75_78_81_84_87_91_95_96_100_102_105_106_120_122_128_130_146_148_156_176_222_238_264_265_271_276_284_288_315_320_320_320_320_343_344_353_354_363_368_381_384_402_406_412_414_444_452_505_508_522_525_531_534_539_540_543_571_580_584_585_588_588_590_635_637_657_669_681_682_704_706_732_749_763_767_769_783_786_789_790_791_792_801_814_817_818_820_821_823_824_834_837_837_841_842_849_850_857_857_866_866_876_876_884_884_885_888_889_889_891_891_893_896_897_897_899_899_901_901_902_907_910_914_915_923_928_931_935_936_940_958_959_962_967_973_974_983_987_1006_1017_1042_1068_1070_1071_1075_1077_1078_1129_1135_1136_1163_1165_1168_1175_1204_1206_1228_1230_1231_1234_1264_1292_1296_1300_1304_1307_1320_1325_1337_1341_1344_1345_1346_1349_1388_1389_1429_1457_1474_,2048_2124_2139_2143_2153_2154_2154_2162_2162_2163_2219_2221_2237_2238_2305_2308_2333_2334_2397_2454_2455_2470_2498_2505_2531_2547_2610_2637_2638_2651_2654_2678_2678_2797_2805_2882_2895_2901_2918_2925_2967_3015_3038_3039_3055_3135_3163_3185_3232_3235_3273_3293_3307_3318_3318_3434_3436_
9,3,時候,N,113,200,313,12_35_37_41_68_68_75_75_144_186_186_186_196_196_196_204_210_211_219_227_238_253_263_281_281_288_364_369_374_391_471_475_522_531_546_551_555_560_568_568_568_577_577_577_582_583_616_616_625_625_630_670_707_717_736_738_772_772_776_776_783_794_797_873_875_881_883_887_891_895_899_902_921_921_923_923_931_931_978_1041_1057_1088_1114_1145_1169_1176_1201_1232_1238_1240_1251_1251_1270_1270_1273_1273_1319_1319_1324_1324_1328_1343_1343_1378_1393_1402_1425_1431_1465_1472_1477_1484_,2098_2107_2159_2161_2162_2162_2162_2201_2209_2209_2210_2210_2220_2222_2232_2232_2252_2252_2252_2253_2253_2253_2271_2271_2340_2341_2360_2360_2360_2360_2361_2361_2361_2361_2381_2381_2383_2394_2426_2450_2450_2450_2450_2453_2453_2453_2453_2454_2455_2500_2501_2522_2549_2549_2549_2550_2550_2550_2565_2567_2567_2567_2572_2604_2606_2609_2609_2615_2621_2626_2637_2638_2666_2667_2702_2715_2716_2730_2731_2731_2731_2731_2731_2753_2756_2761_2762_2769_2769_2770_2770_2775_2787_2789_2794_2796_2802_2806_2806_2809_2815_2835_2838_2838_2861_2861_2861_2861_2864_2867_2885_2887_2933_2953_2956_2957_2974_2987_2987_2987_2995_2995_2999_3005_3008_3013_3020_3038_3038_3038_3039_3039_3039_3047_3051_3071_3074_3084_3099_3117_3120_3125_3133_3133_3150_3150_3150_3193_3194_3196_3196_3202_3220_3221_3224_3231_3231_3231_3234_3243_3246_3253_3253_3261_3274_3313_3318_3331_3337_3351_3360_3361_3362_3391_3393_3397_3409_3433_3433_3433_3433_3433_3435_3435_3435_3435_3435_3446_3451_3456_3458_3460_3460_3462_3470_3475_3478_3478_3493_
9,3,懶得,Vt,1,10,11,,2288_2360_2360_2360_2361_2361_2361_2662_3409_
9,3,人家,N,9,20,29,112_408_670_701_886_887_894_895_,2360_2361_2649_2698_2782_2822_2822_2898_2958_2958_3049_3078_3103_3353_3355_3433_3435_3477_3487_
9,3,6月,N,23,30,53,133_216_442_443_566_575_888_896_938_982_1020_1061_1082_1088_1088_1091_1145_1203_1203_1203_1319_1324_,2343_2368_2369_2386_2445_2446_2447_2516_2518_2609_2702_2779_2914_2941_3049_3065_3067_3159_3159_3165_3168_3169_3258_3345_3345_3352_3354_3373_3374_
9,3,周圍,N,84,43,127,93_102_104_106_117_125_154_216_239_249_296_304_335_342_352_376_395_410_418_484_493_498_522_531_566_575_596_600_605_609_747_779_792_804_814_814_814_819_819_823_844_845_846_890_892_898_900_914_957_977_981_1001_1005_1006_1007_1020_1043_1071_1071_1078_1078_1090_1107_1113_1121_1124_1131_1171_1178_1186_1192_1206_1228_1230_1238_1238_1297_1301_1328_1331_1341_1385_1427_,2057_2120_2121_2179_2206_2232_2442_2483_2537_2538_2588_2610_2671_2691_2698_2728_2729_2740_2740_2746_2749_2772_2815_2828_2833_2896_2965_2966_2977_3012_3056_3087_3132_3149_3149_3178_3185_3293_3306_3365_3414_3475_
9,3,同意,Vt,7,18,25,396_641_794_797_1106_1498_,2083_2287_2287_2288_2288_2391_2630_2731_2733_2740_2828_2914_2923_3076_3086_3367_3368_
9,3,前面,N,20,28,48,186_196_239_249_287_396_407_584_970_1112_1120_1168_1175_1352_1428_1450_1459_1464_1496_,2258_2259_2388_2528_2572_2864_2908_3040_3059_3095_3115_3186_3188_3231_3274_3331_3347_3372_3372_3373_3374_3417_3418_3433_3435_3448_3453_
9,3,爭,Vt,1,1,2,,
9,3,26日,N,1,2,3,,3458_
9,3,總,A,23,32,55,150_153_203_204_209_210_429_499_512_513_628_683_902_1062_1088_1109_1117_1232_1243_1247_1281_1288_,2309_2310_2311_2333_2334_2416_2426_2457_2742_2872_2976_2986_3046_3050_3071_3090_3103_3152_3202_3231_3253_3376_3378_3403_3408_3418_3433_3435_3447_3447_3459_
9,3,竟然,ADV,33,156,189,52_52_108_213_290_320_379_379_424_629_635_636_637_638_711_721_770_774_872_880_988_990_990_993_993_1062_1124_1131_1145_1203_1211_1258_,2002_2009_2012_2044_2057_2057_2066_2072_2074_2079_2081_2081_2081_2081_2081_2081_2083_2083_2083_2083_2083_2083_2089_2136_2136_2139_2140_2140_2143_2144_2145_2159_2163_2193_2228_2229_2232_2235_2236_2272_2272_2299_2302_2344_2349_2372_2372_2375_2375_2412_2419_2445_2445_2445_2445_2446_2446_2446_2446_2454_2455_2457_2480_2483_2486_2494_2495_2525_2526_2527_2527_2528_2528_2528_2531_2532_2533_2635_2662_2662_2669_2669_2691_2714_2731_2739_2773_2823_2825_2931_2944_2946_2989_2991_3001_3005_3009_3010_3044_3048_3073_3083_3089_3091_3096_3098_3132_3133_3146_3150_3150_3150_3150_3150_3158_3158_3159_3159_3174_3186_3188_3195_3201_3201_3202_3202_3207_3212_3217_3237_3237_3244_3246_3254_3255_3256_3288_3288_3288_3313_3345_3367_3368_3369_3370_3371_3419_3433_3433_3435_3435_3458_3458_3477_3487_
9,3,知道,Vt,74,207,281,41_41_41_41_103_122_130_182_182_192_192_213_217_241_251_322_334_410_428_431_439_544_546_546_546_555_555_555_566_575_593_602_630_710_720_766_779_786_823_846_872_872_880_880_886_886_887_888_894_894_895_896_910_921_921_944_1001_1011_1016_1020_1057_1057_1082_1211_1212_1217_1217_1326_1328_1423_1423_1428_1499_,2023_2042_2050_2053_2057_2067_2067_2069_2074_2081_2081_2083_2083_2123_2125_2134_2139_2143_2144_2145_2159_2183_2189_2199_2211_2220_2222_2231_2249_2251_2264_2264_2264_2269_2273_2273_2278_2283_2309_2309_2309_2309_2321_2326_2338_2343_2344_2349_2359_2377_2380_2381_2381_2382_2387_2388_2412_2419_2493_2510_2511_2516_2518_2522_2526_2534_2549_2549_2550_2550_2554_2555_2572_2590_2594_2608_2647_2649_2671_2671_2679_2690_2707_2707_2708_2708_2731_2748_2766_2769_2770_2771_2782_2824_2826_2835_2841_2848_2851_2852_2852_2867_2867_2902_2904_2914_2925_2939_2940_2975_2997_3001_3009_3010_3032_3033_3038_3038_3038_3038_3039_3039_3039_3039_3043_3057_3059_3071_3073_3076_3095_3097_3103_3105_3110_3119_3124_3158_3195_3196_3206_3210_3213_3215_3218_3242_3246_3246_3246_3247_3253_3253_3255_3256_3264_3267_3270_3279_3281_3282_3288_3289_3289_3289_3289_3290_3290_3290_3290_3298_3301_3307_3308_3331_3344_3347_3376_3376_3378_3378_3416_3418_3425_3431_3431_3432_3432_3433_3435_3445_3448_3448_3452_3453_3453_3457_3458_3458_3466_3466_3467_3467_3470_3470_3495_3497_
9,3,等,Vt,25,64,89,64_71_93_272_363_368_573_617_626_644_710_710_720_720_841_858_867_938_983_1057_1112_1120_1328_1425_,2057_2136_2140_2186_2205_2209_2210_2220_2222_2231_2232_2244_2245_2258_2259_2294_2324_2359_2372_2375_2391_2450_2453_2457_2458_2527_2531_2592_2606_2608_2609_2691_2769_2770_2796_2828_2828_2836_2838_2855_2856_2987_3013_3029_3049_3056_3132_3161_3185_3185_3185_3185_3213_3218_3253_3253_3288_3319_3344_3360_3360_3471_3487_
9,1,弟兄,N,1,0,1,,
9,3,鬱悶,Vi,7,35,42,35_186_196_1145_1430_1496_,2069_2099_2239_2264_2279_2291_2393_2502_2603_2605_2680_2680_2775_2775_2775_2822_2831_2832_2861_2889_2890_3052_3053_3105_3119_3124_3132_3146_3158_3266_3331_3357_3458_3487_
9,3,插隊,Vi,1,1,2,,
10,3,貴,Vi,75,71,146,17_47_52_109_150_203_209_274_287_291_297_299_305_320_343_344_350_353_354_360_388_398_399_401_422_448_450_456_458_546_555_588_590_594_603_670_670_670_684_806_807_887_887_895_895_921_959_991_994_1015_1056_1057_1081_1114_1124_1131_1149_1155_1156_1162_1199_1201_1223_1225_1329_1398_1407_1425_1431_1433_1435_1453_1473_1473_,2040_2056_2060_2113_2122_2153_2161_2175_2215_2298_2301_2390_2409_2410_2419_2463_2465_2544_2544_2606_2623_2626_2659_2731_2735_2736_2749_2783_2794_2830_2834_2851_2862_2867_2869_2908_2930_2954_3054_3082_3090_3099_3138_3146_3152_3163_3185_3194_3237_3244_3246_3282_3299_3300_3302_3303_3318_3319_3326_3336_3364_3379_3380_3420_3421_3437_3448_3453_3488_3490_
10,3,修路,Vi,11,7,18,12_628_648_650_654_656_662_830_981_1419_,2034_2120_2121_2883_3365_3475_
10,3,內,N,78,113,191,16_37_40_41_50_77_83_112_113_114_116_116_119_127_157_176_213_229_274_276_277_282_391_435_543_546_555_599_608_650_656_707_711_717_721_743_753_773_777_802_803_813_838_847_856_859_865_868_875_883_889_897_913_924_932_1005_1010_1026_1030_1049_1050_1114_1139_1154_1161_1219_1221_1243_1247_1249_1310_1314_1339_1418_1491_1494_1499_,2043_2045_2059_2061_2078_2101_2102_2110_2125_2136_2140_2153_2163_2163_2177_2232_2232_2275_2304_2307_2320_2324_2342_2363_2363_2409_2410_2417_2417_2452_2492_2508_2508_2528_2530_2553_2553_2553_2553_2553_2559_2571_2571_2571_2582_2651_2651_2651_2654_2654_2654_2682_2685_2698_2698_2714_2744_2759_2759_2759_2759_2813_2813_2815_2845_2848_2870_2873_2873_2959_2972_2974_2976_2985_2988_3030_3034_3065_3067_3071_3073_3074_3076_3084_3098_3098_3101_3120_3125_3139_3146_3146_3196_3223_3246_3246_3253_3257_3313_3347_3360_3360_3360_3386_3391_3393_3462_3462_3465_3466_3477_3483_
10,3,前,N,9,13,22,41_308_312_657_661_662_823_964_,2835_3069_3070_3108_3109_3288_3319_3333_3340_3373_3374_3470_
10,3,門,N,46,98,144,40_40_106_119_127_298_306_321_335_341_391_526_535_565_566_574_575_657_661_669_762_787_787_889_889_890_897_897_898_917_957_970_1057_1059_1070_1077_1211_1264_1319_1324_1328_1375_1411_1416_1450_,2037_2037_2037_2037_2037_2068_2090_2114_2114_2117_2117_2134_2148_2206_2211_2220_2222_2289_2338_2356_2360_2361_2384_2416_2419_2419_2419_2445_2446_2500_2501_2510_2511_2521_2521_2521_2541_2561_2562_2576_2585_2585_2609_2651_2654_2714_2756_2756_2756_2809_2815_2828_2828_2828_2861_2861_2884_2886_2919_2958_2976_2987_2987_3038_3039_3041_3055_3083_3118_3133_3161_3237_3246_3253_3264_3289_3290_3319_3321_3322_3332_3339_3339_3351_3351_3369_3369_3370_3370_3385_3433_3434_3435_3436_3448_3453_3454_
10,3,小時,N,37,93,130,64_71_89_89_109_152_184_194_239_249_269_280_320_435_465_520_521_529_530_546_555_670_739_749_780_802_835_837_842_859_868_938_995_996_1011_1425_,2104_2108_2108_2136_2140_2196_2209_2210_2211_2231_2231_2244_2244_2245_2245_2266_2269_2284_2289_2338_2372_2375_2394_2458_2458_2486_2529_2579_2588_2604_2604_2606_2606_2616_2680_2767_2775_2806_2816_2818_2836_2862_2863_2881_2908_2923_2924_2946_2947_2961_2963_2981_2982_2987_2987_3001_3029_3040_3129_3130_3132_3146_3161_3185_3185_3185_3195_3213_3218_3246_3291_3291_3292_3292_3319_3319_3341_3397_3399_3416_3431_3432_3433_3434_3435_3436_3448_3453_3458_3460_3475_3499_
10,3,門口,N,71,61,132,35_65_66_72_73_108_145_204_210_271_324_363_368_386_424_439_521_528_530_537_584_616_625_630_644_708_710_718_720_742_789_790_792_815_817_820_820_822_823_830_833_835_842_849_886_891_894_899_910_916_962_963_1031_1067_1074_1099_1169_1176_1218_1233_1319_1324_1418_1419_1431_1433_1435_1437_1463_1468_,2037_2050_2053_2108_2134_2137_2139_2141_2143_2162_2162_2206_2281_2282_2326_2326_2360_2360_2361_2361_2411_2445_2446_2534_2587_2651_2654_2705_2706_2731_2809_2815_2857_2858_2861_2867_2873_2883_2967_3038_3039_3076_3103_3192_3223_3231_3231_3233_3241_3278_3308_3319_3376_3378_3392_3394_3402_3407_3409_3475_
11,3,本身,N,12,8,20,242_252_521_524_530_533_857_866_1088_1106_1201_,2647_2671_2757_2758_3103_3479_3481_
11,3,一下,N,67,76,143,12_41_109_111_186_196_217_227_235_287_320_323_326_331_412_435_446_451_454_459_468_469_472_473_505_520_521_529_530_546_553_555_562_614_623_707_717_729_794_797_822_887_895_923_931_1020_1091_1102_1102_1168_1175_1211_1212_1238_1249_1270_1273_1319_1319_1324_1324_1340_1343_1472_1481_1488_,2037_2071_2134_2134_2158_2162_2208_2232_2276_2298_2299_2299_2301_2302_2302_2309_2359_2360_2361_2362_2372_2375_2411_2436_2445_2446_2508_2517_2519_2532_2533_2561_2562_2572_2609_2680_2704_2731_2754_2756_2791_2869_2872_2898_2923_2946_2972_2976_3020_3038_3039_3049_3049_3083_3107_3117_3150_3158_3196_3270_3289_3290_3294_3318_3345_3349_3353_3353_3355_3355_3360_3433_3435_3460_3470_
11,3,那邊,N,6,16,22,584_1243_1247_1250_1425_,2232_2387_2463_2465_2525_2525_2730_2925_3059_3106_3246_3352_3354_3433_3435_
11,3,加,Vt,26,69,95,157_227_328_328_333_333_710_720_745_784_805_835_873_876_881_884_1007_1061_1208_1211_1235_1259_1491_1494_1498_,2084_2085_2104_2139_2143_2162_2246_2252_2253_2266_2322_2447_2483_2483_2483_2483_2483_2494_2495_2541_2541_2549_2549_2550_2550_2553_2553_2553_2565_2565_2603_2605_2606_2659_2688_2747_2775_2775_2775_2787_2789_2846_2861_2882_2972_3040_3061_3093_3115_3115_3119_3124_3146_3146_3158_3165_3202_3264_3289_3290_3294_3308_3308_3313_3313_3329_3350_3379_
11,3,問題,N,101,192,293,51_109_111_135_150_173_178_186_188_196_213_215_217_281_288_289_335_434_443_481_481_504_546_546_546_546_546_546_555_555_555_555_555_555_617_626_628_630_630_630_700_713_723_750_770_774_783_783_784_784_806_819_837_849_857_866_885_893_902_960_973_1028_1029_1030_1030_1031_1057_1100_1100_1100_1107_1141_1143_1169_1176_1234_1242_1246_1256_1311_1315_1319_1319_1319_1324_1324_1324_1337_1337_1340_1366_1423_1450_1451_1455_1469_1469_1470_1470_1471_,2005_2037_2037_2055_2084_2085_2095_2097_2108_2127_2159_2162_2162_2162_2162_2163_2184_2209_2210_2223_2225_2225_2226_2226_2232_2246_2247_2252_2252_2253_2253_2258_2259_2260_2269_2305_2305_2308_2308_2309_2342_2363_2372_2375_2391_2394_2406_2408_2432_2435_2445_2446_2447_2483_2509_2516_2516_2517_2517_2517_2518_2518_2519_2519_2519_2522_2522_2547_2551_2565_2579_2582_2582_2587_2604_2604_2609_2636_2650_2651_2651_2651_2651_2653_2654_2654_2654_2654_2671_2698_2730_2730_2742_2742_2744_2746_2746_2747_2747_2747_2753_2769_2770_2809_2816_2818_2828_2847_2857_2858_2862_2872_2872_2881_2915_2916_2946_2946_2947_2974_3049_3049_3056_3098_3098_3108_3109_3119_3124_3132_3132_3139_3142_3170_3170_3172_3172_3187_3189_3227_3232_3237_3246_3246_3246_3269_3269_3269_3281_3288_3291_3292_3294_3296_3300_3303_3308_3308_3329_3341_3371_3371_3386_3388_3389_3390_3414_3414_3421_3431_3431_3431_3431_3431_3432_3432_3432_3432_3432_3433_3433_3435_3435_3443_3446_3448_3453_3465_3466_3466_3466_
11,3,食品,N,7,13,20,239_249_714_724_962_1010_,2616_2616_2640_2798_2798_2800_2800_2816_2818_3152_3177_3177_
11,3,早餐,N,362,324,686,14_16_18_36_38_39_45_48_52_63_70_79_85_91_91_93_99_109_133_135_139_142_147_149_149_150_159_160_161_163_166_168_183_186_186_186_193_196_196_196_216_216_219_227_235_239_245_246_249_255_256_259_261_271_272_274_281_283_287_287_290_290_291_292_293_297_298_299_300_301_305_306_308_312_317_320_324_325_327_330_332_334_349_359_364_366_369_371_379_379_386_387_391_391_392_393_395_407_413_414_416_417_427_435_437_449_451_457_459_467_471_475_481_481_483_492_501_503_506_508_518_518_520_520_522_523_526_526_528_529_529_531_532_535_535_537_546_549_551_552_555_558_560_561_566_569_570_575_578_579_585_589_590_618_627_628_630_635_637_639_647_653_657_660_662_664_664_669_669_674_676_677_684_688_693_708_711_714_718_721_724_732_733_734_736_738_746_746_749_752_759_760_762_792_794_797_799_800_801_802_804_812_812_813_813_820_827_830_831_851_853_856_856_859_860_862_865_865_868_889_897_913_924_932_939_945_949_954_955_959_970_982_982_987_990_993_1003_1006_1008_1010_1012_1013_1020_1028_1028_1029_1031_1036_1037_1039_1040_1042_1043_1046_1048_1049_1050_1054_1054_1087_1087_1090_1091_1091_1096_1124_1124_1124_1124_1124_1125_1129_1130_1131_1131_1131_1131_1131_1132_1136_1137_1140_1145_1148_1153_1154_1160_1161_1171_1171_1178_1178_1181_1187_1201_1202_1204_1208_1211_1215_1218_1219_1221_1227_1228_1229_1230_1235_1236_1253_1266_1277_1280_1282_1284_1287_1289_1293_1295_1299_1302_1305_1308_1312_1338_1343_1348_1358_1359_1362_1364_1367_1369_1371_1388_1408_1409_1413_1425_1427_1430_1437_1437_1441_1446_1456_1461_1462_1466_1467_1469_1469_1470_1470_1471_1473_1479_1486_1490_1493_1496_,2016_2020_2037_2038_2040_2050_2053_2056_2057_2057_2068_2069_2079_2091_2092_2101_2102_2104_2104_2104_2105_2123_2123_2134_2135_2139_2139_2143_2143_2158_2164_2175_2179_2183_2184_2188_2191_2193_2199_2201_2201_2201_2242_2246_2247_2252_2253_2266_2266_2272_2294_2294_2299_2302_2304_2305_2305_2305_2305_2305_2307_2308_2308_2308_2308_2308_2312_2313_2315_2316_2322_2328_2330_2335_2343_2344_2347_2349_2358_2368_2369_2388_2393_2395_2398_2404_2405_2407_2411_2411_2411_2413_2414_2419_2432_2435_2438_2439_2440_2445_2446_2448_2450_2451_2453_2454_2455_2460_2461_2483_2499_2509_2517_2517_2519_2519_2520_2520_2527_2543_2548_2566_2566_2566_2567_2567_2572_2596_2596_2597_2597_2607_2607_2615_2616_2623_2623_2623_2624_2626_2630_2651_2652_2654_2655_2662_2671_2671_2674_2674_2674_2678_2698_2705_2706_2707_2708_2714_2735_2736_2739_2739_2740_2740_2740_2749_2754_2757_2758_2769_2769_2770_2770_2774_2779_2782_2783_2784_2787_2789_2790_2814_2816_2816_2818_2818_2822_2829_2831_2832_2833_2847_2864_2867_2867_2869_2870_2871_2882_2882_2916_2931_2941_2942_2943_2945_2945_2951_2951_2959_2968_2968_2969_2976_2996_2996_2997_2998_3012_3014_3014_3019_3029_3032_3033_3049_3056_3065_3067_3069_3070_3073_3074_3078_3079_3083_3083_3083_3097_3100_3107_3111_3118_3135_3145_3146_3146_3149_3152_3166_3178_3179_3184_3184_3184_3184_3186_3188_3194_3197_3199_3201_3207_3225_3237_3249_3253_3253_3253_3258_3260_3269_3286_3288_3288_3288_3289_3290_3293_3298_3301_3305_3313_3316_3326_3331_3360_3363_3364_3365_3376_3378_3379_3379_3379_3388_3395_3398_3409_3414_3423_3423_3423_3424_3424_3424_3431_3431_3432_3432_3439_3441_3444_3458_3458_3459_3465_3475_3479_3481_3488_3490_3492_
11,3,重視,Vt,6,26,32,137_435_443_481_783_,2131_2133_2258_2259_2447_2535_2544_2609_2671_2798_2800_2824_2824_2826_2826_2857_2858_2862_3205_3253_3288_3367_3368_3448_3453_
11,3,應該,ADV,92,83,175,40_108_158_160_162_163_163_167_168_168_173_182_186_192_196_227_227_267_276_278_278_281_288_334_401_424_433_440_478_480_487_489_501_505_511_526_535_567_572_576_581_584_584_614_623_645_646_651_652_669_700_743_747_787_802_818_821_886_886_892_894_894_900_929_937_939_969_1004_1020_1054_1054_1082_1091_1124_1124_1131_1131_1139_1141_1143_1237_1238_1251_1267_1293_1310_1314_1374_1428_1429_1453_,2012_2057_2081_2083_2086_2108_2110_2126_2126_2149_2151_2162_2167_2201_2219_2221_2227_2227_2312_2315_2344_2349_2377_2380_2391_2398_2445_2446_2454_2455_2483_2504_2504_2587_2609_2702_2718_2718_2721_2721_2742_2754_2754_2809_2814_2817_2819_2872_2872_2883_2895_2898_2946_2949_3013_3038_3039_3055_3073_3074_3083_3098_3101_3140_3222_3231_3231_3243_3243_3253_3253_3360_3364_3365_3367_3368_3397_3414_3417_3433_3435_3444_
12,3,告訴,Vt,36,77,113,186_196_203_203_209_209_388_410_434_482_491_630_710_711_720_721_736_794_794_797_797_871_879_887_887_895_895_943_1061_1232_1270_1273_1319_1324_1430_,2081_2083_2106_2178_2231_2276_2276_2287_2288_2298_2301_2309_2309_2359_2494_2495_2508_2517_2519_2527_2527_2549_2550_2554_2555_2565_2594_2595_2604_2604_2672_2731_2750_2815_2946_2970_2987_3001_3038_3039_3040_3065_3067_3076_3100_3110_3115_3132_3149_3163_3170_3172_3195_3210_3213_3215_3218_3247_3253_3254_3254_3255_3256_3289_3290_3297_3367_3368_3388_3388_3389_3390_3423_3424_3434_3436_
12,3,細節,N,28,3,31,141_162_167_214_316_434_437_506_526_535_628_628_650_656_661_699_889_897_1013_1030_1054_1058_1270_1273_1481_1488_1500_,3254_3272_
12,3,優點,N,19,41,60,176_308_312_379_540_825_876_884_886_894_939_957_1194_1201_1332_1392_1401_1429_,2131_2133_2163_2165_2189_2206_2281_2282_2339_2588_2656_2683_2686_2705_2706_2797_2822_2829_2845_2908_2939_2940_2965_2966_2969_2975_3031_3065_3067_3108_3109_3170_3172_3293_3318_3391_3393_3483_3488_3490_
12,3,行,Vi,54,33,87,17_82_88_95_95_98_133_149_374_396_427_545_553_562_566_570_575_579_600_609_628_629_630_649_655_707_717_733_750_771_775_832_835_854_863_887_895_958_1015_1049_1049_1051_1053_1163_1165_1171_1178_1233_1282_1289_1350_1374_1418_,2034_2161_2208_2284_2326_2432_2435_2541_2587_2594_2596_2597_2814_3100_3103_3103_3118_3129_3130_3139_3227_3235_3289_3290_3334_3366_3373_3374_3415_3459_3475_3475_
12,3,最近,N,13,14,27,68_75_100_540_551_560_663_944_1220_1222_1254_1254_,2499_2508_2534_2536_2680_2684_2687_2700_2701_3056_3079_3105_3152_
12,1,追,Vt,1,0,1,,
12,3,表揚,Vt,17,9,26,111_139_212_566_575_628_628_738_944_1067_1074_1102_1237_1282_1289_1451_,2517_2519_2651_2654_3196_3270_3466_3466_
12,3,改進,Vt,45,16,61,23_31_40_153_162_167_279_387_413_506_515_515_522_531_546_549_555_558_711_721_744_1019_1025_1055_1091_1148_1205_1216_1319_1319_1319_1324_1324_1324_1359_1364_1441_1446_1469_1470_1476_1481_1483_1488_,2193_2280_2359_2525_2551_2745_2759_2771_2857_2858_3253_3383_3384_3448_3453_
12,3,清潔,Vi,6,17,23,616_625_1030_1042_1343_,2209_2210_2271_2342_2631_2714_2784_2813_2845_2882_3223_3231_3294_3338_3495_3497_
12,3,標準,N,99,159,258,19_68_75_77_83_91_108_149_155_213_253_278_281_281_287_320_386_391_391_397_410_411_411_411_440_441_480_489_526_535_551_553_560_562_566_575_614_623_665_700_707_717_738_740_746_753_753_753_754_771_775_827_830_830_830_843_901_901_901_987_991_994_1029_1039_1086_1088_1089_1097_1098_1115_1141_1143_1167_1168_1169_1170_1172_1173_1174_1175_1176_1177_1179_1180_1213_1224_1226_1234_1243_1247_1271_1274_1332_1433_1435_1437_1453_1472_,2001_2003_2004_2005_2006_2018_2018_2023_2043_2045_2048_2070_2074_2075_2086_2098_2101_2102_2105_2108_2115_2118_2123_2125_2144_2145_2158_2161_2186_2186_2204_2225_2226_2233_2269_2269_2269_2273_2289_2322_2342_2367_2384_2385_2392_2417_2417_2424_2438_2440_2445_2446_2547_2574_2574_2585_2585_2601_2625_2626_2630_2637_2638_2639_2651_2654_2671_2675_2677_2709_2711_2728_2729_2734_2740_2740_2753_2768_2773_2775_2775_2804_2807_2810_2811_2814_2815_2824_2826_2836_2847_2873_2877_2878_2906_2917_2922_2946_2959_2959_2965_2966_2975_2995_3012_3029_3034_3047_3047_3051_3051_3052_3053_3065_3067_3100_3133_3142_3146_3146_3158_3165_3166_3171_3173_3210_3215_3224_3238_3240_3305_3343_3345_3347_3347_3352_3353_3354_3355_3356_3369_3370_3380_3385_3389_3390_3392_3394_3395_3459_3460_3480_3482_3489_3489_3491_3491_3492_
12,3,住,Vt,606,830,1436,20_23_23_28_31_31_38_47_51_51_51_51_51_53_53_58_58_66_67_68_69_73_74_75_76_82_88_100_100_103_103_108_119_119_124_127_127_132_134_138_139_142_144_152_155_160_162_167_176_177_177_179_179_180_185_186_186_186_187_189_189_190_195_196_196_196_197_199_199_204_205_205_210_212_213_215_216_218_219_223_224_226_229_230_230_231_232_240_240_242_242_244_244_244_250_250_252_252_254_254_254_263_266_267_269_271_274_279_281_282_282_283_286_287_290_297_298_298_305_306_306_308_308_308_312_312_312_316_317_320_325_326_327_328_330_331_332_333_334_335_338_338_342_347_350_351_351_352_357_360_361_361_374_376_377_379_381_384_388_392_394_396_397_401_404_404_410_412_419_423_427_428_431_437_437_442_447_448_450_451_455_456_458_459_461_462_465_468_471_472_475_482_482_484_491_491_493_494_494_495_498_499_499_501_508_509_509_520_520_520_521_522_524_525_525_526_526_527_528_529_529_529_530_531_533_534_534_535_535_536_537_540_540_546_548_553_554_554_555_557_562_563_563_569_570_573_573_578_579_582_583_586_587_589_590_590_597_599_600_600_608_609_609_610_612_617_619_621_626_629_633_634_636_638_662_662_663_663_667_668_669_669_669_670_670_676_676_677_678_684_697_698_704_706_707_707_708_709_710_713_714_715_716_716_717_717_718_719_720_723_724_725_726_726_729_729_732_734_736_738_747_750_750_762_762_765_768_769_769_770_771_774_775_782_783_783_785_788_790_794_795_795_797_798_798_799_804_805_805_805_808_813_814_814_814_815_815_820_828_828_830_830_835_843_843_848_852_852_856_856_859_861_861_865_865_868_872_875_876_876_876_880_883_884_884_884_886_887_888_889_889_891_891_894_895_896_897_897_899_899_901_901_902_907_907_910_912_912_912_913_915_915_915_916_916_918_919_923_923_925_931_931_933_935_935_941_946_951_964_973_973_978_979_980_983_986_990_993_999_1005_1005_1007_1009_1009_1018_1020_1030_1032_1038_1039_1040_1040_1044_1046_1049_1049_1049_1060_1061_1062_1063_1066_1070_1070_1072_1072_1073_1077_1077_1079_1079_1080_1082_1083_1088_1088_1088_1088_1088_1088_1097_1098_1106_1107_1112_1115_1120_1124_1127_1131_1134_1149_1149_1152_1156_1156_1159_1168_1168_1171_1175_1175_1178_1201_1205_1208_1208_1209_1211_1212_1220_1220_1220_1222_1222_1222_1235_1236_1250_1254_1256_1258_1262_1264_1270_1273_1276_1276_1283_1283_1303_1304_1306_1307_1309_1311_1313_1315_1317_1319_1322_1324_1328_1328_1328_1332_1337_1339_1342_1342_1343_1345_1345_1345_1347_1349_1352_1356_1361_1366_1375_1376_1386_1388_1394_1398_1398_1399_1403_1407_1407_1409_1412_1417_1419_1423_1425_1428_1429_1433_1433_1435_1435_1437_1437_1442_1442_1447_1447_1454_1455_1461_1462_1466_1467_1471_1473_1477_1477_1484_1484_1497_1497_1500_1500_,2003_2005_2005_2012_2012_2016_2020_2020_2020_2022_2024_2029_2029_2030_2031_2037_2037_2038_2039_2040_2041_2043_2044_2045_2048_2049_2050_2051_2052_2053_2054_2055_2057_2059_2064_2065_2068_2069_2069_2069_2072_2074_2075_2081_2083_2084_2085_2089_2090_2093_2098_2101_2102_2104_2104_2106_2108_2111_2112_2114_2114_2114_2114_2116_2116_2117_2117_2117_2117_2119_2119_2124_2124_2126_2126_2128_2128_2131_2133_2146_2149_2151_2159_2161_2161_2161_2162_2162_2162_2168_2169_2169_2175_2175_2184_2184_2186_2188_2190_2192_2193_2195_2198_2201_2205_2208_2211_2211_2211_2211_2215_2219_2219_2221_2221_2224_2231_2232_2233_2246_2246_2246_2247_2247_2249_2251_2252_2252_2253_2253_2255_2257_2258_2259_2260_2260_2260_2260_2264_2264_2266_2266_2267_2270_2272_2276_2276_2279_2279_2283_2283_2283_2283_2283_2284_2285_2286_2286_2287_2287_2288_2288_2290_2294_2305_2308_2309_2313_2314_2316_2317_2318_2318_2319_2319_2323_2335_2337_2338_2340_2340_2341_2341_2344_2347_2349_2354_2355_2359_2360_2360_2360_2360_2360_2360_2360_2360_2361_2361_2361_2361_2361_2361_2361_2361_2362_2362_2362_2365_2365_2367_2368_2369_2372_2372_2375_2375_2377_2378_2383_2383_2384_2384_2386_2387_2387_2387_2390_2391_2391_2391_2392_2392_2392_2393_2394_2398_2419_2424_2425_2426_2428_2436_2439_2439_2442_2444_2445_2445_2446_2446_2447_2450_2450_2452_2453_2453_2454_2455_2460_2461_2464_2466_2476_2483_2483_2486_2486_2490_2509_2509_2509_2510_2510_2511_2511_2513_2515_2517_2519_2521_2522_2522_2522_2523_2523_2523_2525_2526_2526_2528_2528_2529_2529_2530_2530_2531_2532_2533_2536_2536_2540_2541_2543_2544_2546_2547_2549_2549_2550_2550_2551_2557_2560_2565_2565_2569_2572_2573_2573_2576_2578_2578_2579_2585_2587_2587_2587_2589_2592_2593_2595_2596_2597_2599_2599_2600_2600_2601_2601_2607_2609_2611_2616_2616_2616_2623_2629_2629_2629_2630_2630_2631_2637_2637_2638_2638_2639_2648_2648_2651_2652_2654_2655_2659_2671_2672_2680_2698_2698_2700_2701_2703_2707_2707_2708_2708_2710_2712_2715_2716_2725_2725_2740_2740_2742_2744_2745_2746_2746_2746_2746_2746_2748_2750_2750_2753_2756_2759_2761_2761_2762_2762_2766_2771_2771_2775_2775_2779_2782_2784_2786_2787_2788_2789_2790_2791_2793_2795_2796_2796_2797_2797_2798_2799_2799_2800_2802_2803_2807_2808_2809_2809_2812_2813_2815_2816_2817_2818_2819_2824_2824_2826_2826_2827_2829_2830_2844_2846_2846_2850_2851_2851_2853_2853_2859_2861_2862_2862_2862_2864_2865_2867_2869_2869_2869_2871_2872_2873_2889_2889_2890_2890_2892_2896_2897_2897_2900_2907_2909_2909_2910_2910_2911_2911_2914_2915_2915_2916_2917_2920_2922_2923_2923_2923_2925_2928_2933_2933_2934_2934_2938_2942_2946_2949_2953_2958_2959_2967_2976_2980_2988_2989_2991_2995_2995_2996_2997_2997_2997_2998_3001_3001_3005_3006_3007_3007_3007_3013_3019_3019_3019_3025_3025_3027_3027_3029_3031_3032_3033_3036_3036_3036_3038_3039_3040_3040_3043_3044_3047_3048_3049_3049_3051_3056_3059_3059_3060_3060_3063_3063_3066_3066_3068_3068_3069_3070_3072_3074_3074_3074_3074_3076_3076_3076_3076_3079_3079_3080_3082_3083_3083_3083_3084_3087_3092_3095_3096_3098_3099_3099_3099_3101_3103_3103_3103_3104_3104_3105_3105_3111_3111_3112_3113_3115_3117_3118_3119_3124_3132_3132_3134_3138_3144_3144_3144_3149_3149_3150_3154_3155_3160_3160_3165_3170_3172_3180_3182_3183_3185_3186_3188_3191_3193_3194_3195_3196_3196_3202_3205_3213_3213_3213_3218_3218_3218_3223_3225_3227_3227_3227_3231_3231_3231_3231_3231_3231_3232_3232_3233_3236_3242_3242_3242_3243_3243_3244_3246_3252_3257_3257_3257_3259_3260_3264_3266_3267_3267_3270_3272_3273_3274_3274_3275_3276_3276_3276_3278_3278_3284_3285_3289_3289_3290_3290_3293_3296_3305_3306_3306_3308_3316_3318_3318_3319_3324_3325_3327_3327_3327_3327_3329_3329_3329_3333_3333_3340_3340_3340_3341_3341_3342_3345_3345_3347_3347_3347_3349_3349_3356_3357_3359_3360_3361_3362_3363_3367_3368_3369_3370_3371_3371_3372_3372_3373_3374_3383_3383_3383_3383_3384_3384_3384_3384_3387_3388_3388_3392_3394_3396_3398_3400_3401_3405_3405_3405_3409_3409_3410_3410_3410_3412_3412_3415_3415_3419_3423_3424_3428_3430_3431_3432_3434_3436_3443_3443_3443_3443_3445_3446_3446_3446_3446_3446_3446_3448_3448_3448_3451_3451_3453_3453_3453_3456_3456_3458_3458_3458_3459_3466_3466_3470_3471_3471_3471_3471_3472_3475_3475_3478_3478_3479_3481_3485_3488_3490_3492_3495_3497_
12,3,附件,N,2,4,6,1326_,2198_2809_3055_
12,3,認真,Vi,3,7,10,377_1498_,2005_2071_2928_3083_3345_3345_
12,3,設施,N,287,340,627,23_31_44_50_56_61_63_70_77_82_83_88_92_94_101_107_109_114_121_129_133_135_157_158_158_160_161_163_166_168_183_185_187_193_195_197_198_203_209_213_219_223_230_231_234_246_247_248_256_257_258_270_275_276_278_279_281_284_287_290_294_302_315_316_318_320_326_331_335_337_339_346_351_356_361_362_367_374_381_384_386_387_391_396_409_409_420_424_427_435_437_444_452_477_483_486_492_510_515_521_522_526_530_531_535_543_551_553_560_562_584_588_596_605_607_610_617_619_626_631_639_645_650_651_656_661_662_669_676_678_679_681_682_688_689_693_694_696_703_705_707_710_711_717_720_721_731_732_739_743_744_744_750_753_753_756_758_768_769_771_773_775_777_783_790_801_801_811_812_813_817_818_825_828_830_839_841_847_850_853_854_856_859_862_863_865_868_871_875_875_876_879_883_883_884_886_894_906_914_918_923_924_931_932_941_949_978_982_982_988_989_992_997_1000_1006_1023_1038_1045_1049_1057_1057_1058_1065_1071_1072_1073_1078_1079_1080_1081_1090_1091_1091_1092_1098_1109_1117_1141_1143_1145_1146_1149_1154_1156_1161_1181_1187_1213_1215_1218_1231_1239_1243_1247_1263_1292_1294_1298_1304_1307_1326_1327_1328_1329_1332_1336_1343_1362_1374_1377_1378_1383_1393_1399_1402_1408_1410_1413_1415_1418_1450_1458_1459_1464_1496_1499_,2014_2028_2033_2035_2036_2037_2037_2037_2042_2048_2050_2053_2058_2061_2062_2066_2068_2074_2075_2084_2085_2086_2088_2090_2094_2096_2101_2102_2107_2110_2111_2113_2122_2125_2130_2132_2138_2139_2143_2148_2149_2149_2153_2154_2154_2159_2159_2171_2186_2190_2191_2196_2219_2221_2227_2235_2236_2239_2242_2254_2256_2264_2265_2266_2275_2280_2283_2284_2289_2289_2294_2298_2301_2313_2314_2316_2317_2324_2342_2345_2350_2356_2362_2367_2367_2377_2378_2381_2384_2392_2400_2400_2402_2402_2409_2410_2412_2412_2417_2418_2418_2424_2438_2439_2440_2457_2463_2465_2469_2470_2477_2484_2490_2500_2501_2514_2515_2522_2522_2522_2525_2532_2533_2537_2538_2544_2558_2564_2568_2571_2571_2581_2585_2586_2586_2599_2613_2625_2647_2647_2647_2649_2651_2651_2652_2654_2654_2655_2656_2662_2678_2679_2681_2684_2687_2688_2691_2698_2709_2711_2714_2718_2721_2732_2742_2745_2749_2750_2759_2768_2768_2773_2786_2788_2791_2794_2799_2804_2805_2814_2814_2814_2824_2824_2824_2826_2826_2826_2827_2830_2838_2840_2840_2841_2844_2848_2850_2857_2858_2860_2860_2861_2869_2871_2872_2879_2880_2882_2885_2887_2889_2890_2893_2895_2916_2917_2917_2922_2939_2940_2941_2941_2942_2943_2945_2945_2948_2949_2950_2951_2956_2957_2972_2974_2975_2976_2978_2983_2984_2985_3004_3008_3019_3020_3030_3032_3033_3047_3049_3051_3065_3067_3078_3083_3091_3111_3115_3115_3118_3121_3122_3126_3127_3129_3130_3132_3134_3137_3138_3150_3151_3160_3162_3168_3169_3175_3176_3185_3196_3223_3225_3233_3234_3246_3246_3249_3255_3256_3258_3272_3273_3286_3287_3297_3305_3318_3319_3320_3325_3326_3331_3331_3331_3334_3345_3356_3359_3360_3360_3361_3362_3371_3387_3389_3390_3392_3394_3397_3403_3408_3433_3433_3433_3434_3435_3435_3435_3436_3446_3446_3448_3453_3454_3464_3466_3475_3485_3498_3500_
12,3,一段,N,9,11,20,275_277_695_698_903_1005_1061_1266_,2272_2547_2590_2695_2845_2933_3047_3051_3146_3254_
12,3,像,Vt,29,95,124,77_81_83_87_149_242_252_281_392_407_707_713_717_723_826_875_883_887_895_917_1154_1161_1214_1244_1248_1350_1436_1456_,2014_2038_2040_2050_2053_2058_2090_2098_2105_2124_2153_2181_2189_2198_2202_2240_2296_2335_2335_2388_2395_2404_2406_2406_2408_2408_2414_2426_2438_2440_2450_2453_2459_2479_2513_2523_2540_2571_2589_2610_2616_2713_2726_2727_2744_2750_2782_2790_2839_2840_2863_2889_2890_2915_2929_2934_2974_3038_3039_3052_3053_3055_3056_3065_3067_3078_3093_3093_3094_3095_3112_3114_3184_3223_3252_3270_3272_3289_3290_3297_3327_3327_3333_3333_3333_3336_3345_3405_3410_3415_3418_3427_3431_3432_
12,3,做,Vt,82,102,184,37_41_145_171_217_238_242_252_275_322_434_477_486_501_508_520_522_522_526_529_531_531_535_584_592_593_601_602_616_625_630_634_710_720_741_745_745_745_795_798_813_886_894_923_931_946_948_952_953_983_983_1028_1030_1032_1057_1105_1114_1124_1131_1171_1171_1178_1178_1181_1187_1257_1316_1319_1319_1321_1324_1324_1387_1429_1475_1481_1482_1488_1495_1495_1498_,2054_2072_2084_2085_2089_2116_2119_2131_2133_2149_2162_2163_2191_2195_2225_2226_2229_2239_2252_2252_2252_2253_2253_2253_2264_2284_2305_2305_2308_2308_2312_2314_2315_2317_2328_2330_2411_2417_2445_2446_2448_2451_2483_2517_2519_2609_2609_2609_2651_2654_2756_2756_2759_2769_2769_2769_2770_2770_2770_2824_2826_2835_2862_2864_2869_2892_2903_2905_2922_2933_3049_3074_3106_3112_3146_3150_3158_3158_3159_3186_3188_3253_3254_3318_3327_3333_3333_3333_3341_3351_3352_3354_3415_3418_3448_3448_3453_3453_3487_3489_3491_
12,3,工地,N,2,16,18,672_,2432_2432_2435_2435_2639_2731_2731_2883_2976_3103_3231_3341_3341_3434_3436_
12,3,忘,Vt,11,22,33,186_196_591_674_674_699_736_814_1112_1120_,2259_2294_2298_2301_2314_2317_2342_2521_2534_2640_2642_2646_2806_2956_2957_3052_3053_3231_3254_3495_3497_
12,3,需要,Vt,64,70,134,16_42_164_169_231_276_326_331_339_363_368_429_465_505_597_650_656_674_710_713_720_723_749_749_755_756_757_758_786_800_805_813_850_854_863_876_884_912_921_995_996_1013_1054_1124_1131_1195_1198_1203_1203_1205_1205_1234_1386_1399_1425_1450_1450_1465_1474_1481_1488_1491_1494_,2161_2183_2201_2220_2222_2229_2318_2319_2324_2566_2582_2609_2611_2623_2656_2656_2656_2714_2718_2718_2718_2721_2721_2721_2740_2775_2794_2862_2872_2873_2916_2988_2999_3049_3073_3074_3119_3124_3163_3163_3163_3187_3189_3232_3239_3243_3243_3243_3246_3253_3257_3272_3306_3308_3331_3333_3339_3339_3360_3431_3432_3448_3448_3451_3453_3453_3456_3488_3490_
12,3,東西,N,57,94,151,137_186_196_218_253_253_288_308_312_320_327_332_395_410_508_571_580_754_786_792_813_815_835_835_887_891_895_899_901_902_977_1025_1025_1040_1048_1058_1070_1077_1090_1130_1137_1186_1192_1211_1223_1225_1319_1319_1324_1324_1408_1413_1425_1450_1457_1457_,2047_2047_2126_2126_2139_2143_2159_2183_2193_2204_2220_2220_2222_2222_2232_2232_2241_2241_2258_2258_2259_2259_2271_2274_2294_2298_2301_2304_2305_2307_2308_2360_2361_2384_2452_2493_2497_2572_2578_2630_2671_2707_2708_2714_2724_2730_2731_2746_2746_2756_2757_2758_2784_2803_2846_2902_2904_2929_2945_2945_2954_2958_3029_3052_3053_3074_3079_3085_3103_3135_3149_3158_3161_3164_3184_3194_3210_3215_3331_3360_3386_3388_3409_3445_3458_3458_3458_3462_3462_3462_3462_3478_3478_
12,3,長,Vi,20,44,64,82_88_118_120_126_128_494_520_529_573_632_663_828_837_889_897_1032_1277_1284_,2167_2198_2249_2251_2338_2338_2360_2361_2387_2450_2453_2534_2587_2649_2667_2669_2754_2757_2758_2766_2834_2844_2919_2928_2970_2987_3040_3049_3062_3062_3099_3103_3132_3246_3246_3339_3418_3431_3431_3432_3432_3448_3453_
12,3,比較,ADV,575,256,831,17_17_35_35_36_36_37_38_39_41_44_44_44_51_52_53_57_58_62_65_68_69_69_72_75_76_76_79_79_82_82_85_85_88_88_91_91_91_92_92_94_101_104_104_104_104_104_106_109_111_117_118_119_120_124_125_126_127_128_132_145_145_145_145_145_149_160_160_161_161_166_166_175_175_176_176_176_180_184_186_186_186_186_190_194_196_196_196_196_218_223_227_227_228_229_229_231_234_234_244_247_254_257_260_260_262_262_272_273_273_275_275_280_286_287_288_291_299_318_318_320_320_335_339_345_350_355_360_375_386_388_388_392_392_396_396_397_400_400_409_411_414_418_420_422_424_432_434_434_435_437_437_439_440_444_445_447_448_449_451_452_453_455_456_457_459_462_464_466_471_475_480_484_484_489_493_493_495_498_499_500_503_504_504_507_508_516_522_522_523_526_531_531_532_535_539_539_543_544_546_546_546_546_546_546_551_553_555_555_555_555_555_555_560_562_566_570_572_575_579_581_584_584_584_584_584_585_587_588_589_589_595_600_604_609_632_642_647_648_650_653_654_656_658_660_660_661_662_662_671_674_676_676_683_687_692_696_696_696_698_710_714_720_724_727_728_730_733_739_740_741_742_742_742_742_747_747_749_749_750_753_753_754_754_756_758_765_767_768_773_777_783_783_783_784_786_786_786_788_788_789_789_800_802_804_805_805_808_813_813_815_816_818_818_818_818_819_820_820_821_822_823_828_830_830_833_834_842_844_846_850_850_853_856_859_859_859_862_865_868_868_868_870_876_878_884_888_888_888_888_892_892_896_896_896_896_900_900_904_904_906_906_906_913_913_914_915_921_921_921_923_924_924_931_932_932_943_943_955_957_957_957_957_958_958_959_966_972_972_972_972_977_981_981_985_985_986_997_1003_1006_1006_1006_1010_1010_1010_1010_1017_1024_1029_1049_1049_1050_1050_1050_1051_1053_1054_1054_1054_1057_1057_1065_1068_1075_1081_1083_1083_1088_1088_1091_1091_1092_1092_1093_1094_1106_1108_1113_1114_1114_1114_1116_1121_1130_1137_1141_1141_1143_1143_1145_1148_1151_1152_1154_1154_1158_1159_1161_1161_1164_1164_1166_1166_1168_1175_1183_1185_1185_1189_1191_1191_1195_1198_1204_1208_1211_1211_1211_1211_1213_1213_1214_1214_1216_1219_1221_1231_1234_1241_1242_1242_1242_1242_1245_1246_1246_1246_1246_1250_1251_1263_1263_1263_1264_1267_1267_1268_1277_1282_1282_1284_1289_1289_1292_1304_1304_1307_1307_1311_1315_1317_1322_1328_1331_1333_1337_1343_1346_1349_1355_1358_1358_1360_1369_1377_1378_1388_1394_1398_1399_1403_1407_1409_1418_1418_1418_1421_1423_1430_1430_1430_1437_1437_1438_1438_1450_1450_1453_1457_1465_1469_1469_1469_1470_1470_1470_1481_1488_1491_1494_1496_1496_1498_1499_,2005_2011_2011_2036_2036_2042_2048_2051_2051_2054_2054_2058_2078_2089_2098_2112_2131_2133_2136_2140_2161_2161_2162_2162_2163_2168_2177_2178_2178_2180_2180_2184_2189_2200_2206_2206_2206_2212_2227_2235_2235_2236_2236_2265_2265_2266_2268_2268_2269_2291_2291_2291_2294_2294_2299_2302_2304_2305_2307_2308_2313_2316_2318_2319_2347_2358_2377_2391_2392_2399_2399_2401_2401_2414_2445_2445_2445_2446_2446_2446_2454_2455_2458_2474_2483_2483_2484_2489_2491_2492_2492_2493_2493_2505_2509_2517_2519_2525_2525_2525_2527_2541_2544_2544_2548_2608_2608_2609_2610_2619_2620_2621_2621_2623_2651_2654_2656_2713_2714_2714_2719_2722_2735_2736_2737_2741_2752_2781_2791_2791_2795_2795_2795_2805_2805_2809_2810_2811_2815_2815_2817_2819_2822_2833_2845_2851_2864_2875_2876_2879_2880_2892_2892_2895_2918_2929_2938_2946_2948_2949_2956_2957_2960_2962_2980_2990_2992_3012_3012_3016_3022_3023_3030_3032_3032_3033_3033_3040_3040_3040_3052_3053_3065_3067_3074_3089_3091_3092_3094_3099_3104_3108_3109_3117_3119_3124_3132_3134_3148_3148_3149_3149_3177_3196_3196_3201_3201_3205_3212_3217_3223_3225_3228_3229_3237_3238_3259_3259_3272_3293_3293_3304_3308_3308_3310_3318_3326_3333_3360_3360_3360_3371_3372_3376_3378_3382_3391_3393_3398_3417_3417_3418_3418_3418_3421_3448_3450_3453_3455_3464_3464_3466_3486_3488_3490_
12,3,最,ADV,113,284,397,49_51_51_51_52_52_109_110_119_127_140_164_165_169_170_178_186_188_196_198_228_268_269_292_298_300_306_379_381_384_388_422_471_475_482_491_500_540_550_559_594_599_603_608_610_619_663_670_695_698_787_788_794_797_806_815_822_825_837_837_846_871_872_879_880_886_894_901_902_907_908_908_915_915_1005_1015_1021_1026_1030_1031_1062_1067_1074_1081_1086_1087_1088_1089_1115_1167_1168_1168_1173_1174_1175_1175_1180_1201_1211_1228_1230_1258_1267_1326_1352_1409_1433_1435_1455_1465_1491_1494_,2015_2016_2023_2042_2050_2053_2070_2074_2075_2093_2104_2114_2116_2117_2119_2124_2126_2126_2126_2126_2129_2131_2133_2146_2151_2154_2154_2162_2180_2188_2192_2193_2205_2231_2246_2258_2259_2264_2269_2284_2290_2291_2299_2302_2305_2308_2322_2339_2340_2341_2342_2344_2349_2359_2359_2359_2365_2376_2376_2403_2412_2425_2428_2436_2438_2440_2444_2450_2453_2457_2464_2466_2473_2486_2492_2498_2500_2501_2503_2508_2522_2526_2526_2528_2530_2530_2531_2532_2533_2534_2560_2561_2561_2562_2562_2565_2567_2573_2573_2573_2579_2585_2587_2594_2596_2596_2597_2597_2604_2604_2609_2611_2615_2636_2662_2671_2671_2671_2680_2680_2683_2686_2688_2702_2707_2708_2728_2729_2740_2740_2746_2746_2747_2750_2753_2754_2761_2762_2775_2777_2779_2790_2791_2804_2817_2817_2819_2819_2824_2826_2830_2838_2847_2857_2858_2861_2861_2862_2863_2869_2872_2879_2880_2889_2890_2898_2899_2916_2922_2954_2958_2967_2976_2999_3009_3010_3014_3030_3031_3037_3038_3039_3040_3056_3060_3069_3070_3071_3076_3082_3087_3110_3111_3132_3133_3140_3145_3146_3146_3150_3150_3167_3170_3172_3184_3185_3185_3196_3196_3205_3206_3206_3231_3232_3232_3233_3239_3242_3244_3246_3246_3253_3254_3260_3265_3266_3269_3275_3276_3278_3313_3319_3333_3333_3342_3345_3345_3345_3345_3347_3347_3347_3352_3354_3360_3360_3363_3364_3371_3372_3372_3375_3377_3379_3385_3386_3389_3390_3392_3394_3406_3409_3411_3418_3434_3436_3438_3446_3446_3448_3450_3451_3453_3455_3456_3458_3458_3459_3460_3471_3472_3479_3481_
12,3,打,Vt,91,132,223,38_47_50_52_112_112_145_183_186_193_196_204_210_219_223_227_227_239_248_249_258_266_269_320_364_369_394_505_522_531_545_546_555_584_630_662_677_702_728_730_730_814_819_820_835_842_887_887_887_895_895_895_902_917_955_980_1005_1064_1112_1113_1120_1121_1168_1175_1212_1212_1232_1243_1247_1266_1308_1312_1316_1319_1319_1321_1324_1324_1328_1336_1336_1348_1356_1361_1433_1435_1450_1465_1491_1494_,2037_2076_2095_2095_2095_2097_2097_2097_2101_2102_2137_2141_2159_2193_2211_2231_2231_2232_2269_2269_2270_2272_2289_2303_2306_2343_2353_2360_2360_2361_2361_2370_2372_2373_2375_2391_2394_2411_2445_2445_2446_2446_2505_2509_2527_2527_2534_2547_2561_2562_2584_2587_2606_2642_2646_2671_2690_2707_2708_2746_2747_2753_2761_2762_2771_2861_2872_2919_2923_2972_3001_3001_3001_3019_3032_3033_3035_3044_3048_3056_3074_3074_3087_3110_3129_3130_3146_3149_3150_3150_3152_3152_3159_3159_3159_3163_3163_3185_3185_3193_3195_3196_3207_3242_3244_3252_3253_3253_3253_3254_3308_3333_3333_3333_3333_3341_3341_3341_3347_3373_3374_3397_3409_3409_3413_3434_3434_3436_3436_3448_3453_
12,3,浦東,N,1,3,4,,3405_3410_
12,3,及時,ADV,34,14,48,37_51_106_213_213_226_242_245_252_255_281_342_352_512_516_546_555_639_710_720_743_948_1021_1028_1029_1070_1077_1083_1319_1324_1337_1340_1471_,2210_2225_2226_2342_2590_2714_2761_2762_3110_3226_3231_3258_3483_
12,3,收拾,Vt,10,11,21,41_639_714_724_819_1026_1430_1430_1430_,2225_2226_2867_2867_2867_2869_3266_3341_3419_3419_
12,3,6樓,N,7,6,13,41_551_560_732_1089_1472_,2754_3113_3239_3239_3338_
12,3,距離,N,21,18,39,101_185_195_272_273_277_418_677_875_883_903_924_932_1005_1049_1055_1062_1266_1337_1430_,2091_2092_2092_2146_2153_2162_2232_2232_2797_2867_2867_2909_2910_3159_3163_3306_3345_
12,3,樓層,N,69,61,130,16_82_88_102_156_242_242_246_247_252_252_256_257_260_260_262_262_291_299_342_342_352_352_482_482_491_491_514_517_517_550_559_591_714_714_724_724_794_797_811_811_870_873_878_881_922_924_924_924_924_924_930_932_932_932_932_932_1020_1095_1112_1120_1138_1290_1335_1337_1338_1481_1488_,2072_2107_2108_2108_2126_2126_2126_2126_2159_2204_2269_2384_2391_2463_2465_2540_2576_2576_2606_2606_2637_2638_2754_2769_2770_2775_2784_2817_2819_2836_2836_2862_2863_2863_2873_2914_2914_2914_2928_2964_2964_2964_3024_3024_3024_3026_3026_3026_3078_3108_3109_3111_3114_3270_3283_3289_3290_3363_3383_3384_
12,3,大道,N,4,2,6,176_804_1333_,2308_
13,3,訂,Vt,99,153,252,52_108_109_163_168_174_203_203_209_209_217_263_272_276_290_320_364_369_374_391_407_408_434_446_454_462_522_524_531_533_570_579_611_611_611_620_620_620_645_651_684_701_704_706_707_710_710_710_717_720_720_720_747_751_751_755_757_764_778_788_836_872_880_885_888_893_896_902_916_924_932_934_942_948_971_1011_1054_1057_1057_1060_1062_1073_1080_1102_1139_1150_1157_1204_1214_1252_1259_1290_1290_1353_1421_1473_1477_1484_,2006_2012_2015_2016_2024_2026_2036_2037_2038_2040_2058_2060_2061_2063_2065_2077_2081_2083_2099_2099_2103_2104_2161_2171_2186_2190_2233_2272_2283_2293_2298_2301_2312_2315_2324_2325_2338_2342_2360_2361_2365_2376_2378_2383_2391_2392_2400_2402_2405_2407_2421_2463_2463_2465_2465_2491_2516_2517_2518_2519_2527_2549_2550_2551_2566_2596_2597_2604_2606_2615_2626_2641_2645_2658_2669_2669_2703_2750_2750_2754_2754_2754_2767_2767_2767_2775_2791_2798_2800_2841_2870_2879_2879_2880_2880_2889_2890_2907_2908_2908_2919_2933_2974_2975_2983_2984_3005_3029_3032_3033_3065_3067_3071_3083_3083_3107_3132_3133_3146_3185_3205_3210_3213_3215_3218_3223_3227_3227_3227_3232_3283_3329_3329_3333_3333_3333_3363_3371_3388_3389_3390_3418_3429_3429_3434_3436_3462_3463_3463_3463_3470_3472_
13,3,同事,N,13,49,62,501_570_579_795_798_1049_1061_1102_1214_1268_1412_1417_,2029_2029_2044_2090_2174_2384_2391_2391_2391_2463_2463_2465_2465_2582_2596_2597_2629_2658_2666_2690_2690_2719_2722_2771_2799_2802_2814_2867_2924_2925_2925_2925_3076_3076_3104_3146_3146_3184_3231_3231_3231_3279_3279_3279_3282_3341_3443_3443_
13,3,他,N,38,109,147,52_82_88_94_395_470_474_544_710_714_720_724_788_886_888_894_896_902_902_902_917_935_935_944_1002_1069_1076_1089_1098_1102_1102_1148_1149_1156_1311_1315_1431_,2081_2081_2081_2083_2083_2083_2153_2178_2208_2208_2241_2309_2323_2326_2326_2354_2355_2360_2360_2361_2361_2391_2394_2458_2517_2519_2526_2526_2549_2550_2554_2554_2554_2554_2555_2555_2555_2555_2561_2562_2604_2690_2718_2721_2731_2746_2746_2746_2746_2746_2746_2754_2769_2769_2769_2769_2769_2770_2770_2770_2770_2770_2798_2800_2803_2803_2803_2803_2809_2816_2816_2818_2818_2824_2826_2835_2838_2925_2934_2958_2972_2997_3078_3083_3083_3086_3097_3115_3115_3115_3163_3184_3184_3185_3186_3186_3188_3188_3227_3231_3233_3274_3281_3347_3347_3360_3360_3360_
13,3,以下,N,4,6,10,856_865_1092_,2308_2604_2652_2655_3072_
13,3,給,Vt,173,405,578,52_89_109_115_116_119_127_139_157_163_163_168_168_173_173_178_180_186_186_186_186_188_190_196_196_196_196_213_229_235_276_280_281_281_282_290_309_313_316_316_320_320_341_341_379_434_439_449_457_460_477_481_486_515_515_516_525_534_540_548_557_593_602_628_670_674_675_701_707_707_710_710_710_714_714_714_714_717_717_720_720_720_724_724_724_724_753_771_773_775_777_784_784_793_796_813_817_819_871_871_879_879_886_886_886_894_894_894_914_915_917_924_928_932_936_944_964_976_1002_1019_1020_1020_1020_1023_1025_1028_1030_1054_1054_1054_1061_1088_1089_1091_1096_1098_1106_1106_1106_1169_1176_1212_1238_1272_1275_1311_1315_1319_1319_1324_1324_1328_1328_1340_1352_1371_1393_1402_1411_1416_1428_1431_1452_1469_1470_1472_1472_1477_1484_1497_1498_1499_,2003_2005_2015_2023_2027_2037_2037_2037_2043_2045_2061_2070_2071_2081_2083_2104_2126_2126_2126_2134_2134_2137_2141_2161_2162_2162_2163_2174_2177_2206_2206_2211_2211_2225_2226_2229_2231_2231_2232_2232_2244_2244_2245_2245_2252_2252_2252_2253_2253_2253_2260_2264_2272_2276_2284_2290_2295_2295_2312_2315_2318_2319_2338_2342_2342_2359_2360_2361_2372_2375_2376_2376_2384_2384_2390_2391_2391_2391_2392_2400_2402_2406_2406_2408_2408_2416_2416_2419_2432_2435_2445_2445_2445_2446_2446_2446_2454_2454_2454_2455_2455_2455_2459_2462_2483_2483_2483_2484_2484_2494_2494_2495_2495_2502_2502_2502_2504_2508_2509_2510_2511_2512_2516_2516_2516_2516_2518_2518_2518_2518_2527_2529_2531_2534_2536_2544_2549_2549_2549_2549_2550_2550_2550_2550_2554_2554_2555_2555_2566_2567_2567_2572_2573_2579_2579_2582_2589_2590_2598_2604_2606_2608_2611_2615_2615_2616_2616_2623_2630_2637_2638_2642_2646_2647_2647_2657_2659_2669_2669_2671_2675_2677_2690_2707_2707_2708_2708_2731_2731_2740_2747_2748_2753_2754_2754_2759_2761_2761_2761_2762_2762_2762_2767_2771_2771_2773_2775_2775_2775_2775_2775_2775_2776_2796_2803_2806_2806_2806_2809_2812_2812_2814_2816_2817_2818_2819_2822_2824_2826_2838_2840_2841_2841_2842_2842_2842_2843_2843_2843_2846_2847_2851_2861_2863_2872_2881_2881_2881_2902_2902_2902_2903_2904_2904_2904_2905_2922_2922_2934_2934_2942_2945_2945_2946_2956_2956_2956_2957_2957_2957_2967_2974_2977_2986_2999_3015_3040_3049_3049_3063_3073_3076_3083_3083_3083_3083_3084_3099_3105_3118_3129_3130_3132_3132_3142_3146_3146_3150_3150_3150_3150_3160_3160_3163_3163_3163_3184_3184_3184_3184_3184_3184_3184_3184_3187_3187_3189_3189_3194_3194_3195_3196_3196_3205_3231_3231_3232_3243_3243_3257_3257_3257_3264_3279_3282_3283_3289_3289_3289_3290_3290_3290_3291_3292_3296_3308_3311_3316_3316_3319_3319_3319_3324_3324_3324_3329_3329_3331_3345_3349_3350_3361_3362_3388_3389_3390_3415_3421_3423_3423_3424_3424_3431_3431_3432_3432_3433_3433_3433_3433_3433_3433_3435_3435_3435_3435_3435_3435_3438_3440_3442_3448_3453_3458_3458_3467_3467_3473_3477_3477_3478_3483_3487_3487_
14,3,行李,N,40,64,104,35_35_41_155_227_339_341_373_554_563_566_575_631_670_709_710_710_719_720_720_814_814_817_835_842_886_887_889_894_895_897_1082_1100_1106_1201_1201_1319_1324_1334_,2037_2057_2134_2175_2284_2388_2419_2419_2464_2464_2466_2466_2544_2544_2554_2555_2587_2594_2651_2654_2714_2718_2718_2721_2721_2725_2731_2731_2746_2806_2806_2828_2918_2933_2933_2933_2933_2946_2958_2958_2970_2988_3069_3070_3119_3124_3133_3133_3196_3205_3210_3215_3233_3233_3233_3233_3282_3282_3392_3394_3425_3463_3470_
14,3,天才,N,9,7,16,363_368_674_1272_1275_1311_1315_1430_,2229_2272_2517_2519_2791_3279_
14,3,最後,N,47,110,157,99_115_115_173_177_213_214_217_229_241_251_291_299_410_417_434_521_521_530_530_546_546_555_555_592_601_612_621_701_709_710_719_720_872_872_875_880_880_883_988_1069_1076_1114_1431_1451_1451_,2037_2047_2088_2095_2097_2104_2126_2126_2126_2128_2161_2161_2162_2163_2208_2208_2231_2231_2258_2259_2272_2273_2281_2282_2305_2308_2338_2372_2375_2387_2387_2452_2494_2495_2525_2528_2530_2554_2555_2565_2616_2642_2646_2671_2690_2690_2731_2775_2784_2798_2800_2824_2826_2837_2841_2861_2869_2889_2890_2946_2954_2980_2997_3083_3115_3115_3149_3149_3150_3159_3184_3184_3184_3185_3194_3196_3237_3255_3256_3260_3281_3288_3289_3290_3308_3319_3345_3376_3378_3386_3418_3423_3424_3433_3433_3433_3434_3435_3435_3435_3436_3458_3460_3462_3462_3463_3471_3489_3491_
14,1,素菜,N,1,0,1,,
14,3,弄丟,Vt,1,7,8,,3373_3373_3373_3374_3374_3374_
14,1,找回來,Vi,1,0,1,,
14,3,禮賓部,N,2,10,12,1099_,2126_2715_2716_3255_3255_3255_3256_3256_3256_
14,3,別人,N,7,23,30,662_814_888_896_1319_1324_,2215_2338_2460_2461_2549_2550_2571_2615_2659_2731_2746_2746_2748_2769_2770_2803_2898_2958_3072_3098_3360_3418_
14,1,領走,Vt,1,0,1,,
14,3,發現,Vt,59,154,213,37_89_176_186_196_321_326_331_379_386_407_494_546_555_610_619_630_639_662_669_710_710_711_720_720_721_783_784_802_876_884_887_888_889_889_895_896_897_897_902_912_970_978_980_1025_1061_1099_1106_1311_1315_1319_1324_1392_1401_1421_1425_1490_1493_,2012_2037_2039_2041_2065_2135_2135_2135_2139_2143_2161_2166_2183_2190_2209_2210_2228_2264_2273_2283_2283_2284_2312_2315_2318_2319_2342_2344_2349_2353_2353_2363_2378_2378_2386_2436_2457_2457_2505_2508_2510_2511_2516_2518_2525_2527_2530_2549_2549_2550_2550_2567_2600_2611_2616_2671_2680_2680_2714_2718_2721_2731_2731_2731_2731_2731_2739_2740_2740_2750_2767_2775_2776_2790_2795_2796_2806_2845_2846_2861_2861_2873_2873_2881_2888_2888_2889_2889_2890_2890_2907_2921_2923_2925_2928_2928_2946_2946_2953_2953_2976_3020_3038_3039_3040_3062_3063_3076_3083_3083_3096_3099_3146_3146_3146_3170_3170_3172_3172_3202_3207_3210_3215_3223_3227_3237_3239_3281_3289_3290_3293_3308_3308_3319_3327_3372_3386_3387_3388_3401_3446_3448_3453_3458_3470_3470_3470_3473_3473_3476_3483_3495_3497_
15,3,讓,Vt,111,311,422,51_52_78_84_89_103_113_119_119_127_127_147_155_163_163_168_168_240_242_250_252_286_320_320_321_351_361_397_410_433_434_449_457_522_531_540_540_639_639_674_707_710_714_714_714_714_716_717_720_724_724_724_724_726_736_793_796_804_842_872_880_889_897_902_917_944_964_982_990_993_1005_1028_1029_1030_1031_1045_1054_1054_1061_1062_1062_1106_1112_1112_1120_1120_1141_1143_1148_1170_1171_1177_1178_1208_1211_1211_1220_1222_1369_1387_1423_1469_1470_1472_1472_1472_1495_1495_1495_1497_,2009_2011_2015_2037_2043_2043_2045_2045_2059_2064_2081_2083_2089_2089_2095_2097_2099_2126_2126_2126_2134_2134_2164_2175_2175_2175_2175_2195_2197_2197_2205_2205_2206_2211_2211_2225_2226_2228_2229_2229_2231_2244_2245_2248_2250_2267_2273_2284_2289_2290_2298_2301_2304_2307_2320_2322_2335_2344_2349_2360_2361_2362_2370_2373_2391_2391_2395_2411_2416_2445_2445_2446_2446_2458_2463_2465_2483_2483_2483_2502_2504_2509_2513_2516_2518_2522_2527_2529_2530_2530_2531_2534_2549_2549_2550_2550_2554_2555_2572_2576_2592_2596_2596_2597_2597_2598_2608_2608_2609_2609_2611_2616_2616_2616_2647_2648_2649_2671_2680_2680_2690_2698_2702_2702_2731_2735_2736_2740_2742_2746_2751_2753_2756_2761_2762_2771_2782_2791_2791_2802_2809_2809_2809_2816_2818_2830_2835_2836_2854_2857_2857_2858_2858_2863_2863_2863_2869_2869_2871_2874_2884_2885_2886_2887_2898_2912_2914_2914_2916_2917_2917_2923_2928_2928_2928_2933_2976_3000_3001_3007_3032_3033_3037_3038_3039_3040_3047_3049_3051_3052_3053_3055_3056_3071_3071_3071_3072_3079_3079_3080_3083_3083_3083_3084_3085_3096_3098_3101_3101_3104_3107_3132_3132_3132_3133_3146_3146_3150_3150_3159_3163_3174_3175_3175_3176_3176_3193_3203_3210_3213_3215_3218_3227_3243_3243_3244_3245_3246_3246_3246_3247_3253_3254_3262_3263_3281_3281_3282_3289_3289_3289_3289_3290_3290_3290_3290_3294_3294_3294_3294_3321_3322_3333_3333_3333_3345_3345_3351_3352_3352_3354_3354_3360_3363_3383_3384_3391_3392_3393_3394_3397_3412_3415_3423_3424_3433_3433_3433_3433_3433_3433_3433_3433_3433_3435_3435_3435_3435_3435_3435_3435_3435_3435_3443_3447_3458_3460_3473_3487_3487_
15,3,感動,Vt,22,2,24,89_184_194_281_290_316_321_520_529_639_710_711_714_720_721_724_745_793_796_1062_1208_,3360_
15,3,上來,Vi,15,10,25,253_478_487_710_720_794_797_835_851_860_1164_1166_1257_1495_,2269_2269_2338_2508_2508_2659_2742_3233_3466_
15,3,處理,Vt,18,28,46,16_37_186_196_229_316_546_555_568_577_592_593_601_602_611_620_743_,2081_2083_2084_2085_2229_2252_2253_2273_2322_2691_2691_2759_2775_2914_3001_3049_3177_3186_3186_3188_3188_3223_3253_3257_3294_3448_3453_
15,3,小,Vi,330,398,728,45_51_77_83_91_92_93_94_94_94_99_101_101_101_101_113_115_122_124_130_132_153_154_160_162_163_164_167_168_169_176_176_186_186_196_196_203_203_204_204_209_209_210_210_218_218_219_239_245_245_246_247_247_249_253_255_255_256_257_257_260_262_278_320_320_338_339_341_342_351_352_361_364_369_379_389_392_395_411_415_416_424_429_433_433_434_434_434_435_467_480_480_489_489_499_499_504_519_546_546_550_555_555_559_573_610_611_617_619_620_626_628_629_630_630_630_631_648_654_660_669_670_670_672_674_687_692_701_710_710_710_710_710_711_714_720_720_720_720_720_721_724_752_754_770_773_774_777_779_783_787_787_792_794_795_797_798_804_804_805_806_813_817_819_823_824_826_831_832_835_835_839_842_842_844_844_844_845_846_846_847_847_848_849_856_865_869_870_871_871_872_874_877_878_879_879_880_882_886_887_887_888_889_889_889_889_890_892_894_895_895_896_897_897_897_897_898_900_903_910_912_915_916_917_921_921_921_934_935_942_944_951_964_970_981_988_990_993_1005_1006_1007_1009_1010_1015_1016_1020_1020_1020_1024_1026_1026_1029_1029_1030_1039_1040_1054_1057_1057_1068_1069_1070_1075_1076_1077_1087_1091_1112_1113_1120_1121_1129_1136_1155_1162_1171_1178_1183_1186_1189_1192_1197_1200_1201_1204_1208_1211_1212_1213_1214_1235_1270_1273_1282_1289_1293_1326_1333_1334_1337_1337_1343_1353_1366_1366_1375_1376_1394_1396_1403_1405_1418_1425_1427_1428_1429_1429_1431_1441_1442_1446_1447_1451_1454_1478_1481_1485_1488_1499_,2006_2010_2015_2037_2037_2050_2053_2057_2072_2072_2077_2098_2099_2114_2114_2116_2117_2117_2119_2120_2121_2122_2123_2124_2144_2145_2146_2147_2149_2151_2153_2162_2162_2164_2166_2167_2172_2172_2179_2179_2180_2180_2180_2180_2181_2186_2190_2193_2195_2198_2198_2199_2200_2232_2244_2245_2246_2252_2252_2252_2253_2253_2253_2255_2257_2261_2263_2264_2274_2274_2279_2283_2285_2286_2298_2298_2299_2301_2301_2302_2309_2318_2319_2324_2326_2326_2335_2338_2339_2345_2350_2353_2356_2362_2362_2365_2372_2375_2380_2380_2382_2384_2385_2385_2388_2388_2389_2390_2391_2399_2401_2412_2417_2417_2418_2419_2421_2432_2434_2434_2435_2438_2440_2445_2446_2454_2455_2460_2460_2461_2461_2463_2463_2465_2465_2475_2483_2490_2491_2491_2492_2492_2492_2497_2500_2501_2515_2517_2519_2525_2528_2528_2530_2541_2543_2543_2547_2549_2550_2563_2565_2571_2572_2584_2585_2586_2588_2589_2599_2600_2604_2611_2612_2621_2623_2623_2624_2631_2632_2633_2637_2638_2648_2648_2656_2680_2702_2703_2709_2709_2709_2711_2711_2711_2718_2718_2718_2721_2721_2721_2726_2727_2731_2740_2740_2740_2747_2749_2753_2753_2767_2772_2775_2776_2784_2785_2786_2788_2790_2796_2797_2804_2814_2815_2815_2815_2820_2822_2840_2840_2847_2847_2864_2866_2867_2867_2871_2874_2879_2880_2881_2881_2883_2889_2890_2908_2911_2912_2914_2917_2925_2930_2931_2939_2940_2941_2941_2946_2946_2946_2946_2953_2968_2968_2968_2971_2973_2976_2993_2994_3001_3013_3029_3029_3031_3031_3047_3051_3055_3061_3064_3064_3064_3080_3089_3100_3106_3108_3109_3110_3112_3114_3115_3117_3119_3121_3123_3124_3126_3131_3146_3149_3150_3154_3155_3158_3159_3159_3159_3159_3159_3159_3159_3160_3171_3173_3184_3184_3187_3189_3195_3211_3213_3216_3218_3222_3224_3239_3253_3253_3254_3258_3276_3282_3287_3295_3295_3297_3300_3303_3306_3307_3307_3319_3319_3319_3333_3336_3345_3345_3345_3347_3347_3347_3357_3360_3365_3372_3372_3379_3386_3402_3407_3413_3413_3414_3417_3418_3418_3418_3422_3422_3423_3423_3424_3424_3425_3433_3433_3434_3434_3435_3435_3436_3436_3446_3454_3458_3459_3460_3467_3471_3472_3475_3478_3478_3487_
15,3,道歉,Vi,3,25,28,246_256_,2195_2309_2391_2445_2445_2446_2446_2609_2616_2702_2731_2731_2746_2746_2776_2836_2840_2857_2858_2924_3289_3290_3388_3473_
15,3,還是,ADV,294,240,534,16_22_30_37_45_47_51_68_69_69_69_75_76_76_76_89_92_104_104_109_109_111_111_111_115_119_127_162_162_164_167_167_169_173_177_186_186_186_186_196_196_196_196_198_213_225_227_231_240_242_250_252_253_269_275_276_276_281_287_289_292_295_300_303_308_312_322_323_338_342_352_365_370_374_379_379_379_386_408_408_410_410_430_434_435_447_448_449_455_456_457_460_464_465_467_477_480_481_484_486_489_493_499_521_530_540_546_546_546_546_551_551_555_555_555_555_560_560_584_584_585_588_590_596_599_600_600_605_608_609_609_612_621_630_631_636_638_648_654_660_662_662_662_668_668_669_670_671_684_701_714_724_732_734_740_747_751_753_769_783_783_789_800_813_814_814_817_830_842_842_842_846_847_856_865_871_871_872_874_879_879_880_882_885_886_886_889_889_893_894_894_897_897_903_903_914_917_917_924_924_932_932_938_956_967_972_976_980_983_991_991_994_994_997_1005_1009_1011_1033_1034_1044_1045_1050_1051_1054_1055_1055_1057_1062_1082_1086_1087_1088_1089_1091_1099_1105_1106_1113_1121_1124_1125_1131_1132_1141_1143_1149_1156_1164_1166_1168_1175_1181_1181_1187_1187_1199_1203_1211_1212_1242_1246_1259_1270_1273_1311_1315_1318_1323_1327_1328_1345_1352_1352_1378_1389_1396_1398_1405_1407_1408_1413_1418_1423_1423_1428_1431_1431_1457_1461_1466_1469_1470_1472_,2013_2023_2029_2036_2039_2041_2070_2081_2081_2083_2083_2089_2099_2114_2117_2122_2128_2161_2161_2162_2171_2172_2194_2195_2195_2229_2232_2232_2232_2239_2240_2244_2244_2245_2245_2252_2253_2260_2260_2268_2269_2269_2269_2273_2273_2291_2299_2302_2309_2309_2310_2311_2312_2315_2320_2342_2347_2359_2360_2360_2360_2360_2361_2361_2361_2361_2372_2375_2387_2416_2421_2458_2477_2483_2510_2511_2516_2517_2517_2518_2519_2519_2527_2531_2534_2543_2561_2561_2562_2562_2567_2572_2578_2578_2579_2584_2589_2624_2636_2641_2642_2645_2646_2659_2707_2708_2714_2719_2719_2719_2722_2722_2722_2744_2746_2748_2775_2775_2775_2783_2798_2800_2814_2828_2861_2861_2863_2864_2879_2880_2889_2890_2892_2895_2898_2908_2917_2925_2926_2928_2933_2933_2951_2954_2954_2968_2970_2972_3004_3009_3009_3010_3010_3019_3032_3033_3037_3038_3039_3041_3049_3056_3057_3066_3068_3083_3087_3112_3117_3117_3119_3124_3137_3153_3184_3184_3186_3188_3223_3243_3253_3253_3253_3255_3255_3255_3255_3256_3256_3256_3256_3264_3270_3283_3295_3300_3303_3313_3318_3324_3327_3329_3341_3344_3360_3380_3388_3389_3390_3392_3394_3397_3397_3405_3410_3418_3418_3423_3424_3431_3431_3431_3432_3432_3432_3433_3433_3434_3435_3435_3436_3447_3448_3453_3487_3488_3489_3490_3491_
15,3,親自,ADV,10,6,16,630_711_721_738_794_797_1425_1477_1484_,2562_2902_2904_3360_3388_
15,3,錯誤,N,5,12,17,546_546_555_555_,2083_2131_2133_2174_2450_2453_2484_2757_2758_3139_3163_
15,3,副理,N,7,22,29,794_794_797_797_1471_1472_,2106_2252_2253_2287_2287_2288_2288_2388_2391_2391_2391_2450_2453_2508_2609_2609_2737_2775_2776_3463_3478_
15,3,專業,Vi,22,17,39,81_87_180_190_226_230_242_242_252_252_281_391_554_563_663_737_918_944_1224_1226_1471_,2085_2159_2159_2269_2447_2798_2800_2815_3153_3225_3254_3448_3448_3453_3453_3466_
15,3,慢,Vi,25,51,76,64_68_71_75_308_312_379_437_591_617_626_630_737_772_776_790_924_932_988_1202_1216_1239_1389_1430_,2009_2161_2162_2168_2184_2297_2300_2382_2450_2453_2484_2489_2588_2592_2667_2671_2698_2838_2844_2857_2858_2875_2947_2959_3007_3007_3029_3031_3038_3039_3099_3102_3112_3231_3293_3332_3333_3339_3357_3391_3391_3393_3393_3421_3422_3447_3460_3465_3466_3466_
15,3,速度,N,48,28,76,40_64_71_106_150_219_226_296_304_334_341_397_546_553_554_555_562_563_570_579_589_591_737_749_790_814_887_895_923_924_931_932_972_976_1083_1087_1107_1147_1237_1238_1309_1313_1335_1353_1383_1437_1454_,2438_2440_2450_2453_2484_2596_2597_2662_2698_2719_2722_2772_2830_2857_2858_2875_2898_3007_3102_3103_3112_3187_3189_3289_3290_3332_3460_
16,3,中國,N,12,15,27,16_238_242_252_281_663_710_720_1203_1500_1500_,2241_2388_2561_2562_2615_2972_2972_3001_3003_3038_3039_3253_3409_3409_
16,3,原先,ADV,5,1,6,162_167_665_814_,
16,3,請,Vt,24,95,119,16_37_37_112_119_127_213_238_238_320_546_546_546_555_555_555_641_794_797_1025_1054_1253_1423_,2011_2016_2037_2067_2081_2083_2151_2229_2252_2252_2253_2253_2258_2258_2259_2259_2284_2312_2315_2326_2359_2360_2361_2363_2382_2406_2406_2408_2408_2481_2482_2494_2495_2552_2561_2562_2566_2569_2611_2630_2674_2683_2686_2695_2695_2739_2747_2769_2769_2769_2770_2770_2770_2775_2779_2803_2828_2834_2834_2846_2857_2858_2924_2946_2972_2972_2980_2988_3003_3037_3132_3167_3170_3172_3253_3255_3256_3279_3281_3296_3319_3340_3342_3345_3345_3359_3360_3360_3414_3448_3448_3453_3453_3483_
16,1,設,Vt,3,0,3,163_168_,
16,3,忍受,Vt,4,23,27,64_71_1086_,2061_2604_2608_2608_2608_2608_2636_2651_2654_2740_2740_2802_3047_3051_3159_3170_3172_3184_3308_3333_3406_3411_
16,3,很少,ADV,11,18,29,133_253_253_391_701_1063_1091_1268_1437_1499_,2036_2037_2057_2098_2386_2626_2967_3003_3037_3097_3149_3228_3229_3293_3305_3376_3378_
16,3,放進,Vt,1,1,2,,
16,3,者,N,9,13,22,16_540_641_728_728_1023_1115_1239_,2521_2544_2548_2551_2609_2615_3003_3044_3048_3103_3488_3490_
16,3,看到,Vt,99,71,170,35_50_51_186_196_239_247_249_253_257_273_273_279_287_341_363_368_374_374_376_376_396_416_424_427_435_443_470_474_477_482_486_491_568_577_599_608_629_669_695_701_707_710_710_710_710_710_714_714_717_720_720_720_720_720_724_724_736_738_749_771_775_778_780_803_815_817_828_856_865_871_872_879_880_885_887_888_893_895_896_947_1014_1090_1169_1176_1201_1211_1211_1270_1273_1304_1307_1343_1371_1409_1429_1471_1496_,2069_2099_2110_2161_2162_2183_2206_2206_2215_2225_2226_2258_2258_2259_2259_2266_2271_2275_2290_2380_2381_2419_2454_2455_2502_2587_2609_2626_2691_2702_2745_2745_2746_2754_2806_2809_2815_2824_2826_2835_2848_2933_2933_2941_2976_3003_3038_3039_3052_3053_3184_3206_3232_3239_3254_3264_3298_3301_3352_3354_3372_3397_3415_3448_3453_3478_3488_3490_3495_3497_
16,3,抽屜,N,1,4,5,,3289_3290_3290_
16,3,成為,Vt,4,6,10,442_480_489_,2551_3003_3269_3269_3269_
16,3,服從,Vt,1,1,2,,
16,3,人口,N,1,1,2,,
16,3,再,ADV,113,312,425,41_55_60_89_96_110_116_186_196_213_242_252_266_276_276_281_316_316_338_341_374_408_409_418_425_434_554_563_573_582_583_584_589_610_611_614_619_620_623_628_630_701_707_707_711_715_717_717_721_725_736_736_736_756_758_782_786_847_872_880_885_885_886_887_888_893_893_894_895_896_910_910_919_935_935_970_976_999_1020_1058_1082_1082_1088_1088_1091_1095_1095_1098_1115_1125_1132_1139_1149_1156_1170_1177_1197_1200_1211_1232_1276_1276_1283_1283_1311_1315_1394_1403_1437_1481_1488_1498_,2011_2015_2024_2049_2052_2072_2072_2072_2081_2083_2099_2106_2108_2114_2117_2134_2147_2151_2161_2162_2162_2162_2162_2163_2163_2163_2167_2169_2175_2184_2189_2190_2192_2206_2211_2211_2215_2219_2221_2231_2244_2245_2252_2253_2269_2270_2272_2272_2279_2284_2285_2286_2287_2287_2288_2288_2289_2305_2308_2318_2318_2319_2319_2322_2324_2338_2340_2341_2360_2360_2361_2361_2392_2411_2412_2424_2425_2426_2428_2442_2445_2445_2446_2446_2454_2455_2457_2457_2464_2466_2477_2477_2478_2483_2483_2483_2483_2485_2521_2530_2540_2549_2549_2550_2550_2554_2555_2558_2561_2562_2569_2578_2582_2582_2587_2598_2598_2598_2599_2606_2606_2607_2608_2609_2621_2623_2630_2636_2637_2637_2638_2638_2648_2669_2674_2683_2686_2690_2707_2708_2724_2731_2746_2746_2746_2750_2750_2754_2754_2766_2769_2769_2769_2770_2770_2770_2773_2775_2776_2779_2782_2786_2788_2793_2799_2807_2808_2812_2822_2830_2836_2840_2841_2841_2859_2860_2861_2873_2879_2880_2883_2889_2890_2893_2900_2908_2923_2942_2968_2976_2979_2988_2998_3000_3001_3005_3013_3015_3038_3039_3040_3049_3063_3072_3074_3076_3080_3082_3101_3103_3107_3111_3113_3115_3118_3122_3127_3133_3134_3170_3170_3172_3172_3180_3184_3185_3185_3196_3201_3204_3205_3213_3218_3222_3226_3227_3227_3227_3227_3227_3232_3234_3243_3246_3246_3246_3253_3253_3253_3253_3255_3256_3264_3274_3291_3292_3293_3293_3297_3305_3306_3308_3308_3313_3325_3329_3337_3340_3347_3364_3369_3370_3372_3373_3374_3379_3383_3384_3386_3386_3388_3391_3393_3400_3412_3412_3420_3425_3426_3428_3433_3433_3434_3435_3435_3436_3440_3442_3443_3445_3452_3457_3460_3465_3470_3475_3475_3478_3485_3487_3492_
16,3,規則,N,1,4,5,,2259_3003_3133_
16,3,點,ADV,68,67,135,22_30_38_52_99_111_119_127_152_218_222_241_251_269_338_393_429_553_562_569_578_630_670_672_700_709_719_765_794_797_800_813_835_872_872_874_880_880_882_885_890_893_898_917_921_921_935_935_951_1009_1020_1034_1087_1087_1145_1269_1282_1289_1333_1359_1364_1425_1431_1450_1451_1478_1485_,2050_2053_2061_2069_2105_2127_2162_2168_2171_2231_2287_2288_2313_2316_2342_2372_2375_2393_2414_2448_2451_2477_2483_2526_2531_2531_2561_2562_2576_2615_2735_2736_2742_2754_2754_2756_2784_2829_2842_2843_2857_2858_2861_2881_2892_2908_3061_3083_3089_3175_3176_3194_3196_3231_3243_3253_3253_3254_3299_3302_3311_3397_3419_3431_3432_3471_
16,3,謝謝,Vt,18,22,40,16_91_151_337_426_428_435_641_982_982_984_1061_1170_1177_1450_1451_1451_,2305_2308_2360_2361_2432_2435_2737_2744_2753_2840_2857_2857_2858_2858_3003_3072_3072_3168_3169_3327_3345_
16,3,只,ADV,147,266,413,23_31_47_50_52_64_64_71_71_91_91_91_94_99_103_121_129_145_145_149_156_172_186_196_198_204_210_227_229_231_238_272_280_283_287_289_289_324_335_342_350_352_360_364_369_374_391_392_397_408_411_424_429_429_435_437_502_507_546_555_573_640_644_644_672_687_692_703_705_707_717_740_743_753_786_795_798_802_825_826_835_841_847_847_872_874_880_882_885_886_889_893_894_897_907_921_950_962_976_986_990_990_990_993_993_993_1006_1006_1011_1020_1029_1030_1030_1041_1049_1082_1097_1129_1136_1140_1164_1166_1195_1198_1201_1205_1212_1218_1243_1243_1247_1247_1251_1341_1367_1386_1398_1407_1425_1428_1433_1435_1441_1446_1472_1472_,2005_2012_2018_2019_2023_2037_2047_2057_2058_2059_2065_2065_2070_2072_2072_2106_2110_2110_2110_2112_2114_2117_2124_2127_2128_2136_2140_2146_2149_2162_2162_2162_2162_2167_2192_2196_2198_2219_2221_2223_2242_2252_2252_2252_2253_2253_2253_2277_2284_2298_2301_2309_2312_2315_2326_2335_2354_2355_2360_2361_2362_2371_2374_2380_2409_2410_2419_2419_2419_2419_2434_2434_2450_2452_2453_2454_2455_2464_2466_2473_2475_2475_2483_2483_2483_2494_2494_2495_2495_2502_2502_2505_2510_2511_2516_2517_2518_2519_2530_2536_2560_2566_2569_2579_2596_2597_2604_2604_2607_2613_2615_2615_2616_2621_2636_2647_2656_2662_2669_2671_2684_2687_2690_2709_2709_2711_2711_2740_2742_2746_2747_2753_2773_2786_2788_2809_2828_2828_2834_2835_2836_2846_2846_2857_2858_2872_2872_2873_2873_2884_2886_2899_2908_2915_2916_2919_2921_2929_2933_2933_2983_2984_2996_2997_2999_3003_3007_3009_3010_3019_3022_3023_3038_3038_3038_3039_3039_3039_3047_3049_3051_3052_3053_3063_3069_3069_3070_3070_3076_3076_3076_3088_3097_3098_3103_3103_3103_3103_3106_3115_3115_3118_3129_3130_3132_3133_3146_3149_3162_3181_3184_3184_3184_3194_3195_3196_3196_3202_3202_3205_3205_3232_3234_3236_3237_3246_3246_3246_3247_3262_3263_3270_3288_3288_3295_3304_3327_3327_3327_3331_3347_3350_3353_3355_3360_3364_3371_3388_3397_3397_3418_3418_3419_3434_3436_3448_3453_3458_3459_3462_3466_3470_3476_3477_3487_
16,1,煙灰缸,N,1,0,1,,
16,3,到,Vt,269,330,599,38_41_47_48_51_52_66_73_81_87_89_89_89_101_103_104_104_104_104_109_122_130_151_162_162_167_167_182_184_185_192_194_195_215_217_227_238_248_258_276_278_278_283_286_297_305_317_320_321_335_335_338_341_341_364_364_369_369_379_381_384_386_427_436_460_480_489_501_502_517_520_520_520_528_529_529_529_537_551_560_572_581_582_583_630_649_655_672_701_702_707_707_707_707_707_710_714_714_717_717_717_717_717_720_724_724_743_751_764_771_771_775_775_783_783_783_783_787_794_797_800_804_814_814_815_821_828_828_833_835_842_842_842_843_846_849_857_866_870_870_872_878_878_880_886_886_886_886_887_887_887_887_888_888_888_889_889_891_891_894_894_894_894_895_895_895_895_896_896_896_897_897_899_899_901_902_902_902_907_907_907_910_915_916_917_922_923_923_923_923_930_931_931_931_931_949_958_963_965_967_983_983_1021_1025_1025_1025_1057_1057_1061_1062_1082_1084_1084_1087_1106_1113_1115_1121_1124_1131_1139_1141_1143_1228_1230_1242_1246_1251_1259_1270_1272_1273_1275_1290_1295_1299_1308_1309_1309_1312_1313_1313_1316_1316_1319_1321_1321_1324_1339_1345_1359_1364_1386_1408_1413_1428_1430_1433_1435_1437_1443_1448_1455_1457_1459_1464_1474_1495_,2017_2023_2024_2026_2028_2037_2058_2059_2061_2066_2070_2071_2090_2103_2106_2123_2127_2136_2137_2137_2139_2140_2141_2141_2143_2155_2159_2161_2161_2162_2166_2179_2179_2180_2183_2186_2204_2206_2220_2222_2229_2229_2231_2231_2231_2231_2231_2232_2232_2232_2235_2236_2239_2244_2245_2246_2252_2252_2253_2253_2294_2309_2333_2333_2334_2334_2353_2359_2360_2360_2360_2361_2361_2361_2362_2372_2372_2375_2375_2378_2383_2384_2384_2387_2409_2410_2411_2411_2421_2426_2444_2445_2446_2457_2483_2483_2485_2486_2492_2494_2494_2495_2495_2498_2503_2506_2507_2510_2511_2514_2516_2518_2527_2530_2530_2531_2536_2537_2538_2554_2555_2565_2572_2574_2579_2585_2587_2595_2595_2603_2605_2608_2609_2609_2623_2623_2624_2629_2637_2637_2637_2638_2638_2638_2649_2659_2709_2710_2711_2712_2714_2719_2722_2723_2731_2731_2734_2739_2744_2746_2750_2754_2754_2754_2754_2769_2769_2770_2770_2773_2775_2784_2791_2802_2830_2836_2836_2865_2871_2872_2881_2881_2889_2890_2892_2902_2904_2928_2933_2934_2942_2945_2948_2953_2959_2972_2981_2982_2999_3001_3003_3004_3005_3013_3019_3034_3038_3038_3039_3039_3040_3040_3047_3049_3051_3052_3053_3056_3063_3071_3074_3074_3074_3083_3083_3084_3088_3095_3099_3100_3100_3103_3110_3112_3115_3118_3118_3119_3124_3146_3146_3150_3159_3159_3163_3163_3163_3167_3184_3185_3185_3185_3194_3195_3204_3205_3232_3239_3253_3253_3253_3254_3264_3268_3274_3274_3275_3279_3281_3281_3281_3282_3288_3289_3289_3289_3290_3290_3290_3291_3291_3291_3292_3292_3292_3293_3296_3309_3312_3333_3333_3345_3352_3354_3360_3360_3360_3364_3367_3368_3369_3370_3380_3389_3389_3390_3390_3397_3397_3401_3413_3414_3419_3419_3431_3432_3433_3433_3435_3435_3443_3443_3458_3470_3478_3478_3486_3489_3491_
16,3,無煙層,N,5,1,6,16_92_853_862_,
16,3,少,Vi,32,64,96,38_239_249_275_339_393_501_570_579_630_658_750_788_945_977_981_982_1005_1135_1139_1141_1143_1185_1191_1204_1253_1269_1384_1408_1413_1474_,2053_2101_2102_2123_2131_2133_2161_2163_2205_2232_2232_2252_2253_2314_2317_2388_2388_2450_2453_2458_2471_2509_2509_2509_2544_2671_2678_2698_2714_2797_2847_2907_2969_2996_2997_3001_3014_3015_3069_3070_3074_3078_3083_3083_3098_3111_3159_3226_3231_3237_3237_3279_3286_3289_3290_3293_3308_3331_3400_3419_3478_3478_3478_
16,3,無煙,Vi,9,13,22,16_16_16_592_593_601_602_745_,2135_2784_3003_3024_3024_3026_3026_3111_3255_3256_3383_3384_
16,3,得,ADV,17,52,69,89_390_401_599_608_630_830_916_922_930_943_980_989_992_1207_1495_,2008_2015_2036_2068_2081_2083_2126_2126_2136_2137_2140_2141_2314_2317_2328_2330_2382_2390_2432_2435_2445_2446_2534_2659_2744_2772_2862_2869_2883_2919_2922_2922_3038_3038_3039_3039_3044_3048_3052_3053_3158_3333_3360_3363_3385_3434_3434_3434_3436_3436_3436_
16,3,煙民,N,2,2,4,16_,3003_
16,3,客房,N,70,99,169,57_57_57_62_62_62_155_173_174_226_230_242_252_260_262_281_321_391_417_417_417_436_501_512_525_534_553_562_591_635_637_641_641_783_783_960_982_1007_1009_1025_1062_1100_1104_1104_1167_1168_1169_1170_1172_1172_1173_1173_1174_1175_1176_1177_1179_1179_1180_1180_1207_1208_1329_1332_1359_1364_1398_1407_1495_,2037_2039_2041_2048_2048_2079_2090_2146_2180_2180_2204_2225_2226_2258_2258_2259_2259_2291_2299_2302_2337_2342_2342_2363_2382_2389_2400_2402_2417_2510_2511_2544_2587_2608_2609_2609_2609_2624_2656_2674_2674_2680_2695_2759_2759_2767_2774_2776_2798_2800_2815_2824_2826_2881_2902_2902_2902_2904_2904_2904_2914_2919_2946_2960_2962_3012_3024_3024_3026_3026_3073_3078_3099_3139_3194_3196_3196_3223_3231_3264_3296_3316_3319_3319_3327_3345_3345_3383_3384_3431_3432_3446_3448_3448_3453_3453_3458_3483_
16,3,吸煙,Vi,8,3,11,16_710_720_784_811_811_934_,2775_3003_
16,3,多,ADV,103,147,250,36_39_39_51_68_68_75_75_91_102_103_116_145_162_162_167_167_173_227_227_235_238_245_255_274_275_280_281_290_317_334_338_395_428_494_503_546_546_546_546_555_555_555_555_610_619_658_683_709_719_753_768_783_788_801_819_844_853_862_871_872_879_880_886_894_902_964_976_983_1005_1005_1005_1006_1057_1061_1071_1073_1078_1080_1088_1089_1105_1124_1127_1131_1134_1181_1187_1211_1220_1222_1231_1239_1320_1325_1348_1409_1425_1425_1457_1481_1488_,2037_2043_2045_2047_2061_2081_2081_2083_2083_2127_2154_2154_2161_2163_2164_2186_2211_2231_2232_2241_2287_2288_2313_2314_2314_2316_2317_2317_2322_2324_2359_2360_2361_2372_2375_2388_2400_2402_2421_2426_2457_2457_2525_2540_2549_2549_2549_2550_2550_2550_2553_2565_2579_2587_2603_2605_2621_2671_2672_2698_2718_2721_2739_2742_2746_2761_2761_2761_2762_2762_2762_2841_2842_2843_2846_2846_2847_2851_2853_2869_2869_2882_2882_2883_2933_2941_2946_2949_2967_2967_2967_2975_2999_3001_3007_3007_3029_3038_3038_3038_3039_3039_3039_3071_3073_3074_3076_3095_3099_3107_3107_3132_3133_3137_3149_3159_3196_3225_3231_3242_3246_3246_3259_3313_3319_3331_3351_3385_3395_3397_3413_3413_3421_3422_3438_3443_3448_3448_3448_3453_3453_3453_3458_3463_3470_3470_
16,3,賓館,N,279,335,614,38_40_40_40_42_42_42_43_43_43_44_47_89_89_89_89_89_100_100_100_101_101_101_103_103_103_103_103_109_109_109_112_113_113_116_140_142_142_151_157_175_177_177_177_186_186_187_187_187_196_196_197_197_197_212_213_213_213_213_216_216_217_217_217_245_255_270_286_308_312_316_344_344_354_354_381_384_389_396_425_426_427_428_434_435_436_437_438_439_440_441_442_443_466_502_515_516_517_520_520_521_522_522_522_524_524_524_524_524_526_528_529_529_530_531_531_531_533_533_533_533_533_535_537_568_577_584_592_601_628_630_681_682_713_714_723_724_743_747_747_822_828_828_830_831_915_958_982_983_983_1011_1028_1028_1028_1028_1028_1029_1029_1029_1029_1029_1029_1030_1030_1030_1030_1031_1031_1032_1032_1032_1044_1050_1054_1061_1088_1092_1114_1114_1115_1115_1115_1115_1141_1141_1141_1141_1143_1143_1143_1143_1150_1157_1167_1167_1167_1168_1168_1168_1169_1170_1171_1171_1172_1173_1173_1173_1174_1174_1174_1175_1175_1175_1176_1177_1178_1178_1179_1180_1180_1180_1213_1213_1214_1224_1226_1234_1242_1242_1242_1243_1244_1246_1246_1246_1247_1248_1282_1289_1304_1307_1309_1313_1316_1319_1319_1319_1319_1320_1321_1324_1324_1324_1324_1325_1352_1355_1360_1419_1425_1431_1439_1443_1444_1448_1450_1451_1461_1462_1463_1466_1467_1468_1469_1470_1473_1490_1493_,2005_2012_2012_2012_2012_2015_2022_2025_2037_2042_2050_2053_2059_2070_2073_2079_2095_2097_2099_2099_2108_2126_2127_2131_2131_2133_2133_2134_2134_2134_2134_2149_2158_2167_2167_2167_2177_2183_2188_2193_2204_2205_2208_2208_2208_2209_2210_2211_2225_2225_2226_2226_2237_2238_2249_2251_2258_2259_2264_2264_2272_2277_2278_2279_2281_2281_2282_2282_2297_2299_2300_2302_2305_2308_2314_2314_2317_2317_2322_2342_2342_2342_2342_2342_2342_2359_2359_2360_2361_2372_2375_2377_2390_2390_2406_2408_2417_2432_2433_2435_2445_2446_2447_2467_2468_2469_2475_2479_2481_2481_2482_2482_2483_2483_2483_2483_2484_2484_2535_2561_2561_2561_2562_2562_2562_2571_2571_2571_2574_2574_2575_2582_2582_2582_2587_2589_2590_2590_2604_2604_2608_2608_2608_2608_2609_2615_2616_2623_2624_2665_2671_2672_2680_2702_2702_2737_2741_2743_2743_2744_2746_2746_2746_2746_2746_2746_2747_2753_2759_2761_2762_2764_2779_2782_2793_2793_2798_2800_2809_2809_2809_2837_2840_2847_2852_2857_2858_2862_2865_2877_2878_2879_2880_2883_2902_2904_2924_2933_2941_2942_2952_2958_2958_2965_2966_2976_2979_2987_2987_2987_2993_2994_2997_2997_3024_3026_3031_3032_3033_3034_3034_3034_3034_3035_3049_3055_3065_3067_3083_3087_3100_3100_3107_3107_3115_3115_3146_3150_3150_3156_3158_3159_3159_3160_3161_3161_3163_3168_3169_3182_3183_3196_3207_3213_3218_3226_3226_3231_3252_3252_3252_3253_3255_3256_3288_3296_3313_3313_3313_3318_3318_3318_3318_3318_3318_3319_3319_3319_3323_3325_3333_3345_3371_3383_3384_3392_3392_3394_3394_3395_3395_3397_3397_3419_3431_3432_3445_3448_3448_3448_3448_3448_3448_3448_3448_3448_3448_3448_3452_3452_3453_3453_3453_3453_3453_3453_3453_3453_3453_3453_3453_3457_3457_3459_3460_3462_3463_3463_3470_3470_3472_3483_3493_3493_
16,3,自覺,Vt,3,2,5,239_249_,3003_
16,3,希望,Vt,85,112,197,35_40_43_53_58_67_74_108_116_119_127_163_168_186_196_213_217_217_232_242_252_269_276_387_413_417_425_443_468_472_517_538_546_549_555_558_618_627_699_703_705_708_718_743_744_753_952_953_965_976_989_992_1002_1005_1019_1054_1055_1057_1069_1076_1097_1126_1133_1138_1153_1160_1197_1200_1216_1231_1319_1319_1319_1324_1324_1324_1351_1412_1417_1441_1446_1451_1490_1493_,2005_2012_2037_2048_2070_2071_2081_2083_2167_2193_2195_2231_2244_2245_2258_2259_2266_2267_2284_2305_2308_2359_2359_2372_2375_2409_2410_2417_2419_2419_2445_2445_2446_2446_2475_2510_2511_2525_2532_2533_2535_2551_2582_2589_2590_2608_2608_2608_2609_2623_2624_2659_2671_2674_2674_2680_2702_2737_2742_2750_2759_2761_2762_2773_2775_2798_2800_2814_2816_2816_2818_2818_2869_2869_2872_2872_2881_2889_2890_2915_2921_2951_2952_3009_3010_3049_3055_3072_3083_3095_3096_3146_3160_3231_3253_3258_3296_3320_3345_3345_3397_3397_3433_3435_3440_3442_3448_3452_3453_3457_3460_
16,1,加付,Vt,1,0,1,,
16,1,再接再厲,Vi,1,0,1,,
16,3,二手,A,1,1,2,,
16,3,受害者,N,1,1,2,,
16,3,高級,Vi,7,19,26,570_579_934_956_1352_1375_,2344_2349_2434_2454_2455_2707_2708_2775_2775_2841_2995_3047_3051_3069_3070_3132_3347_3396_
16,1,煙鬼,N,1,0,1,,
16,3,樓,N,66,70,136,21_29_109_109_109_113_116_155_182_182_184_184_184_184_192_192_194_194_194_194_266_281_281_309_313_334_340_392_424_481_522_522_523_524_525_526_531_531_532_533_534_535_674_703_705_771_775_783_844_888_896_904_934_982_982_1029_1082_1105_1106_1141_1143_1338_1343_1362_1438_,2075_2077_2077_2078_2093_2168_2169_2177_2178_2392_2483_2491_2517_2519_2544_2623_2629_2629_2835_2841_2862_2914_2914_2936_2937_2946_2970_2974_2976_3047_3051_3078_3146_3187_3189_3198_3200_3246_3246_3252_3252_3274_3274_3297_3297_3297_3372_3401_3422_3433_3433_3433_3433_3433_3433_3433_3433_3435_3435_3435_3435_3435_3435_3435_3435_3448_3453_3488_3490_
16,3,房價,N,39,87,126,16_48_53_58_158_163_163_168_168_272_328_333_502_610_610_618_619_619_627_630_649_649_655_655_662_663_684_786_1022_1029_1048_1081_1130_1137_1329_1351_1423_1423_,2072_2072_2089_2116_2119_2122_2161_2171_2177_2252_2253_2295_2328_2330_2342_2358_2360_2361_2372_2375_2390_2400_2402_2434_2484_2516_2518_2537_2538_2544_2558_2559_2606_2626_2717_2719_2720_2722_2767_2767_2773_2830_2839_2846_2846_2877_2878_2879_2880_2907_2956_2957_3032_3032_3033_3033_3046_3049_3049_3050_3055_3055_3099_3099_3111_3154_3154_3155_3155_3224_3262_3263_3267_3299_3299_3302_3302_3339_3345_3376_3378_3403_3408_3413_3450_3455_
16,3,豐富,Vt,55,4,59,45_52_109_159_186_196_216_245_255_259_261_291_299_325_330_392_435_437_522_523_526_528_531_532_535_537_662_676_684_708_718_802_856_859_865_868_957_987_1008_1031_1095_1129_1136_1148_1153_1160_1208_1235_1236_1359_1364_1369_1427_1471_,2438_2440_3146_
16,3,仍然,ADV,6,6,12,139_1208_1211_1383_1383_,2606_2761_2762_3003_3260_
16,3,不許,ADV,1,1,2,,
16,3,煙,N,3,6,9,103_379_,2680_2997_3003_3186_3188_
16,3,提升,Vt,12,3,15,213_614_623_901_1005_1031_1032_1170_1177_1309_1313_,2671_3253_
16,3,抽煙,Vi,1,2,3,,3003_
16,3,中國人,N,6,4,10,35_44_57_62_334_,2550_3392_3394_
16,3,評論,N,15,16,31,242_252_282_408_434_508_629_629_669_750_876_884_1211_1259_,2372_2375_2388_2432_2435_2549_2550_2745_2745_2793_2840_2908_2967_3003_3443_
16,3,電梯,N,37,92,129,150_163_163_163_168_168_168_233_308_312_379_379_481_520_529_573_573_591_837_948_957_957_982_1020_1106_1142_1144_1146_1267_1302_1305_1389_1473_1474_1490_1493_,2058_2058_2058_2058_2090_2093_2120_2121_2130_2132_2180_2206_2270_2281_2281_2282_2282_2347_2368_2369_2390_2406_2408_2414_2425_2428_2450_2453_2516_2518_2544_2572_2572_2572_2585_2589_2616_2616_2623_2623_2623_2623_2623_2629_2684_2687_2707_2708_2714_2756_2756_2807_2844_2847_2857_2858_2863_2871_2873_2918_2931_2946_2961_2963_3003_3034_3038_3039_3074_3076_3103_3103_3103_3119_3124_3141_3246_3267_3289_3289_3290_3290_3319_3325_3339_3341_3341_3388_3437_3480_3482_
16,1,外企,N,1,0,1,,
17,3,地毯,N,24,89,113,79_85_201_207_382_385_683_763_947_957_974_985_1003_1059_1085_1125_1132_1140_1217_1341_1350_1375_1376_,2037_2048_2059_2061_2108_2114_2117_2124_2126_2137_2139_2141_2143_2190_2241_2247_2264_2267_2271_2299_2302_2312_2315_2344_2344_2349_2349_2378_2380_2388_2392_2394_2425_2428_2450_2453_2454_2455_2521_2541_2541_2544_2547_2573_2584_2651_2651_2654_2654_2683_2686_2707_2708_2714_2744_2748_2753_2760_2781_2787_2789_2795_2824_2824_2826_2826_2854_2908_2909_2910_2971_3013_3022_3023_3040_3076_3104_3152_3177_3223_3242_3246_3318_3386_3391_3393_3417_3466_
17,3,太多,Vi,10,22,32,53_58_220_700_807_813_934_1107_1353_,2048_2061_2320_2769_2770_2956_2957_2993_2994_3032_3033_3098_3163_3332_3347_3347_3414_3448_3453_3458_3458_
17,3,不好,Vt,1,36,37,,2052_2057_2057_2057_2162_2162_2162_2281_2281_2282_2282_2852_2857_2857_2857_2858_2858_2858_3084_3084_3140_3140_3140_3284_3284_3284_3285_3285_3285_3433_3433_3433_3435_3435_3435_
17,1,超多,Vi,1,0,1,,
17,3,老,Vi,55,55,110,36_38_41_63_70_149_177_260_262_266_270_270_281_318_320_465_477_484_486_493_517_519_572_581_584_587_671_700_747_769_789_792_793_796_830_835_892_900_917_982_982_1038_1070_1077_1145_1146_1201_1304_1307_1359_1364_1429_1429_1473_,2089_2169_2175_2175_2219_2221_2254_2256_2265_2269_2385_2397_2541_2544_2586_2596_2597_2703_2707_2708_2714_2746_2746_2841_2851_2866_2877_2878_2885_2885_2885_2887_2887_2887_2915_2938_2941_3019_3088_3132_3198_3200_3212_3217_3365_3402_3407_3428_3433_3434_3435_3436_3462_3475_
17,3,亂,Vi,11,12,23,63_65_70_72_479_488_957_1031_1186_1192_,2119_2268_2343_2530_2573_2592_2772_3194_3365_3397_3414_
17,3,景點,N,20,16,36,51_100_106_106_296_304_480_489_582_583_670_711_721_964_983_983_1081_1231_1328_,2332_2566_2610_2703_2775_2933_2945_2945_3012_3015_3132_3319_3319_3479_3481_
17,3,火車站,N,54,34,88,17_18_63_65_65_66_68_70_72_72_73_75_89_95_239_249_325_330_363_368_545_584_584_632_641_657_676_677_820_842_957_958_963_983_1084_1092_1278_1279_1281_1282_1285_1286_1288_1289_1304_1307_1308_1312_1337_1378_1386_1436_1450_,2005_2103_2136_2137_2139_2140_2141_2143_2167_2168_2169_2268_2396_2399_2401_2484_2484_2592_2607_2656_2671_2763_2795_2851_2879_2880_2919_2949_2949_2965_2966_3088_3118_
17,3,真的,ADV,49,78,127,116_335_335_349_359_377_417_465_518_629_644_699_710_716_716_720_726_726_751_791_814_847_856_859_865_868_875_883_885_887_893_895_1062_1082_1090_1181_1187_1208_1211_1254_1350_1383_1393_1402_1477_1484_1495_1495_,2043_2045_2072_2104_2130_2132_2134_2159_2162_2162_2180_2183_2192_2199_2211_2225_2226_2252_2253_2298_2301_2313_2316_2347_2385_2395_2419_2517_2519_2596_2596_2597_2597_2601_2624_2637_2638_2714_2745_2746_2756_2775_2775_2779_2796_2809_2838_2866_2902_2903_2904_2905_2915_2934_2976_2976_3031_3031_3056_3078_3119_3119_3124_3124_3187_3189_3246_3249_3254_3274_3279_3288_3289_3290_3310_3347_3363_
17,3,怪味,N,1,9,10,,2048_2161_2395_2983_2984_2995_3289_3290_
17,3,打開,Vt,19,57,76,64_68_71_75_244_254_600_609_630_670_707_717_838_1088_1169_1176_1232_1252_,2037_2057_2069_2101_2102_2190_2190_2240_2272_2356_2425_2428_2445_2446_2447_2523_2530_2707_2708_2748_2766_2828_2863_2873_2873_2914_2923_2923_2923_2987_3101_3170_3172_3194_3213_3218_3239_3339_3353_3355_3431_3432_3433_3433_3433_3434_3435_3435_3435_3436_3443_3443_3443_3446_3446_3470_
17,3,基本,N,40,59,99,100_136_185_195_213_288_289_338_391_405_425_427_501_513_631_701_702_714_724_749_764_835_835_842_876_884_978_1005_1092_1098_1141_1143_1173_1180_1204_1250_1251_1257_1358_,2062_2179_2211_2232_2235_2236_2246_2304_2307_2332_2383_2535_2601_2616_2636_2651_2654_2714_2756_2769_2769_2770_2770_2775_2775_2791_2795_2817_2819_2829_2829_2893_2976_2981_2982_2988_3025_3027_3069_3070_3073_3073_3073_3108_3109_3132_3135_3145_3178_3231_3272_3308_3347_3360_3396_3422_3434_3436_
17,3,空氣,N,19,19,38,109_110_144_146_148_201_207_482_491_516_784_822_837_859_868_955_1238_1346_,2060_2116_2119_2244_2245_2356_2356_2363_2444_2728_2729_2732_2763_2769_2770_2946_3443_3443_
17,3,競爭力,N,13,4,17,150_163_163_168_168_517_649_655_846_959_1351_1436_,2587_3326_3430_
17,3,旁邊,N,38,44,82,65_65_72_72_159_175_228_341_374_402_507_540_649_655_677_686_691_697_740_749_782_813_815_889_897_904_947_987_1009_1019_1040_1053_1186_1192_1345_1359_1364_,2050_2053_2116_2119_2139_2143_2189_2198_2228_2231_2264_2272_2287_2288_2394_2587_2695_2731_2746_2750_2835_2847_2861_2861_2879_2880_2883_2897_2912_2926_2945_2945_2946_3040_3110_3231_3341_3341_3358_3433_3435_3448_3453_
17,1,快軌,N,1,0,1,,
17,3,日本人,N,5,8,13,51_407_1105_1107_,2549_2549_2549_2550_2550_2550_2550_
17,1,佈局,Vi,4,0,4,1018_1481_1488_,
17,3,稍,ADV,36,13,49,91_91_113_139_150_248_258_341_391_391_433_522_531_553_562_686_691_790_800_847_960_991_994_1020_1022_1023_1030_1082_1109_1117_1139_1235_1329_1378_1431_,2360_2361_2448_2451_2510_2511_2609_2834_2976_3100_3132_3232_
18,3,安靜,Vi,59,35,94,101_102_104_146_198_234_239_249_277_308_312_325_330_334_335_338_503_524_533_628_744_746_782_784_792_801_823_828_842_844_845_846_892_900_902_912_943_957_974_981_1037_1063_1071_1078_1091_1104_1106_1115_1219_1221_1234_1276_1283_1294_1298_1366_1431_1473_,2162_2175_2269_2299_2302_2344_2349_2445_2446_2509_2510_2511_2535_2671_2671_2740_2742_2861_2864_2892_2932_3031_3098_3231_3283_3293_3319_3431_3432_3433_3433_3435_3435_3454_
19,3,完全,ADV,13,51,64,281_289_424_546_555_658_662_746_912_1091_1481_1488_,2098_2153_2267_2293_2309_2354_2355_2359_2359_2388_2483_2508_2589_2631_2662_2671_2671_2671_2671_2764_2830_2841_2860_2863_2917_2945_2945_2945_2953_3012_3038_3039_3049_3063_3132_3132_3163_3223_3243_3282_3294_3294_3296_3325_3326_3339_3363_3372_3380_3458_
19,3,超值,Vi,17,2,19,181_191_295_303_432_470_474_641_913_923_931_974_1020_1101_1349_1350_,3419_
19,3,服務,Vt,200,144,344,36_38_39_40_67_74_105_135_139_148_153_157_173_177_184_186_194_196_199_200_205_206_212_217_217_242_242_247_252_252_257_264_265_266_290_318_336_338_339_339_342_343_352_353_366_371_372_382_385_396_407_409_414_420_429_434_438_464_484_493_495_500_503_510_520_522_527_528_529_531_536_537_546_548_552_554_555_557_561_563_584_607_630_630_630_630_632_643_657_659_676_679_696_704_706_708_709_715_718_719_725_748_754_759_765_768_779_782_793_794_795_796_797_798_802_819_826_830_847_871_879_889_897_905_912_924_932_948_949_956_959_982_997_1018_1021_1032_1038_1046_1054_1057_1061_1083_1084_1085_1088_1108_1113_1116_1121_1146_1154_1161_1169_1176_1186_1192_1208_1211_1211_1212_1218_1220_1222_1228_1230_1235_1239_1259_1303_1306_1309_1313_1319_1324_1331_1344_1349_1351_1378_1387_1426_1427_1438_1456_1459_1464_1476_1480_1481_1483_1487_1488_1489_1490_1492_1493_1499_1500_1500_,2005_2009_2020_2032_2034_2047_2048_2060_2062_2089_2091_2092_2098_2114_2117_2128_2153_2158_2166_2169_2175_2177_2177_2216_2229_2229_2252_2253_2289_2309_2322_2332_2345_2346_2350_2351_2356_2359_2360_2361_2371_2374_2384_2385_2390_2396_2445_2445_2446_2446_2450_2450_2453_2453_2458_2464_2466_2469_2475_2506_2507_2522_2527_2527_2531_2535_2544_2548_2565_2565_2565_2565_2571_2582_2590_2603_2605_2608_2608_2636_2671_2700_2701_2703_2754_2756_2756_2815_2827_2853_2857_2858_2866_2869_2874_2889_2890_2907_2976_2981_2982_3046_3050_3056_3069_3070_3084_3122_3127_3140_3154_3155_3166_3184_3198_3200_3207_3207_3209_3220_3221_3228_3229_3231_3243_3246_3266_3270_3284_3285_3293_3312_3334_3335_3361_3362_3431_3432_3458_3463_3467_3494_3496_
19,3,星,N,57,123,180,56_61_229_334_409_409_411_422_477_486_501_501_504_510_527_528_536_537_610_610_613_614_619_619_622_623_663_675_715_716_716_725_726_726_740_830_842_876_884_1009_1013_1048_1058_1091_1154_1161_1164_1166_1398_1398_1398_1407_1407_1407_1481_1488_,2020_2025_2033_2035_2038_2040_2043_2045_2071_2078_2084_2085_2099_2115_2118_2125_2144_2145_2194_2199_2241_2249_2249_2249_2251_2251_2251_2269_2274_2283_2328_2330_2337_2338_2360_2361_2367_2388_2421_2445_2446_2462_2483_2489_2499_2502_2506_2507_2521_2523_2523_2523_2524_2526_2537_2538_2541_2558_2574_2608_2608_2625_2637_2638_2647_2670_2719_2722_2723_2725_2780_2810_2811_2821_2836_2837_2838_2852_2874_2881_2917_2919_2944_2945_2972_3052_3053_3083_3095_3100_3112_3119_3124_3129_3129_3129_3129_3130_3130_3130_3130_3132_3132_3140_3141_3141_3150_3156_3162_3162_3162_3181_3202_3209_3238_3392_3394_3409_3418_3426_3459_3466_
20,3,地點,N,39,17,56,24_28_32_52_96_150_231_234_245_247_255_257_286_297_305_350_360_402_442_630_630_751_821_842_845_885_893_920_1266_1278_1279_1285_1286_1350_1359_1364_1392_1401_,2159_2164_2172_2299_2302_2493_2544_2717_2720_3022_3023_3170_3172_3209_3409_3471_
21,1,華東,N,2,0,2,29_,
21,3,裝修,Vt,108,86,194,23_29_31_40_40_44_100_139_175_215_235_244_254_259_261_272_281_281_281_291_293_299_301_366_371_417_418_419_422_428_433_477_486_506_527_536_538_543_687_692_707_717_754_765_787_788_793_795_796_798_814_815_819_838_838_842_875_876_883_884_910_974_1002_1020_1042_1044_1049_1057_1057_1059_1092_1139_1167_1168_1169_1170_1172_1173_1174_1175_1176_1177_1179_1180_1236_1250_1253_1254_1267_1270_1273_1280_1287_1317_1322_1335_1345_1418_1418_1469_1470_1472_1481_1488_1489_1492_1499_,2051_2054_2057_2060_2072_2177_2177_2178_2200_2201_2204_2204_2211_2225_2226_2261_2261_2263_2263_2268_2276_2305_2308_2322_2322_2322_2356_2363_2381_2388_2391_2405_2407_2412_2462_2499_2499_2526_2574_2587_2641_2645_2652_2655_2680_2680_2781_2802_2814_2847_2861_2861_2895_2913_2926_2927_2943_2952_2980_2981_2982_2993_2994_2995_3098_3120_3125_3190_3202_3205_3211_3216_3222_3224_3265_3318_3349_3363_3385_3423_3424_3448_3448_3453_3453_
21,3,富麗,Vi,2,2,4,29_,2771_
21,3,入住,Vt,399,620,1019,29_37_37_41_41_41_43_55_56_60_61_68_69_75_76_78_81_84_87_89_89_106_106_112_112_113_113_116_116_118_126_133_136_137_155_155_155_162_162_163_164_164_167_167_168_169_169_174_174_175_176_182_183_183_184_186_186_192_193_193_194_196_196_200_201_206_207_213_213_213_222_226_228_229_238_238_239_242_245_246_248_249_252_253_255_256_258_275_276_280_281_281_281_295_295_295_296_303_303_303_304_321_321_322_324_326_326_326_331_331_331_335_336_341_348_362_363_365_367_368_370_373_377_378_394_397_402_403_406_407_408_425_426_434_435_438_438_439_441_442_443_443_445_451_453_459_460_470_474_481_496_502_515_515_516_516_521_523_530_532_546_555_566_567_568_568_568_568_568_568_575_576_577_577_577_577_577_577_584_592_593_599_601_602_608_616_616_625_625_628_630_630_630_633_634_643_649_655_657_662_662_670_674_675_685_690_707_707_710_710_714_714_714_717_717_720_720_724_724_724_743_743_743_753_768_779_779_783_787_788_800_800_802_803_811_812_813_820_820_843_856_865_876_876_884_884_885_885_888_893_893_896_901_905_907_914_921_923_923_923_924_924_924_931_931_931_932_932_932_938_944_958_960_973_974_974_978_978_978_981_984_1005_1018_1019_1023_1025_1028_1029_1029_1030_1031_1032_1032_1032_1032_1038_1041_1043_1047_1050_1054_1057_1058_1062_1062_1073_1080_1081_1089_1089_1091_1091_1092_1093_1094_1095_1095_1095_1096_1114_1124_1131_1135_1138_1139_1141_1142_1143_1144_1145_1146_1150_1157_1168_1169_1175_1176_1197_1199_1200_1201_1201_1203_1204_1211_1211_1217_1218_1238_1240_1242_1246_1249_1250_1252_1255_1257_1257_1271_1274_1293_1294_1298_1309_1313_1317_1319_1322_1324_1326_1326_1337_1338_1348_1348_1349_1374_1384_1384_1384_1387_1419_1421_1425_1428_1440_1441_1445_1446_1451_1472_1480_1487_1490_1493_1495_1497_1499_,2003_2005_2005_2007_2007_2008_2008_2010_2012_2015_2015_2016_2016_2018_2033_2035_2036_2037_2037_2037_2037_2037_2037_2043_2043_2045_2045_2055_2057_2059_2059_2061_2061_2062_2065_2067_2070_2070_2071_2086_2090_2094_2095_2096_2097_2103_2108_2110_2111_2123_2126_2126_2127_2128_2134_2136_2136_2140_2140_2151_2151_2153_2153_2155_2166_2168_2177_2177_2178_2180_2183_2183_2189_2191_2193_2194_2195_2204_2204_2204_2209_2209_2209_2210_2210_2210_2229_2231_2231_2234_2239_2244_2245_2252_2252_2253_2253_2258_2258_2258_2258_2258_2259_2259_2259_2259_2259_2261_2263_2267_2269_2269_2269_2273_2280_2287_2288_2291_2295_2295_2295_2295_2295_2298_2301_2305_2308_2314_2317_2322_2324_2333_2334_2337_2338_2342_2344_2349_2359_2359_2359_2359_2360_2360_2361_2361_2363_2372_2372_2375_2375_2377_2377_2382_2386_2388_2388_2391_2394_2406_2406_2408_2408_2412_2414_2414_2417_2421_2425_2425_2428_2428_2432_2432_2434_2435_2435_2439_2445_2445_2445_2446_2446_2446_2447_2447_2450_2452_2453_2454_2454_2455_2455_2457_2462_2471_2475_2477_2477_2478_2483_2485_2492_2497_2502_2502_2508_2508_2509_2510_2511_2516_2518_2521_2527_2530_2535_2540_2544_2548_2549_2549_2550_2550_2554_2554_2554_2554_2554_2555_2555_2555_2555_2555_2559_2559_2560_2561_2561_2561_2562_2562_2562_2567_2569_2572_2575_2582_2589_2593_2594_2594_2596_2597_2603_2604_2605_2606_2606_2608_2613_2616_2616_2618_2621_2631_2641_2645_2651_2651_2651_2654_2654_2654_2666_2669_2669_2669_2671_2671_2671_2671_2671_2672_2680_2680_2683_2683_2684_2686_2686_2687_2691_2695_2702_2702_2702_2715_2716_2718_2719_2721_2722_2731_2731_2731_2731_2740_2743_2744_2744_2745_2745_2746_2746_2747_2753_2753_2754_2754_2754_2754_2756_2756_2756_2759_2766_2766_2767_2776_2787_2789_2790_2790_2802_2813_2815_2816_2817_2818_2819_2828_2835_2835_2836_2836_2836_2836_2836_2837_2837_2842_2843_2844_2846_2846_2855_2856_2860_2861_2861_2861_2861_2862_2862_2869_2869_2872_2872_2872_2872_2872_2873_2879_2880_2881_2902_2904_2914_2924_2933_2944_2946_2946_2947_2953_2956_2956_2956_2956_2957_2957_2957_2957_2958_2958_2960_2960_2962_2962_2970_2970_2970_2970_2973_2974_2976_2976_2976_2976_2980_2985_2986_2987_2998_3007_3012_3020_3024_3026_3032_3032_3033_3033_3034_3038_3038_3039_3039_3040_3041_3044_3047_3048_3049_3049_3049_3049_3049_3049_3049_3049_3049_3051_3055_3059_3062_3065_3065_3067_3067_3071_3083_3083_3083_3092_3095_3097_3097_3099_3099_3103_3105_3108_3109_3110_3113_3115_3119_3120_3124_3125_3129_3129_3130_3130_3139_3141_3142_3142_3146_3146_3146_3150_3152_3160_3165_3168_3169_3171_3173_3174_3177_3180_3181_3184_3187_3189_3190_3196_3201_3207_3210_3215_3220_3221_3223_3226_3226_3231_3231_3233_3236_3239_3239_3241_3243_3243_3243_3249_3253_3253_3253_3254_3255_3256_3260_3260_3267_3270_3271_3277_3279_3279_3279_3281_3281_3282_3288_3288_3288_3289_3290_3293_3294_3294_3294_3294_3295_3296_3296_3297_3307_3308_3308_3308_3316_3317_3319_3319_3324_3326_3341_3345_3345_3347_3347_3347_3352_3354_3360_3364_3364_3364_3364_3367_3368_3371_3371_3372_3387_3388_3388_3388_3389_3390_3397_3405_3410_3413_3413_3413_3413_3422_3423_3423_3424_3424_3426_3431_3432_3433_3433_3435_3435_3438_3438_3443_3448_3453_3454_3462_3465_3467_3470_3475_3483_3483_3493_
21,3,選擇,Vt,129,125,254,29_40_51_91_105_107_116_135_138_139_147_152_157_213_213_217_217_230_240_241_245_250_251_253_255_275_276_287_288_315_324_407_434_434_434_434_436_438_439_443_465_467_470_474_483_492_550_559_644_659_662_670_670_711_716_721_726_738_738_739_750_773_777_786_801_812_818_832_853_854_856_862_863_865_872_874_880_882_886_887_892_894_895_900_907_914_915_928_936_951_1023_1030_1031_1040_1061_1062_1064_1067_1074_1081_1081_1085_1087_1171_1172_1178_1179_1197_1200_1211_1242_1246_1251_1251_1281_1288_1292_1311_1315_1345_1369_1408_1413_1418_1427_1429_1461_1466_,2066_2104_2112_2126_2136_2140_2162_2162_2177_2177_2189_2204_2248_2250_2252_2252_2253_2253_2258_2259_2269_2287_2288_2292_2292_2309_2322_2347_2384_2385_2409_2410_2424_2426_2439_2447_2454_2455_2522_2525_2525_2568_2589_2609_2636_2659_2659_2671_2718_2721_2740_2740_2746_2749_2759_2765_2797_2807_2817_2819_2829_2840_2842_2842_2843_2843_2848_2862_2882_2906_2954_2975_3034_3037_3040_3046_3050_3065_3067_3069_3070_3083_3101_3104_3115_3119_3124_3133_3163_3187_3189_3197_3199_3201_3231_3232_3233_3243_3296_3297_3307_3313_3345_3345_3357_3364_3364_3372_3395_3419_3434_3436_3445_3480_3482_3483_3488_3489_3489_3489_3490_3491_3491_3491_
21,3,以後,N,48,101,149,29_56_61_177_186_196_213_215_229_238_244_254_284_402_434_520_529_554_563_600_609_657_707_716_717_726_814_848_875_883_901_1009_1054_1072_1073_1079_1080_1082_1139_1149_1156_1169_1176_1204_1442_1447_1451_,2104_2108_2134_2147_2151_2215_2260_2270_2283_2286_2314_2317_2323_2328_2330_2360_2360_2360_2361_2361_2361_2372_2375_2405_2407_2417_2426_2442_2483_2508_2510_2511_2515_2549_2550_2558_2569_2592_2599_2606_2615_2672_2688_2702_2707_2708_2737_2745_2746_2773_2807_2829_2836_2862_2863_2885_2887_2889_2889_2890_2890_2920_2967_2977_2995_2998_3049_3060_3076_3079_3082_3104_3111_3134_3170_3172_3185_3195_3196_3196_3201_3206_3243_3284_3285_3291_3292_3356_3369_3370_3372_3373_3374_3420_3438_3440_3442_3448_3453_3470_
21,3,西樓,N,6,2,8,29_672_674_674_674_,3454_
21,3,新,Vi,114,54,168,23_29_31_42_43_43_56_61_68_75_82_88_104_133_158_158_163_168_225_235_239_249_259_259_261_261_272_279_281_291_299_366_371_418_433_435_440_477_486_521_526_530_535_538_540_540_572_581_588_596_605_628_639_661_663_666_696_733_754_782_793_793_796_796_814_815_819_820_825_847_875_883_904_910_917_974_978_988_1003_1005_1005_1006_1020_1054_1057_1057_1060_1092_1095_1098_1149_1156_1205_1213_1249_1249_1250_1251_1251_1254_1267_1304_1307_1317_1322_1478_1479_1481_1485_1486_1488_1495_1498_,2012_2037_2051_2054_2061_2194_2204_2260_2261_2261_2261_2263_2263_2263_2360_2361_2382_2412_2447_2454_2455_2517_2519_2544_2587_2594_2621_2621_2642_2646_2761_2762_2790_2902_2904_2956_2957_2967_3040_3146_3159_3159_3171_3173_3196_3246_3318_3318_3341_3341_3391_3393_3415_
21,3,條件,N,16,51,67,29_51_93_172_328_333_335_567_576_630_678_684_968_1081_1425_,2022_2024_2027_2027_2050_2053_2077_2105_2153_2190_2202_2202_2204_2235_2236_2290_2342_2378_2442_2492_2520_2544_2626_2671_2726_2727_2765_2885_2887_2914_3047_3051_3114_3121_3126_3148_3159_3209_3310_3339_3364_3364_3389_3390_3431_3432_3480_3482_3488_3490_
21,3,大連,N,25,7,32,25_29_33_40_40_42_43_51_51_51_53_58_66_68_69_73_75_76_89_1398_1398_1399_1407_1407_,2486_2745_2956_2956_2957_2957_
22,3,區別,N,8,11,19,30_119_127_134_658_1095_1099_,2247_2623_2817_2817_2819_2819_2859_2924_3031_3086_
22,3,划算,Vi,15,5,20,30_101_297_305_789_841_841_852_861_903_1095_1398_1407_1473_,2084_2085_2264_3231_
22,3,協議,N,5,19,24,30_597_989_992_,2267_2269_2494_2495_2537_2538_2803_2852_2925_3009_3010_3074_3231_3247_3247_3255_3256_3345_
22,3,那麼,ADV,45,37,82,30_41_51_81_87_133_229_286_378_380_383_407_408_499_584_599_599_608_608_629_662_662_662_670_710_720_772_776_784_826_830_889_889_897_897_1020_1124_1131_1205_1238_1270_1273_1383_1474_,2140_2344_2349_2386_2424_2509_2526_2534_2582_2609_2611_2662_2682_2685_2797_2797_2861_3073_3132_3184_3194_3236_3274_3289_3290_3294_3331_3333_3358_3360_3433_3433_3433_3435_3435_3435_
22,3,沒,Vt,199,470,669,30_35_35_35_35_69_76_103_109_133_134_135_144_154_161_163_166_168_186_186_196_196_246_256_263_272_278_279_282_287_292_293_298_300_301_306_308_312_320_320_339_365_370_386_390_395_408_424_431_450_458_471_471_475_475_481_499_517_520_529_546_546_555_555_568_577_591_597_610_619_630_630_630_630_644_646_652_658_662_664_670_675_695_697_700_701_701_707_710_710_710_717_720_720_720_738_745_749_760_761_783_783_803_805_814_830_836_837_842_854_857_863_866_870_872_873_878_880_881_886_887_889_889_894_895_897_897_903_912_912_917_917_934_939_943_957_971_976_980_982_990_993_1001_1019_1025_1025_1037_1040_1045_1049_1057_1060_1085_1098_1100_1105_1106_1106_1106_1114_1130_1137_1202_1204_1204_1205_1212_1217_1227_1229_1232_1238_1272_1275_1348_1348_1352_1358_1366_1410_1415_1423_1423_1423_1423_1425_1425_1430_1437_1437_1438_1455_1461_1466_1473_1477_1484_1499_,2005_2007_2008_2009_2009_2012_2012_2020_2020_2025_2029_2030_2030_2031_2031_2039_2039_2041_2041_2042_2047_2061_2065_2071_2077_2086_2094_2096_2103_2104_2104_2104_2114_2114_2117_2117_2126_2127_2128_2135_2138_2144_2145_2162_2163_2171_2180_2186_2195_2199_2208_2219_2221_2225_2226_2231_2232_2232_2232_2233_2233_2247_2247_2247_2260_2260_2260_2260_2266_2269_2269_2271_2273_2273_2274_2276_2289_2289_2289_2290_2294_2304_2305_2307_2308_2309_2309_2314_2317_2318_2318_2318_2319_2319_2319_2343_2353_2360_2360_2361_2361_2365_2370_2373_2376_2390_2391_2391_2391_2391_2391_2393_2406_2408_2411_2416_2425_2426_2428_2432_2435_2436_2436_2436_2445_2445_2445_2446_2446_2446_2448_2450_2451_2453_2454_2455_2471_2476_2477_2483_2483_2483_2486_2490_2491_2502_2503_2517_2517_2517_2519_2519_2519_2523_2523_2525_2526_2526_2527_2527_2528_2528_2528_2531_2531_2531_2531_2532_2533_2534_2534_2543_2549_2549_2550_2550_2561_2562_2565_2573_2579_2582_2592_2607_2611_2611_2611_2616_2616_2630_2631_2639_2650_2651_2651_2653_2654_2654_2659_2662_2669_2680_2703_2704_2709_2711_2715_2716_2718_2719_2721_2722_2731_2731_2731_2733_2739_2742_2745_2745_2745_2753_2753_2753_2756_2756_2756_2757_2758_2767_2767_2771_2771_2775_2775_2776_2796_2797_2802_2816_2816_2816_2818_2818_2818_2829_2845_2853_2853_2859_2861_2865_2867_2867_2873_2873_2877_2878_2879_2880_2889_2889_2890_2890_2896_2897_2898_2907_2927_2932_2933_2938_2939_2939_2940_2940_2942_2942_2958_2958_2967_2968_2968_2968_2973_2986_2986_2989_2991_2995_3013_3015_3032_3033_3038_3039_3040_3043_3047_3051_3052_3053_3055_3071_3076_3086_3088_3103_3103_3103_3103_3111_3115_3115_3115_3115_3119_3124_3131_3132_3132_3132_3140_3145_3146_3146_3149_3149_3150_3168_3169_3170_3170_3170_3172_3172_3172_3174_3184_3184_3195_3197_3199_3201_3205_3205_3207_3213_3218_3223_3226_3226_3227_3227_3234_3237_3238_3246_3253_3253_3253_3253_3253_3253_3255_3255_3255_3256_3256_3256_3257_3261_3264_3264_3266_3282_3289_3289_3289_3289_3289_3289_3290_3290_3290_3290_3290_3290_3291_3291_3292_3292_3296_3306_3318_3319_3319_3319_3324_3329_3336_3338_3343_3344_3347_3347_3360_3360_3360_3360_3360_3363_3371_3371_3375_3377_3383_3384_3388_3388_3388_3388_3396_3397_3405_3409_3409_3410_3418_3418_3425_3433_3433_3433_3433_3434_3435_3435_3435_3435_3436_3437_3443_3446_3447_3447_3447_3448_3453_3458_3463_3466_3471_3471_3475_3476_3476_3476_3483_3483_3487_3487_3487_3488_3490_3495_3495_3497_3497_
22,3,香格里拉,N,13,10,23,22_23_23_30_30_31_31_35_433_572_581_597_,2754_2754_2754_2754_2754_2827_2827_3369_3370_
23,3,品種,N,51,35,86,31_36_38_39_79_85_91_91_109_150_159_183_193_245_255_259_261_274_317_334_393_501_503_506_522_531_635_637_684_733_801_859_868_982_982_1005_1006_1039_1050_1054_1054_1063_1088_1171_1178_1181_1187_1204_1211_1388_,2057_2101_2102_2123_2184_2232_2252_2253_2450_2453_2460_2461_2671_2678_2714_2893_2942_2969_2997_3014_3097_3146_3146_3225_3237_3286_3293_3305_3308_3318_3395_3400_3459_3475_
23,3,大堂,N,106,122,228,31_35_77_81_81_83_87_87_91_158_176_176_176_184_194_226_227_227_241_242_242_242_242_246_251_252_252_252_252_256_294_295_298_302_303_306_316_421_424_424_518_610_619_634_641_660_710_710_713_714_720_720_723_724_742_762_783_787_794_794_794_797_797_797_804_839_846_872_874_880_882_889_889_890_897_897_898_921_924_932_1010_1013_1020_1049_1058_1064_1088_1129_1136_1163_1165_1266_1345_1350_1383_1384_1393_1397_1402_1406_1427_1471_1472_1472_1499_,2037_2037_2038_2040_2050_2053_2055_2055_2058_2105_2106_2110_2134_2180_2181_2183_2206_2252_2253_2287_2288_2289_2309_2388_2388_2391_2413_2414_2426_2426_2450_2453_2454_2454_2455_2455_2486_2487_2488_2492_2494_2495_2497_2508_2508_2517_2519_2544_2549_2550_2553_2582_2585_2590_2606_2606_2606_2608_2608_2609_2616_2690_2730_2730_2737_2744_2746_2746_2746_2748_2775_2776_2785_2812_2824_2826_2847_2853_2854_2861_2879_2880_2919_2920_2939_2940_2944_2953_2960_2962_2983_2984_3056_3080_3108_3109_3113_3131_3177_3223_3232_3255_3255_3256_3256_3282_3318_3318_3319_3333_3345_3385_3417_3423_3424_3459_3463_3465_3468_3478_3499_
23,3,隔壁,N,19,57,76,31_35_164_165_169_170_239_249_286_596_605_971_1042_1243_1247_1366_1421_1455_,2029_2076_2077_2239_2326_2326_2445_2446_2510_2510_2510_2510_2510_2511_2511_2511_2511_2511_2541_2684_2687_2730_2740_2791_2791_2791_2803_2822_2861_2861_2861_2862_2934_2969_2996_3041_3058_3103_3141_3205_3262_3263_3278_3333_3341_3351_3351_3351_3402_3407_3428_3428_3452_3457_3471_3471_
23,3,店,N,45,55,100,31_103_108_152_245_255_316_316_316_327_332_340_342_352_388_392_417_630_662_701_701_714_714_724_724_743_749_786_815_856_865_944_962_964_964_964_982_982_982_1309_1309_1313_1313_1499_,2177_2177_2318_2319_2324_2342_2343_2359_2388_2392_2442_2445_2446_2534_2534_2595_2623_2680_2715_2716_2750_2750_2756_2809_2828_2846_2862_2862_2996_3007_3032_3033_3044_3048_3049_3071_3074_3085_3146_3146_3160_3171_3173_3203_3278_3297_3308_3327_3345_3406_3411_3478_3487_3487_
23,3,需,ADV,15,12,27,31_153_162_167_198_392_811_874_882_1025_1029_1148_1201_1367_,2623_2893_2899_3073_3115_3118_3118_3118_3146_3423_3424_
23,3,挺,ADV,116,36,152,31_45_45_51_51_65_67_72_74_100_101_102_133_162_167_228_248_248_258_258_267_272_274_289_291_299_334_334_334_334_362_367_382_385_386_407_407_410_427_435_465_467_471_475_482_491_508_566_571_575_580_584_591_659_670_677_679_769_771_775_784_792_806_811_815_835_842_843_843_845_847_885_887_887_888_888_893_895_895_896_896_939_962_978_980_980_1055_1061_1097_1147_1171_1178_1181_1187_1209_1211_1242_1246_1254_1266_1270_1273_1280_1287_1341_1353_1358_1423_1423_1428_1455_1461_1466_1474_1474_,2058_2058_2068_2078_2219_2221_2237_2238_2261_2263_2264_2487_2488_2500_2501_2730_2756_2795_2828_2861_2944_2954_2998_2998_3013_3059_3099_3131_3192_3192_3241_3304_3357_3360_3422_
23,3,東樓,N,4,7,11,31_670_674_,2446_2754_2754_2871_2871_2871_
23,3,寬敞,Vi,43,6,49,31_69_76_81_87_99_100_124_132_162_162_167_167_397_434_437_520_522_524_529_531_533_550_554_559_563_641_643_696_755_757_923_931_973_1086_1201_1242_1246_1311_1315_1481_1488_,2206_2544_2847_3454_3472_
23,3,西餐廳,N,16,8,24,31_35_157_518_610_619_714_724_1028_1108_1114_1116_1171_1178_1334_,2731_2798_2800_3175_3176_3237_3466_
23,3,相對,Vi,35,15,50,31_163_168_245_255_498_647_653_668_789_790_791_876_884_902_910_940_971_1005_1005_1029_1055_1181_1183_1186_1187_1189_1192_1211_1211_1282_1289_1399_1428_,2646_2783_2863_2892_2895_2895_2928_3031_3255_3256_3282_3293_3450_3455_
23,3,食物,N,14,8,22,31_416_549_558_610_619_1086_1087_1108_1116_1181_1187_1437_,2798_2800_2816_2818_3111_3388_3458_
23,3,方面,N,53,45,98,26_31_34_66_73_103_163_168_173_198_198_229_248_258_420_420_440_506_522_531_538_566_575_710_720_747_753_756_758_830_850_850_885_887_889_893_895_897_901_941_960_1049_1108_1114_1114_1116_1205_1259_1311_1315_1412_1417_,2037_2066_2069_2072_2246_2247_2247_2258_2259_2305_2305_2308_2308_2322_2445_2446_2483_2651_2654_2695_2719_2722_2731_2742_2759_2769_2770_2836_2845_2892_2903_2905_2922_2967_3066_3068_3084_3152_3166_3323_3329_3336_3489_3491_
24,3,舒服,Vi,105,55,160,32_35_42_52_79_79_85_85_109_119_119_127_127_162_167_181_191_227_276_281_283_297_305_308_308_308_312_312_312_322_342_351_352_361_396_397_403_407_408_422_467_499_522_531_554_563_631_657_662_663_670_698_707_710_710_716_717_720_720_726_747_751_783_795_798_799_806_826_841_846_848_874_882_885_893_922_930_946_1044_1055_1056_1091_1100_1112_1115_1120_1149_1154_1156_1161_1181_1187_1218_1242_1246_1332_1342_1346_1418_1423_1428_1469_1470_1471_,2059_2090_2090_2122_2128_2270_2318_2319_2362_2377_2439_2500_2500_2501_2501_2509_2522_2549_2550_2616_2649_2688_2753_2771_2771_2782_2784_2809_2867_2872_2888_2909_2910_2938_2954_3006_3038_3039_3064_3084_3104_3137_3207_3267_3289_3290_3321_3322_3360_3418_3433_3435_3470_3477_
24,3,便宜,Vi,62,61,123,32_35_55_60_69_76_99_103_145_150_156_328_333_476_485_499_502_610_619_645_647_651_653_684_686_691_783_786_786_790_835_843_886_886_886_889_891_894_894_894_897_899_901_902_905_907_935_948_1105_1201_1211_1213_1228_1230_1236_1320_1325_1341_1385_1421_1498_,2061_2108_2136_2140_2186_2237_2238_2246_2273_2277_2283_2290_2342_2358_2390_2390_2457_2480_2484_2525_2537_2538_2606_2648_2730_2748_2750_2868_2877_2878_2881_2893_2895_2922_3011_3013_3013_3095_3098_3099_3099_3099_3115_3202_3231_3231_3252_3262_3263_3274_3313_3347_3376_3378_3401_3422_3452_3457_3463_3467_
25,1,南山,N,2,0,2,33_,
25,3,花園,N,37,2,39,33_78_84_116_182_192_341_407_433_521_524_530_533_641_711_714_714_715_721_724_724_725_783_783_856_856_865_865_1111_1119_1342_1343_1427_1428_1440_1445_,3088_
25,3,差點,ADV,9,20,29,33_342_352_617_626_876_884_1034_,2271_2314_2317_2477_2703_2753_2773_2907_2915_2954_2968_3079_3201_3288_3356_3402_3407_3446_3446_
25,3,搞錯,Vt,4,9,13,33_222_460_,2302_2475_2604_2751_2919_2923_3085_3397_
26,3,最好,Vi,63,24,87,34_109_119_127_138_139_140_140_145_165_170_175_271_276_278_281_283_395_427_465_478_484_487_493_628_663_704_704_706_706_715_725_794_797_807_812_871_879_1040_1066_1142_1144_1169_1173_1176_1180_1186_1192_1211_1213_1242_1246_1250_1296_1297_1300_1301_1342_1386_1425_1455_1500_,2083_2151_2273_2344_2349_2476_2504_2523_2572_2650_2653_2767_2779_2813_2933_2967_3056_3327_3345_3347_3392_3394_3477_
26,3,國內,N,19,9,28,34_246_256_334_554_563_660_675_711_721_847_888_896_923_931_1164_1166_1474_,2246_2385_2454_2455_2548_3194_3423_3424_
35,3,她們,N,8,23,31,229_404_546_555_634_736_1054_,2269_2269_2269_2287_2288_2314_2317_2377_2383_2534_2746_2988_3187_3189_3225_3253_3331_3433_3433_3435_3435_3462_
35,3,差不多,Vi,20,39,59,101_114_287_381_384_422_540_747_771_775_802_803_1048_1088_1088_1089_1250_1293_1450_,2127_2144_2145_2346_2351_2360_2361_2541_2600_2627_2649_2658_2718_2721_2769_2770_2855_2856_2898_2916_2919_2938_2945_2972_3042_3107_3154_3155_3194_3213_3218_3308_3319_3392_3394_3439_3441_3443_
35,3,游泳,Vi,5,9,14,669_783_901_1049_,2519_2731_2731_2824_2826_2861_3059_3132_
35,1,奧迪,N,1,0,1,,
35,3,不同,Vi,5,15,20,904_1207_1481_1488_,2204_2204_2305_2308_2445_2446_2759_2836_2864_2964_3040_3163_3345_3458_
35,3,乘,Vt,19,8,27,35_239_249_817_842_847_847_889_889_889_889_897_897_897_897_957_1243_1247_,2154_2154_2154_2517_2519_2933_3159_
35,3,受到,Vt,4,7,11,42_482_491_,2041_2530_2769_2770_2776_3345_
35,3,開放,Vi,4,2,6,822_1106_1249_,2813_
35,3,地方,N,90,144,234,104_150_159_162_162_163_167_167_168_232_239_249_269_273_276_278_287_326_331_340_381_384_404_422_422_424_508_546_555_597_599_608_631_632_736_783_786_799_835_842_842_852_856_856_861_865_865_871_879_886_886_886_886_889_890_894_894_894_894_897_898_958_977_1011_1014_1015_1026_1026_1057_1088_1088_1088_1100_1124_1131_1139_1236_1242_1246_1259_1269_1326_1359_1364_1423_1457_1474_1481_1488_,2031_2038_2040_2089_2161_2179_2235_2236_2264_2264_2271_2309_2313_2313_2316_2316_2318_2318_2319_2319_2323_2335_2370_2373_2390_2419_2424_2436_2492_2513_2514_2522_2522_2551_2566_2625_2651_2654_2715_2716_2718_2718_2718_2718_2721_2721_2721_2721_2725_2740_2744_2759_2769_2770_2771_2775_2784_2784_2802_2812_2812_2831_2832_2835_2835_2842_2843_2869_2889_2890_2892_2915_2922_2929_2933_2945_2945_2946_2946_2953_2955_2973_2980_3013_3032_3033_3036_3047_3051_3056_3056_3059_3066_3068_3074_3074_3074_3078_3132_3138_3152_3178_3179_3182_3183_3196_3207_3207_3213_3214_3218_3219_3231_3231_3231_3246_3274_3274_3275_3281_3287_3289_3289_3290_3290_3304_3319_3333_3353_3355_3365_3376_3378_3392_3394_3397_3417_3422_3439_3441_3467_3488_3490_
35,1,各,ADV,4,0,4,468_472_902_,
35,3,一樓,N,22,29,51,44_245_255_328_333_701_707_717_1005_1018_1041_1112_1120_1147_1278_1279_1285_1286_1333_1343_1472_,2286_2444_2445_2445_2445_2446_2446_2446_2497_2497_2530_2565_2739_2750_2787_2789_2793_2813_2824_2826_2889_2890_3063_3345_3360_3360_3488_3490_
35,3,告知,Vt,29,82,111,116_184_184_186_194_194_196_339_342_352_628_707_717_738_756_758_870_878_924_932_958_990_993_1029_1112_1120_1309_1313_,2008_2023_2026_2081_2081_2083_2083_2162_2186_2229_2229_2272_2272_2291_2324_2359_2359_2391_2419_2421_2445_2446_2483_2483_2494_2494_2495_2495_2497_2498_2498_2527_2549_2549_2550_2550_2566_2594_2594_2603_2605_2606_2629_2669_2680_2732_2740_2769_2770_2836_2861_2861_2872_2873_2873_2919_2919_2933_2946_2949_2974_2974_3038_3039_3047_3051_3103_3133_3146_3232_3294_3308_3308_3332_3333_3360_3360_3360_3364_3416_3421_
35,3,估計,Vt,17,46,63,290_499_518_573_600_609_701_783_912_917_1009_1081_1139_1139_1238_1293_,2062_2065_2075_2204_2225_2226_2249_2251_2313_2316_2411_2492_2544_2544_2544_2556_2572_2608_2608_2707_2708_2756_2959_3013_3038_3039_3076_3076_3098_3098_3106_3261_3294_3294_3385_3388_3388_3433_3435_3495_3495_3495_3497_3497_3497_
35,3,打扮,N,2,3,5,917_,2162_2309_
35,3,送,Vt,113,72,185,145_145_154_162_167_186_186_186_196_196_196_211_214_215_218_237_246_256_272_373_395_437_442_514_520_524_529_533_540_568_568_572_577_577_581_669_670_674_710_714_714_720_724_724_738_739_760_780_794_797_799_803_804_813_813_852_861_872_880_888_896_921_921_948_948_959_1000_1025_1025_1057_1082_1084_1084_1084_1084_1087_1091_1091_1095_1114_1124_1131_1135_1149_1156_1182_1188_1201_1235_1237_1238_1240_1240_1266_1272_1272_1275_1275_1277_1284_1296_1300_1311_1315_1338_1343_1378_1378_1378_1451_1459_1464_,2066_2086_2086_2127_2139_2143_2162_2223_2255_2257_2272_2272_2272_2272_2309_2309_2333_2333_2334_2334_2390_2445_2446_2450_2450_2453_2453_2460_2461_2527_2528_2543_2544_2611_2625_2669_2671_2731_2731_2776_2790_2824_2826_2864_2873_2926_2926_2968_3013_3014_3038_3039_3103_3118_3119_3124_3195_3195_3231_3274_3315_3315_3360_3360_3360_3360_3397_3397_3471_3477_3492_
35,1,喝茶,Vi,1,0,1,,
35,3,裡面,N,56,89,145,38_47_107_118_126_150_161_166_201_207_278_287_288_335_481_515_521_530_615_624_713_723_767_783_786_786_815_815_816_817_842_856_865_887_887_895_895_956_1044_1052_1098_1100_1106_1250_1270_1273_1316_1316_1321_1321_1472_1473_1479_1486_1499_,2039_2041_2041_2090_2106_2116_2119_2124_2131_2133_2171_2190_2198_2220_2222_2232_2260_2270_2271_2272_2322_2335_2344_2344_2349_2349_2383_2414_2458_2517_2519_2549_2550_2587_2647_2707_2708_2730_2760_2779_2803_2812_2851_2852_2872_2881_2883_2884_2886_2898_2923_2926_2929_2945_2945_2946_2958_2958_3013_3014_3030_3038_3039_3056_3085_3099_3112_3115_3144_3161_3182_3183_3194_3195_3246_3316_3319_3333_3345_3352_3352_3354_3354_3375_3377_3389_3390_3415_
35,3,難道,ADV,7,25,32,119_127_231_1029_1383_1472_,2225_2226_2295_2372_2375_2445_2446_2516_2518_2534_2731_2746_2761_2762_2862_3001_3071_3084_3146_3333_3351_3445_3462_3470_
35,3,小費,N,12,1,13,290_554_563_871_879_886_894_917_1106_1319_1324_,
35,3,學,Vt,4,4,8,35_889_897_,2517_2519_2609_
35,3,泳池,N,8,5,13,503_669_707_717_1091_1266_1427_,2731_2776_2797_3418_
35,3,二樓,N,10,19,29,180_190_495_546_546_555_555_663_1326_,2102_2272_2445_2446_2565_2606_2606_2606_2735_2736_2787_2789_2973_3198_3200_3360_3360_3409_
35,3,搬,Vt,1,2,3,,3333_
35,3,說話,Vi,7,18,25,507_546_555_842_1112_1120_,2048_2084_2085_2296_2296_2450_2453_2740_2932_3099_3105_3227_3333_3341_3357_3409_3463_
35,3,女孩子,N,1,2,3,,3109_
35,3,想,Vt,87,179,266,35_173_186_196_212_224_231_242_242_252_252_295_303_316_320_320_323_379_388_388_388_388_390_424_505_630_630_636_638_662_669_710_710_710_710_720_720_720_720_736_736_756_758_786_835_837_851_860_886_889_894_897_906_907_915_915_958_968_990_993_1016_1020_1061_1082_1088_1099_1112_1120_1208_1211_1211_1232_1238_1318_1319_1319_1323_1324_1324_1371_1437_1450_1455_1472_1477_1484_,2005_2011_2012_2029_2057_2067_2084_2085_2095_2097_2099_2134_2159_2162_2162_2162_2163_2205_2211_2219_2221_2223_2225_2226_2232_2264_2273_2276_2283_2287_2288_2309_2309_2309_2314_2317_2372_2375_2378_2382_2394_2419_2426_2438_2440_2445_2446_2477_2483_2483_2498_2510_2511_2530_2540_2544_2549_2550_2553_2561_2562_2578_2579_2579_2606_2636_2637_2638_2639_2640_2649_2650_2653_2672_2680_2691_2698_2718_2718_2721_2721_2740_2740_2746_2750_2761_2762_2767_2771_2797_2804_2816_2818_2822_2861_2863_2864_2873_2881_2911_2915_2919_2946_2952_2964_2968_2979_2995_3000_3001_3009_3010_3031_3038_3039_3040_3052_3053_3076_3083_3083_3103_3110_3110_3146_3159_3161_3163_3195_3205_3222_3227_3227_3236_3242_3243_3246_3253_3253_3253_3253_3253_3264_3305_3324_3327_3327_3344_3345_3358_3360_3360_3360_3365_3379_3386_3388_3397_3412_3412_3416_3418_3431_3432_3433_3433_3433_3434_3434_3435_3435_3435_3436_3436_3443_3487_3493_3493_
35,3,笑容,N,6,12,18,89_405_934_1033_1099_,2508_2609_2609_2731_2782_3025_3027_3132_3361_3362_3471_
35,1,日文,N,2,0,2,1105_,
35,3,看,Vt,118,206,324,109_119_127_183_193_203_209_213_239_241_241_241_249_251_251_251_275_287_328_333_341_364_369_388_408_411_419_434_447_455_480_489_540_546_546_546_546_546_546_555_555_555_555_555_555_630_662_670_674_674_710_711_713_716_720_721_723_726_767_767_783_785_793_796_803_814_837_849_851_860_875_876_883_884_885_887_888_889_889_893_895_896_897_897_912_978_990_993_1009_1016_1019_1019_1020_1020_1020_1020_1044_1054_1057_1141_1141_1143_1143_1168_1175_1197_1200_1239_1394_1403_1421_1425_1430_1430_1437_1472_1474_,2005_2009_2012_2012_2012_2017_2019_2019_2037_2037_2038_2040_2081_2083_2090_2095_2097_2099_2124_2134_2161_2161_2162_2163_2175_2205_2240_2240_2260_2264_2264_2269_2269_2269_2272_2272_2289_2309_2318_2319_2326_2359_2360_2361_2362_2388_2392_2412_2416_2425_2428_2432_2435_2436_2450_2452_2453_2471_2494_2495_2508_2521_2525_2525_2531_2531_2541_2544_2549_2549_2550_2550_2554_2555_2571_2579_2579_2585_2587_2593_2606_2616_2642_2646_2718_2718_2721_2721_2723_2731_2733_2739_2740_2740_2744_2744_2745_2757_2758_2779_2815_2822_2839_2847_2867_2872_2888_2897_2906_2908_2915_2923_2923_2924_2932_2933_2942_2945_2946_2946_2949_2967_2976_2976_2986_2987_2988_2998_3000_3020_3025_3025_3027_3027_3040_3055_3071_3076_3076_3076_3076_3076_3076_3076_3088_3089_3103_3104_3108_3109_3110_3115_3115_3133_3142_3150_3204_3205_3213_3213_3218_3218_3222_3231_3231_3232_3233_3239_3245_3253_3253_3254_3255_3256_3257_3288_3289_3290_3321_3322_3333_3345_3356_3357_3360_3363_3367_3368_3392_3394_3397_3397_3417_3418_3431_3431_3432_3432_3433_3433_3434_3435_3435_3436_3447_
35,1,猜錯,Vt,2,0,2,35_,
35,3,下車,Vi,9,4,13,339_554_563_710_720_949_1124_1131_,3133_3204_3425_
35,1,進口,Vt,1,0,1,,
35,1,妖艷,Vi,1,0,1,,
35,1,吝嗇,Vi,2,0,2,272_,
35,1,口音,N,1,0,1,,
35,3,到達,Vt,19,44,63,35_106_174_186_196_328_333_634_780_842_887_895_901_922_930_1311_1315_1427_,2081_2083_2134_2161_2284_2284_2289_2292_2309_2324_2494_2494_2495_2495_2498_2651_2654_2719_2722_2725_2731_2734_2744_2754_2795_2873_2921_2921_2946_3103_3114_3129_3129_3130_3130_3159_3233_3433_3433_3435_3435_3489_3491_
35,3,自己,N,61,169,230,48_52_89_112_145_173_231_238_281_320_321_345_355_388_410_410_446_449_454_457_461_494_521_530_551_560_629_632_670_670_670_699_710_720_745_749_835_835_857_866_891_899_902_978_1053_1069_1076_1081_1087_1106_1114_1114_1195_1198_1211_1251_1311_1315_1332_1473_,2016_2047_2047_2059_2069_2081_2083_2099_2104_2126_2131_2133_2134_2144_2145_2162_2171_2175_2175_2175_2193_2195_2195_2205_2206_2211_2225_2225_2226_2226_2232_2234_2252_2253_2264_2272_2283_2283_2296_2298_2301_2312_2313_2315_2316_2342_2359_2360_2361_2387_2390_2391_2425_2428_2436_2459_2523_2527_2530_2531_2534_2544_2551_2566_2569_2569_2572_2587_2595_2606_2609_2609_2731_2731_2739_2740_2745_2759_2769_2769_2770_2770_2779_2816_2816_2818_2818_2823_2824_2825_2826_2842_2843_2846_2851_2861_2869_2914_2914_2917_2919_2929_2932_2946_2987_3029_3034_3074_3087_3095_3146_3146_3175_3176_3187_3189_3195_3213_3218_3231_3241_3244_3244_3246_3267_3272_3281_3289_3289_3289_3290_3290_3290_3296_3319_3319_3327_3331_3345_3360_3360_3367_3367_3368_3368_3385_3385_3414_3421_3421_3433_3433_3434_3434_3435_3435_3436_3436_3443_3445_3447_3448_3453_3466_3473_3475_3475_3487_
35,3,吃飯,Vi,52,54,106,35_69_76_91_158_163_168_344_354_374_388_388_406_512_550_559_584_679_686_691_697_701_710_720_771_775_779_790_842_849_886_890_894_898_1088_1113_1121_1228_1230_1263_1269_1278_1279_1285_1286_1328_1329_1385_1472_1472_1495_,2072_2163_2179_2211_2231_2231_2264_2272_2291_2338_2360_2361_2411_2436_2497_2509_2537_2538_2567_2604_2615_2705_2706_2784_2802_2822_2828_2835_2867_2867_2869_2923_2929_2939_2940_2975_2979_3098_3132_3149_3167_3178_3246_3253_3293_3353_3355_3433_3433_3433_3435_3435_3435_
35,1,馬自達,N,1,0,1,,
36,3,海邊,N,25,7,32,38_39_171_185_195_335_339_348_363_364_368_369_599_600_607_608_609_708_710_718_720_783_1427_1428_,2092_2861_3274_3415_3415_3422_
37,3,特意,ADV,9,6,15,103_320_695_714_724_944_978_1473_,2287_2288_2883_2933_3470_
37,3,並,ADV,23,43,66,185_195_246_256_341_391_422_434_546_555_568_577_668_710_720_803_889_897_943_1063_1319_1324_,2139_2143_2220_2220_2222_2222_2363_2406_2408_2417_2417_2498_2609_2642_2646_2651_2654_2662_2671_2754_2767_2857_2858_2873_2933_3032_3032_3033_3033_3042_3118_3205_3254_3254_3255_3256_3308_3337_3345_3364_3431_3432_
37,3,經理,N,18,91,109,212_241_242_242_242_251_252_252_252_427_477_486_634_988_1129_1136_1257_,2037_2055_2055_2081_2081_2081_2081_2083_2083_2083_2083_2095_2097_2101_2102_2229_2232_2232_2287_2287_2288_2288_2309_2312_2315_2363_2450_2453_2483_2486_2494_2495_2521_2549_2550_2553_2554_2555_2579_2582_2590_2606_2606_2608_2608_2616_2671_2675_2675_2677_2677_2680_2746_2746_2796_2879_2880_2881_2968_3038_3038_3039_3039_3049_3055_3071_3099_3099_3103_3105_3132_3177_3184_3243_3243_3257_3257_3281_3281_3281_3329_3341_3341_3349_3360_3388_3423_3423_3424_3424_
37,3,感謝,Vt,87,59,146,40_40_42_43_44_109_157_157_186_196_213_213_217_242_252_316_316_320_321_321_321_377_427_434_434_435_436_437_438_439_440_441_442_443_515_628_743_913_944_946_982_982_984_1003_1028_1028_1029_1029_1030_1031_1032_1054_1054_1061_1082_1088_1126_1133_1150_1157_1167_1168_1169_1172_1173_1174_1175_1176_1179_1180_1203_1208_1212_1309_1313_1319_1319_1319_1324_1324_1324_1431_1450_1451_1469_1470_,2037_2104_2108_2193_2258_2258_2259_2259_2305_2305_2308_2308_2322_2359_2406_2408_2417_2417_2432_2435_2445_2446_2447_2447_2575_2589_2671_2737_2746_2753_2759_2862_2902_2904_3024_3026_3049_3055_3072_3072_3146_3231_3253_3288_3345_3345_3371_3371_3431_3431_3432_3432_3448_3448_3453_3453_3483_3483_
37,3,註明,Vt,4,10,14,923_931_946_,2168_2454_2455_2671_2787_2789_2846_2919_3174_
37,3,表示,Vt,23,35,58,44_157_246_256_434_516_568_577_743_1028_1029_1030_1031_1061_1088_1091_1114_1126_1133_1319_1324_1497_,2232_2244_2244_2244_2245_2245_2245_2359_2363_2391_2391_2447_2582_2616_2731_2747_2761_2761_2762_2762_2798_2800_2882_2889_2890_2902_2904_3049_3163_3253_3308_3397_3431_3432_
37,3,注意,Vt,11,20,31,213_238_471_475_630_1155_1162_1169_1176_1343_,2069_2139_2143_2195_2509_2552_2680_2695_2695_2834_2914_2914_2972_2980_3007_3246_3266_3414_3414_
37,1,妥善,Vi,1,0,1,,
37,3,通知,Vt,12,18,30,47_377_707_717_736_872_880_1319_1319_1324_1324_,2057_2104_2104_2104_2229_2269_2273_2295_2565_2611_2731_3007_3110_3227_3281_3421_3483_
37,3,滿意,Vt,135,60,195,42_44_51_52_52_52_91_92_100_118_120_126_128_147_175_187_197_215_215_217_227_239_239_240_244_249_249_250_254_260_262_267_348_351_361_366_371_374_401_424_431_434_434_477_486_508_516_528_537_544_569_570_578_579_585_589_596_599_605_608_611_620_632_660_661_663_666_675_740_746_749_787_787_799_813_842_846_856_865_889_897_910_923_923_924_924_931_931_932_932_959_972_991_994_999_1025_1026_1029_1045_1056_1065_1067_1074_1081_1083_1101_1126_1127_1133_1134_1170_1171_1177_1178_1199_1206_1211_1214_1235_1238_1242_1246_1259_1337_1352_1369_1393_1402_1433_1435_1481_1488_1491_1494_,2005_2043_2045_2159_2161_2193_2196_2209_2210_2239_2260_2269_2322_2360_2361_2391_2395_2513_2523_2528_2530_2548_2561_2562_2582_2590_2604_2611_2621_2773_2774_2779_2791_2881_2951_2974_2976_3083_3132_3177_3205_3210_3215_3227_3231_3231_3238_3352_3354_3397_3415_3417_3450_3455_3466_3489_3491_3498_3500_
37,1,所幸,ADV,1,0,1,,
37,3,本人,N,22,53,75,37_37_37_41_41_41_41_153_342_352_521_530_1019_1089_1112_1120_1317_1322_1339_1481_1488_,2111_2252_2253_2287_2287_2287_2287_2287_2287_2288_2288_2288_2288_2288_2288_2347_2403_2417_2535_2535_2559_2566_2579_2631_2725_2739_2752_2775_2790_2864_2882_2902_2904_2958_2960_2962_2964_3037_3049_3073_3110_3253_3286_3296_3297_3340_3352_3354_3388_3388_3423_3424_
37,3,務必,ADV,2,10,12,811_,2360_2361_2361_2492_2554_2555_2683_2686_3253_
37,3,辦理,Vt,18,51,69,89_155_238_470_474_570_579_707_717_924_924_924_932_932_932_1008_1430_,2016_2016_2016_2252_2252_2253_2253_2258_2259_2284_2289_2377_2454_2455_2516_2518_2608_2669_2691_2747_2754_2754_2756_2806_2828_2835_2835_2861_2861_2861_2869_2872_2947_2949_2976_3020_3049_3049_3049_3083_3108_3109_3254_3423_3424_3433_3433_3435_3435_3499_
37,3,準備好,Vt,3,2,5,186_196_,2319_
37,3,攜程,N,138,459,597,43_47_111_111_112_112_112_115_119_121_127_129_152_163_163_163_163_168_168_168_168_183_184_186_186_186_193_194_196_196_196_201_203_207_209_238_238_276_287_316_320_320_320_320_320_320_342_352_365_370_373_373_377_377_408_431_434_434_451_459_460_460_466_481_481_481_482_491_516_546_546_555_555_568_577_630_641_674_681_682_716_726_753_753_753_766_779_779_779_813_870_878_901_901_901_912_989_989_992_992_1020_1020_1020_1054_1057_1057_1057_1057_1069_1069_1073_1076_1076_1080_1088_1124_1126_1126_1126_1131_1133_1133_1133_1212_1224_1226_1234_1293_1319_1324_1328_1348_1351_1453_1479_1486_1496_,2006_2012_2012_2012_2024_2038_2039_2040_2041_2050_2053_2065_2065_2068_2070_2073_2074_2074_2081_2083_2086_2095_2097_2104_2104_2106_2108_2108_2108_2124_2125_2134_2134_2134_2162_2162_2231_2232_2232_2237_2238_2244_2244_2244_2245_2245_2245_2252_2253_2267_2278_2279_2284_2284_2287_2288_2290_2290_2295_2295_2295_2295_2309_2309_2309_2309_2309_2309_2312_2315_2321_2322_2322_2322_2322_2322_2338_2343_2345_2350_2360_2360_2360_2361_2361_2361_2363_2364_2368_2369_2372_2372_2372_2375_2375_2375_2378_2383_2388_2390_2391_2391_2391_2394_2394_2403_2412_2412_2416_2418_2421_2421_2424_2426_2445_2446_2454_2454_2455_2455_2457_2467_2468_2476_2477_2483_2483_2483_2483_2494_2494_2494_2495_2495_2495_2504_2504_2504_2521_2521_2521_2527_2527_2531_2532_2533_2535_2535_2535_2535_2536_2551_2551_2554_2554_2554_2555_2555_2555_2561_2561_2562_2562_2564_2567_2567_2574_2582_2603_2605_2606_2609_2610_2615_2623_2630_2632_2633_2659_2659_2669_2671_2671_2680_2684_2687_2695_2714_2714_2718_2721_2731_2731_2731_2737_2739_2743_2748_2750_2750_2750_2750_2750_2750_2750_2750_2750_2753_2767_2769_2769_2770_2770_2771_2771_2771_2775_2775_2775_2776_2776_2776_2776_2776_2779_2779_2779_2782_2803_2822_2824_2824_2824_2824_2826_2826_2826_2826_2831_2832_2836_2836_2838_2838_2838_2838_2838_2847_2851_2851_2865_2869_2872_2872_2872_2879_2880_2881_2881_2881_2885_2887_2889_2890_2915_2919_2921_2921_2923_2925_2946_2949_2949_2949_2956_2957_2959_2965_2966_2968_2972_2972_2976_2979_2983_2984_2986_3009_3009_3010_3010_3011_3011_3013_3032_3032_3033_3033_3038_3038_3038_3038_3039_3039_3039_3039_3055_3059_3059_3076_3076_3076_3076_3076_3076_3083_3083_3083_3083_3083_3083_3084_3095_3095_3096_3099_3099_3103_3103_3103_3105_3105_3105_3105_3115_3115_3123_3133_3133_3140_3146_3146_3149_3159_3159_3159_3160_3165_3170_3172_3182_3183_3184_3185_3195_3196_3196_3196_3202_3204_3227_3227_3231_3232_3232_3232_3253_3258_3260_3267_3283_3283_3289_3290_3294_3296_3296_3296_3296_3308_3316_3317_3320_3327_3329_3338_3345_3345_3345_3345_3345_3357_3363_3364_3364_3371_3371_3371_3373_3373_3373_3374_3374_3374_3386_3386_3386_3388_3388_3388_3389_3389_3390_3390_3397_3421_3421_3423_3424_3431_3431_3432_3432_3433_3433_3433_3433_3433_3433_3433_3435_3435_3435_3435_3435_3435_3435_3440_3442_3443_3452_3457_3458_3458_3458_3458_3458_3459_3460_3462_3466_3466_3489_3489_3489_3491_3491_3491_
37,3,準備,Vt,14,21,35,241_251_434_710_711_720_721_749_852_861_924_932_978_,2108_2195_2445_2446_2554_2555_2759_2828_2847_2945_2958_3038_3039_3146_3281_3308_3318_3319_3431_3432_
37,3,預先,ADV,3,2,5,41_779_,2525_
37,3,已經,ADV,74,145,219,40_44_65_72_109_109_109_122_130_137_151_155_217_230_308_312_328_333_341_374_378_517_517_592_593_601_602_630_661_736_745_753_755_757_850_885_887_888_889_889_893_895_896_897_897_923_931_946_982_982_1030_1057_1082_1082_1083_1100_1139_1168_1168_1169_1175_1175_1176_1203_1211_1236_1255_1257_1270_1273_1336_1409_1450_,2037_2059_2061_2061_2062_2072_2099_2104_2134_2134_2161_2162_2177_2194_2235_2236_2272_2283_2291_2291_2318_2319_2324_2333_2334_2338_2342_2356_2378_2381_2387_2390_2392_2411_2445_2446_2447_2494_2494_2495_2495_2517_2519_2544_2554_2555_2585_2606_2608_2608_2613_2613_2623_2637_2638_2641_2645_2649_2649_2671_2671_2684_2687_2690_2690_2700_2701_2702_2707_2708_2715_2716_2718_2721_2730_2731_2744_2747_2769_2770_2773_2782_2815_2824_2826_2828_2872_2897_2946_2946_2961_2963_3013_3020_3049_3076_3076_3076_3083_3115_3119_3124_3129_3130_3146_3153_3159_3159_3170_3172_3190_3202_3220_3221_3243_3253_3254_3254_3254_3254_3281_3289_3290_3310_3329_3333_3389_3390_3392_3394_3423_3424_3433_3433_3433_3433_3435_3435_3435_3435_3470_3475_3488_3490_
37,3,訂單,N,6,20,26,174_186_196_320_674_,2071_2079_2086_2364_2690_2690_2690_2690_3146_3282_3373_3373_3373_3373_3374_3374_3374_3374_3463_
37,3,手續,N,22,49,71,52_144_184_184_194_194_280_437_437_707_714_717_724_887_895_924_924_932_932_1008_1384_,2016_2258_2259_2289_2314_2317_2333_2334_2353_2372_2375_2454_2455_2561_2562_2596_2596_2597_2597_2608_2609_2641_2645_2754_2754_2776_2790_2806_2828_2828_2828_2828_2872_2949_2970_2970_2976_3020_3049_3083_3253_3288_3295_3388_3422_3423_3424_3443_
37,1,行李架,N,4,0,4,41_41_41_,
37,1,名叫,Vt,1,0,1,,
38,3,車,N,87,89,176,47_50_89_100_145_145_155_162_167_204_210_227_239_248_249_258_320_363_364_368_369_394_522_531_546_546_555_555_584_629_630_632_644_644_662_677_702_707_707_710_717_717_720_792_793_796_814_835_835_849_851_860_886_887_889_889_889_894_895_897_897_897_942_943_949_963_980_983_983_1062_1064_1112_1113_1120_1121_1254_1308_1312_1319_1324_1343_1433_1435_1450_1491_1494_,2131_2133_2139_2143_2231_2231_2231_2231_2231_2231_2231_2231_2353_2360_2360_2361_2361_2438_2440_2505_2547_2565_2604_2604_2604_2604_2714_2748_2754_2759_2795_2812_2838_2857_2858_2881_2881_2917_2976_2993_2994_3019_3074_3103_3142_3149_3152_3159_3159_3163_3185_3214_3219_3231_3231_3231_3233_3241_3244_3253_3255_3255_3255_3255_3256_3256_3256_3256_3274_3274_3310_3318_3319_3319_3319_3319_3333_3392_3392_3392_3394_3394_3394_3405_3405_3410_3410_3447_
38,3,走路,Vi,16,14,30,219_270_630_714_724_804_835_874_882_958_1084_1140_1266_1433_1435_,2424_2786_2788_2813_2813_3074_3108_3109_3213_3218_3239_3318_3341_
38,3,開發區,N,5,7,12,44_433_686_691_,2035_2116_2119_2835_3074_3074_
38,3,起步價,N,6,1,7,820_886_894_1151_1158_,
38,3,出差,Vi,43,29,72,225_315_321_326_326_331_331_406_431_498_508_587_628_634_701_753_793_793_795_796_796_798_907_945_951_998_1040_1081_1106_1115_1152_1159_1171_1172_1178_1179_1203_1262_1412_1417_1481_1488_,2103_2167_2211_2551_2652_2655_2680_2680_2707_2708_2759_2980_3044_3048_3059_3076_3079_3099_3119_3124_3146_3193_3233_3257_3443_3443_3446_3485_
39,3,又,ADV,78,245,323,41_52_52_112_157_203_203_209_209_215_230_268_276_277_278_283_288_298_306_316_320_405_433_499_513_540_546_546_546_546_555_555_555_555_592_601_611_620_641_669_707_710_714_714_717_720_724_724_802_814_852_861_886_889_891_891_894_897_899_899_928_928_936_936_938_980_1018_1025_1025_1124_1131_1135_1237_1238_1249_1369_1425_,2037_2037_2050_2050_2053_2053_2058_2059_2059_2079_2081_2083_2095_2097_2108_2108_2112_2126_2134_2134_2161_2161_2162_2186_2186_2190_2198_2198_2198_2198_2199_2199_2209_2210_2225_2226_2244_2245_2266_2269_2272_2272_2272_2273_2279_2297_2300_2335_2335_2342_2342_2353_2360_2360_2361_2361_2372_2375_2385_2390_2390_2391_2406_2406_2406_2408_2408_2408_2419_2421_2464_2466_2483_2483_2483_2494_2495_2517_2519_2525_2531_2531_2531_2537_2537_2538_2538_2551_2564_2565_2565_2579_2582_2584_2594_2600_2606_2608_2609_2616_2616_2648_2648_2671_2671_2680_2680_2691_2691_2707_2708_2717_2720_2725_2731_2739_2739_2739_2742_2742_2742_2745_2746_2754_2757_2758_2761_2762_2766_2767_2767_2767_2796_2796_2796_2797_2798_2798_2798_2798_2798_2800_2800_2800_2800_2800_2809_2815_2841_2854_2857_2858_2861_2888_2899_2902_2904_2908_2923_2923_2928_2928_2942_2946_2946_2946_2974_2996_2998_3001_3013_3082_3083_3087_3115_3132_3137_3137_3146_3159_3159_3181_3194_3194_3205_3222_3227_3232_3233_3237_3237_3239_3239_3239_3239_3246_3253_3253_3253_3255_3256_3258_3298_3301_3304_3308_3319_3332_3333_3360_3360_3371_3375_3377_3386_3386_3386_3392_3394_3397_3402_3407_3418_3418_3419_3433_3433_3433_3433_3433_3435_3435_3435_3435_3435_3446_3452_3457_3459_3459_3470_3478_3480_3482_
40,3,反饋,Vt,73,85,158,42_43_44_109_113_116_157_186_196_213_217_316_425_426_427_428_434_435_436_437_438_439_440_441_442_443_515_516_517_568_577_592_601_628_743_982_1028_1029_1030_1031_1032_1054_1061_1070_1077_1150_1157_1167_1168_1169_1170_1171_1171_1172_1173_1174_1175_1176_1177_1178_1178_1179_1180_1309_1313_1319_1324_1450_1450_1451_1469_1470_,2005_2037_2108_2126_2177_2193_2204_2225_2226_2258_2259_2305_2308_2309_2322_2359_2360_2361_2364_2406_2408_2417_2432_2433_2435_2445_2445_2446_2446_2447_2469_2475_2534_2575_2589_2590_2608_2609_2616_2623_2624_2658_2671_2672_2702_2737_2744_2746_2747_2753_2759_2761_2762_2798_2800_2840_2857_2858_2862_2924_3024_3026_3049_3055_3146_3163_3168_3169_3231_3252_3253_3288_3296_3345_3371_3383_3384_3429_3431_3432_3448_3453_3459_3483_
40,3,大門,N,16,10,26,52_94_163_168_334_1031_1031_1141_1143_1244_1248_1356_1361_1433_1435_,2040_2232_2828_2907_2976_3083_3246_3304_3319_
40,3,好像,ADV,65,100,165,52_133_142_142_155_162_162_167_167_175_272_273_275_287_287_316_334_379_424_521_530_538_546_555_565_574_591_594_603_677_713_723_771_775_778_795_798_818_888_896_901_935_935_1010_1015_1034_1034_1045_1049_1069_1073_1076_1080_1092_1106_1112_1120_1269_1317_1322_1350_1352_1425_1430_,2015_2022_2036_2090_2098_2108_2139_2143_2161_2169_2201_2201_2252_2253_2281_2282_2312_2314_2315_2317_2383_2411_2418_2460_2461_2471_2483_2487_2488_2499_2510_2510_2511_2511_2522_2523_2544_2566_2608_2616_2616_2649_2652_2655_2688_2690_2724_2769_2769_2770_2770_2793_2803_2838_2838_2862_2863_2867_2968_2997_3032_3033_3047_3051_3103_3120_3125_3152_3168_3169_3184_3195_3223_3236_3245_3252_3277_3289_3290_3324_3353_3355_3361_3362_3392_3394_3403_3408_3418_3419_3433_3435_3443_3466_3479_3481_3485_3495_3497_
40,3,工作,N,53,80,133,52_64_71_138_139_273_273_288_316_336_377_377_377_386_410_436_437_437_439_442_443_551_560_628_628_628_663_707_710_717_720_733_819_960_982_990_993_1007_1028_1029_1030_1030_1031_1057_1057_1135_1151_1158_1212_1250_1423_1451_,2057_2258_2258_2259_2259_2273_2273_2294_2309_2312_2315_2359_2498_2510_2511_2530_2587_2608_2608_2609_2609_2651_2654_2671_2671_2671_2731_2731_2731_2745_2759_2759_2779_2902_2904_2917_2917_2919_2960_2962_3012_3032_3033_3043_3055_3074_3098_3104_3105_3107_3115_3119_3124_3144_3146_3149_3163_3163_3163_3184_3231_3231_3233_3246_3254_3406_3411_3423_3424_3431_3432_3434_3436_3448_3448_3453_3453_3484_3487_
40,3,差距,N,7,11,18,57_62_217_276_753_1293_,2102_2273_2651_2654_2719_2722_2815_2815_3110_3331_
40,3,一如,Vt,9,1,10,316_648_654_699_1168_1170_1175_1177_,
40,3,透進,Vt,1,1,2,,
40,3,整修,Vt,3,1,4,1125_1132_,
40,3,俱樂部,N,3,2,5,856_865_,2316_
40,3,總是,ADV,20,21,41,112_242_252_280_481_592_601_714_714_724_724_745_890_898_999_1036_1239_1304_1307_,2095_2097_2164_2209_2210_2409_2410_2517_2519_2535_2566_2566_2659_2742_2747_2861_2934_3071_3337_3345_
40,3,康體,N,1,2,3,,2945_
40,3,走廊,N,11,46,57,79_85_173_182_192_239_249_957_1091_1456_,2057_2167_2175_2180_2183_2190_2198_2272_2289_2296_2411_2421_2426_2444_2483_2493_2534_2534_2576_2587_2615_2705_2706_2791_2844_2899_2908_2912_2912_2946_2976_3034_3040_3076_3083_3103_3119_3124_3246_3246_3261_3319_3319_3386_3454_
40,3,旅行,Vi,9,2,11,47_176_276_714_724_780_901_1500_,2548_
40,3,風,N,7,18,25,79_85_172_229_1092_1352_,2388_2517_2517_2519_2519_2528_2703_2784_2861_2861_2888_3132_3194_3194_3194_3470_3470_
40,3,大樓,N,5,2,7,286_286_476_485_,3338_
40,3,您好,Vi,18,20,38,44_109_113_116_186_196_443_982_1028_1029_1030_1309_1313_1450_1451_1469_1470_,2259_2305_2308_2359_2447_2575_2589_2590_2671_2672_2702_2747_2759_2857_2858_3146_3231_3253_3288_
40,3,理想,N,15,4,19,163_168_227_239_249_416_714_724_749_901_944_998_1319_1324_,2681_2882_3041_
40,3,正在,ADV,13,21,34,44_80_86_157_281_437_672_982_1013_1049_1169_1176_,2120_2121_2517_2519_2609_2691_2691_2705_2706_2740_2861_2914_2924_2942_2942_3194_3318_3332_3349_3365_
40,3,將,ADV,17,60,77,157_186_196_213_217_438_517_709_719_982_1028_1029_1203_1319_1324_1345_,2037_2037_2081_2083_2108_2135_2162_2163_2177_2219_2221_2273_2309_2322_2337_2353_2359_2359_2360_2361_2406_2408_2623_2640_2671_2671_2671_2672_2707_2708_2737_2747_2747_2753_2754_2759_2807_2824_2826_2837_2864_2902_2904_2983_2984_3008_3024_3026_3049_3146_3163_3170_3172_3305_3327_3327_3433_3435_3462_
40,3,期間,N,11,46,57,53_58_109_335_437_568_577_820_980_1335_,2016_2038_2040_2086_2126_2134_2258_2259_2305_2308_2318_2319_2322_2359_2360_2361_2391_2411_2445_2445_2446_2446_2447_2452_2475_2582_2595_2672_2759_2862_2862_2883_2946_2968_3029_3133_3202_3231_3231_3241_3243_3253_3253_3277_3341_
40,3,完成,Vt,4,1,5,710_720_819_,
40,3,快,Vi,94,61,155,51_106_150_151_174_186_196_219_226_272_289_296_304_334_335_341_377_379_397_411_411_434_504_520_529_546_554_555_563_570_579_589_591_630_674_707_710_710_713_714_714_717_720_720_723_724_724_767_783_801_802_814_820_826_841_842_849_887_895_923_931_948_956_962_966_970_972_973_976_982_983_1008_1057_1061_1083_1087_1107_1139_1147_1153_1160_1237_1238_1257_1302_1305_1309_1313_1335_1353_1366_1383_1430_,2114_2117_2127_2154_2154_2162_2162_2163_2179_2186_2231_2231_2252_2253_2258_2259_2260_2333_2334_2342_2359_2492_2517_2519_2590_2662_2707_2708_2748_2756_2761_2762_2772_2830_2845_2898_2953_2968_3013_3099_3146_3150_3158_3159_3170_3172_3195_3231_3253_3253_3253_3289_3290_3341_3360_3369_3370_3383_3384_3462_
40,3,往,Vt,8,2,10,316_648_654_1168_1170_1175_1177_,3329_
40,3,開,Vt,50,161,211,103_162_167_173_173_374_412_484_493_495_546_554_555_563_566_572_575_581_600_609_674_710_720_739_813_835_921_921_955_1007_1020_1021_1042_1088_1212_1242_1246_1319_1324_1332_1348_1348_1348_1352_1366_1384_1451_1496_1496_,2030_2031_2031_2037_2037_2037_2037_2037_2042_2042_2042_2042_2047_2057_2057_2059_2061_2099_2139_2143_2148_2163_2175_2186_2205_2206_2211_2232_2304_2304_2307_2307_2322_2343_2360_2361_2389_2477_2483_2487_2488_2509_2510_2511_2517_2519_2530_2531_2532_2533_2534_2561_2561_2562_2562_2565_2576_2588_2594_2598_2611_2649_2707_2708_2715_2716_2728_2729_2740_2747_2748_2753_2754_2754_2756_2815_2824_2826_2857_2857_2858_2858_2861_2863_2868_2898_2898_2923_2929_2953_2953_2958_2964_2964_2999_2999_3009_3009_3009_3010_3010_3010_3040_3040_3040_3056_3074_3076_3098_3133_3133_3140_3149_3180_3181_3184_3187_3189_3194_3196_3196_3196_3196_3213_3218_3241_3252_3253_3253_3291_3292_3295_3300_3303_3304_3309_3341_3341_3389_3390_3405_3410_3433_3433_3433_3435_3435_3435_3443_3443_3446_3475_3475_3476_3477_3480_3482_3485_3488_3490_
40,1,雜亂,Vi,1,0,1,,
40,3,寬帶,N,33,78,111,235_328_333_334_407_495_495_662_749_756_758_924_932_948_970_973_1083_1107_1147_1197_1200_1201_1224_1226_1251_1257_1258_1266_1271_1274_1349_1454_,2012_2051_2054_2077_2099_2170_2170_2177_2198_2266_2266_2294_2299_2299_2302_2302_2323_2328_2330_2360_2361_2365_2490_2492_2535_2544_2606_2606_2606_2623_2623_2623_2635_2651_2654_2666_2724_2738_2781_2802_2893_2916_2916_2927_2933_2972_2987_3099_3099_3103_3103_3103_3146_3146_3171_3173_3195_3196_3204_3245_3252_3252_3252_3269_3274_3318_3318_3319_3319_3333_3447_3488_3488_3488_3490_3490_3490_
40,1,短期,N,1,0,1,,
40,3,銀帆,N,12,1,13,40_40_41_42_42_43_43_43_44_44_44_,
40,3,評價,N,45,61,106,42_120_128_178_186_188_196_287_316_391_396_540_540_553_562_710_710_710_714_720_720_720_724_768_814_871_879_924_932_935_982_982_1007_1054_1057_1057_1197_1200_1311_1315_1319_1324_1348_1496_,2005_2037_2089_2115_2118_2162_2162_2183_2190_2193_2234_2247_2258_2259_2362_2362_2450_2453_2517_2519_2521_2525_2551_2571_2589_2604_2671_2671_2719_2722_2797_2815_2816_2818_2857_2858_2864_2906_2924_2933_2933_2941_2942_2967_3029_3038_3039_3040_3042_3043_3044_3048_3056_3076_3076_3076_3104_3196_3357_3371_
40,3,所,ADV,29,53,82,101_160_163_168_242_242_252_252_281_611_620_695_756_758_786_885_889_893_897_902_964_1023_1054_1171_1178_1319_1324_1367_,2089_2161_2161_2258_2258_2259_2259_2299_2302_2314_2317_2322_2417_2445_2446_2616_2623_2624_2681_2746_2746_2753_2824_2826_2842_2843_2846_2862_2862_2872_2924_2976_3034_3038_3038_3039_3039_3132_3163_3163_3272_3296_3296_3345_3352_3352_3354_3354_3364_3371_3371_3386_
40,3,指,Vt,5,10,15,245_255_711_721_,2038_2040_2040_2671_2861_3163_3163_3352_3354_
40,3,您,N,207,272,479,40_40_42_42_43_43_109_109_109_113_116_157_157_157_157_186_186_186_186_196_196_196_196_213_213_213_213_217_217_217_217_308_312_316_316_316_316_316_316_427_428_434_434_434_434_434_434_435_435_435_436_436_437_437_438_438_439_439_439_440_440_441_441_442_442_443_443_443_443_443_515_515_516_516_516_516_516_517_568_568_568_568_568_568_577_577_577_577_577_577_592_592_601_601_736_743_743_982_982_982_982_982_982_982_982_982_982_982_982_982_982_982_982_982_1028_1028_1028_1028_1029_1029_1029_1029_1029_1029_1029_1029_1030_1030_1030_1030_1030_1031_1031_1031_1031_1031_1032_1032_1032_1032_1054_1054_1054_1054_1054_1054_1054_1054_1054_1054_1054_1054_1081_1150_1150_1157_1157_1167_1167_1168_1168_1169_1169_1170_1170_1171_1171_1171_1172_1172_1173_1173_1174_1174_1175_1175_1176_1176_1177_1177_1178_1178_1178_1179_1179_1180_1180_1309_1309_1309_1313_1313_1313_1319_1319_1319_1324_1324_1324_1451_1451_1451_1469_1469_1470_1470_,2005_2037_2037_2037_2037_2037_2037_2037_2037_2108_2126_2126_2126_2177_2177_2193_2193_2258_2258_2258_2258_2258_2259_2259_2259_2259_2259_2273_2305_2305_2305_2305_2305_2305_2305_2308_2308_2308_2308_2308_2308_2308_2322_2322_2322_2322_2322_2359_2359_2359_2359_2359_2359_2359_2390_2406_2406_2406_2408_2408_2408_2417_2417_2417_2432_2432_2432_2435_2435_2435_2445_2445_2445_2445_2445_2445_2446_2446_2446_2446_2446_2446_2447_2447_2447_2447_2475_2475_2475_2575_2589_2589_2589_2589_2589_2589_2589_2590_2590_2590_2590_2590_2608_2608_2608_2609_2609_2609_2623_2623_2623_2624_2624_2651_2654_2671_2671_2671_2671_2671_2671_2671_2671_2672_2672_2672_2672_2702_2702_2702_2702_2702_2737_2737_2744_2744_2744_2744_2747_2747_2747_2747_2747_2747_2753_2753_2759_2759_2761_2761_2761_2761_2761_2761_2761_2762_2762_2762_2762_2762_2762_2762_2798_2800_2834_2840_2840_2840_2840_2840_2857_2857_2857_2857_2858_2858_2858_2858_3024_3024_3024_3026_3026_3026_3037_3049_3049_3049_3049_3049_3049_3049_3049_3055_3146_3146_3146_3146_3146_3146_3146_3146_3163_3163_3163_3163_3163_3163_3163_3163_3163_3163_3163_3168_3168_3169_3169_3170_3172_3181_3231_3231_3231_3231_3231_3253_3253_3253_3253_3253_3288_3288_3345_3345_3345_3345_3345_3345_3371_3371_3371_3383_3383_3384_3384_3431_3431_3431_3431_3431_3431_3432_3432_3432_3432_3432_3432_3433_3435_3448_3448_3448_3453_3453_3453_3483_3483_3483_3483_3483_3483_
40,3,7日,N,6,13,19,517_1167_1168_1174_1175_,2040_2177_2647_2759_2761_2762_3049_3141_3146_3163_3352_3354_
40,3,5月,N,19,36,55,164_169_227_517_611_620_901_921_1031_1031_1032_1048_1054_1203_1203_1347_1469_1470_,2204_2261_2263_2299_2302_2305_2308_2314_2317_2433_2436_2475_2611_2616_2744_2747_2877_2878_2946_2976_3013_3047_3049_3051_3103_3133_3223_3308_3308_3308_3458_3458_3459_3480_3482_
40,3,主樓,N,2,8,10,334_,2629_2630_2871_3210_3215_3401_3418_
40,3,近期,N,5,1,6,42_157_326_331_,
40,3,工程,N,2,5,7,157_,2408_2432_2435_2946_
40,3,盡快,ADV,3,6,9,1091_1138_,2180_2391_3009_3010_3360_
40,3,現,N,4,7,11,109_1087_1087_,2432_2435_2714_2744_3205_3463_
40,1,中肯,Vi,2,0,2,982_,
40,1,一頭,ADV,1,0,1,,
41,3,臨時,N,4,10,14,152_174_753_,2053_2134_2747_2769_2770_2844_3083_3115_3272_
41,3,如何,ADV,3,13,16,779_943_,2036_2070_2070_2309_2309_2873_3043_3132_3163_3364_3364_3478_
41,3,無語,Vi,1,12,13,,2284_2587_2609_2787_2789_2930_3024_3026_3146_3419_3466_
41,3,評,N,6,16,22,316_408_821_1428_1472_,2074_2125_2181_2241_2241_2338_2384_2679_2718_2721_3242_3296_3331_3385_3458_
41,3,管理,Vt,21,22,43,79_81_85_87_141_236_612_621_707_714_717_724_753_1005_1153_1160_1319_1324_1399_1399_,2081_2081_2083_2083_2134_2189_2267_2322_2388_2671_2746_2828_2857_2858_2976_3132_3213_3218_3288_3341_3397_
41,3,蹲,Vi,2,1,3,52_,
41,3,行政,N,35,20,55,108_115_156_203_209_225_260_262_434_517_665_901_922_924_924_924_924_924_930_932_932_932_932_932_934_1009_1009_1096_1099_1155_1162_1204_1442_1447_,2065_2065_2072_2166_2463_2463_2463_2465_2465_2465_2698_2698_2754_3111_3132_3223_3345_3383_3384_
41,3,不可,ADV,3,9,12,77_83_,2267_2604_2609_3105_3159_3269_3448_3453_
41,3,喜好,N,1,3,4,,2308_2624_
41,3,能,ADV,182,339,521,47_50_52_52_55_60_66_69_69_73_76_76_100_103_119_127_145_145_154_163_163_168_168_185_185_185_186_195_195_195_196_213_217_227_238_239_242_242_245_249_252_252_253_255_280_281_281_287_289_335_341_342_352_374_391_393_396_396_424_427_427_429_429_439_443_468_468_472_472_502_512_525_534_538_546_546_555_555_573_592_600_601_609_630_644_660_669_707_711_717_721_743_743_744_783_786_788_795_798_802_808_817_825_835_841_847_858_867_885_886_886_887_887_888_890_893_894_894_895_895_896_898_902_902_924_932_947_958_961_965_968_982_983_990_990_993_993_1014_1028_1029_1030_1031_1041_1049_1051_1060_1070_1077_1084_1088_1090_1090_1091_1124_1131_1139_1171_1178_1197_1200_1207_1208_1211_1215_1218_1231_1232_1232_1252_1319_1319_1324_1324_1340_1366_1437_1471_1471_1472_1472_1500_,2005_2012_2012_2018_2037_2037_2042_2047_2048_2048_2059_2062_2070_2070_2071_2072_2095_2097_2106_2108_2110_2110_2112_2116_2119_2124_2124_2126_2126_2127_2136_2140_2162_2162_2167_2167_2170_2175_2186_2192_2223_2229_2232_2240_2242_2244_2245_2246_2252_2252_2253_2253_2258_2259_2281_2282_2284_2290_2298_2301_2304_2305_2305_2305_2307_2308_2308_2308_2312_2315_2322_2359_2360_2360_2361_2361_2364_2371_2374_2384_2391_2395_2409_2409_2410_2410_2417_2434_2445_2446_2469_2473_2483_2483_2491_2492_2492_2494_2494_2495_2495_2505_2517_2517_2519_2519_2522_2525_2530_2530_2531_2560_2569_2569_2579_2579_2579_2589_2590_2603_2604_2605_2606_2606_2608_2609_2609_2616_2636_2662_2671_2671_2684_2687_2690_2698_2702_2709_2711_2718_2718_2721_2721_2734_2734_2740_2742_2742_2742_2750_2750_2750_2753_2753_2756_2772_2773_2775_2786_2788_2791_2791_2798_2800_2802_2824_2824_2826_2826_2828_2828_2835_2836_2837_2846_2855_2856_2857_2858_2862_2862_2864_2869_2872_2872_2873_2879_2880_2881_2882_2884_2886_2889_2890_2892_2893_2898_2912_2914_2915_2916_2919_2924_2924_2924_2933_2933_2933_2933_2958_2973_2980_3019_3031_3035_3036_3040_3040_3049_3049_3052_3053_3055_3055_3065_3067_3071_3076_3076_3078_3083_3088_3089_3095_3098_3098_3103_3103_3103_3115_3115_3115_3129_3129_3130_3130_3135_3140_3146_3153_3170_3172_3184_3187_3189_3190_3194_3205_3205_3209_3210_3215_3223_3225_3226_3231_3239_3246_3246_3246_3247_3257_3260_3264_3270_3278_3288_3289_3290_3296_3305_3319_3319_3320_3323_3327_3331_3339_3339_3341_3341_3345_3347_3360_3360_3379_3388_3396_3397_3397_3415_3415_3423_3424_3431_3431_3432_3432_3433_3433_3433_3433_3433_3433_3434_3435_3435_3435_3435_3435_3435_3436_3438_3443_3448_3448_3448_3451_3452_3453_3453_3453_3456_3457_3458_3467_3470_3477_
41,1,應不應該,ADV,1,0,1,,
41,3,預定,Vt,58,137,195,115_121_121_129_129_183_186_186_193_196_196_238_342_352_363_363_368_368_427_431_434_461_461_593_602_611_620_630_649_655_665_756_758_764_779_811_901_901_901_956_1020_1020_1033_1067_1074_1091_1141_1143_1234_1352_1430_1469_1469_1470_1470_1479_1486_,2039_2041_2106_2128_2134_2134_2135_2209_2210_2252_2253_2269_2295_2309_2309_2342_2360_2360_2361_2361_2372_2372_2375_2375_2390_2403_2406_2408_2417_2417_2421_2445_2446_2483_2494_2494_2494_2495_2495_2495_2502_2527_2535_2564_2604_2609_2632_2633_2637_2638_2690_2690_2690_2724_2732_2750_2750_2773_2787_2789_2790_2794_2836_2838_2838_2838_2872_2872_2872_2885_2887_2919_2919_2949_2956_2956_2957_2957_2986_3005_3115_3115_3115_3115_3119_3124_3129_3130_3142_3159_3159_3159_3163_3165_3213_3218_3253_3253_3253_3255_3255_3255_3255_3256_3256_3256_3256_3267_3267_3283_3296_3308_3308_3311_3324_3324_3324_3367_3368_3373_3373_3374_3374_3386_3431_3432_3433_3435_3466_3486_3488_3488_3488_3490_3490_3490_
41,1,彎腰,Vi,3,0,3,1112_1120_,
41,3,不會,ADV,16,195,211,109_481_546_546_555_555_573_590_672_736_1088_1153_1160_1256_1429_,2039_2041_2049_2052_2070_2104_2108_2112_2126_2134_2139_2143_2147_2149_2151_2158_2161_2162_2163_2171_2175_2177_2184_2190_2191_2204_2211_2247_2255_2257_2260_2264_2269_2270_2285_2286_2292_2292_2296_2305_2308_2318_2319_2338_2340_2341_2360_2361_2392_2411_2414_2424_2425_2426_2428_2439_2450_2453_2454_2455_2484_2485_2515_2541_2544_2558_2569_2572_2606_2607_2636_2637_2638_2651_2654_2672_2688_2690_2698_2698_2702_2714_2715_2716_2731_2745_2746_2754_2759_2759_2761_2762_2765_2766_2776_2776_2776_2776_2786_2788_2791_2797_2798_2800_2807_2808_2809_2822_2829_2830_2836_2846_2859_2860_2861_2862_2862_2867_2879_2880_2885_2887_2889_2890_2907_2920_2922_2922_2953_2959_2976_2979_2998_3000_3001_3005_3046_3049_3050_3076_3080_3082_3083_3097_3101_3111_3113_3115_3122_3127_3133_3134_3180_3185_3195_3196_3201_3213_3218_3222_3223_3246_3255_3256_3280_3284_3285_3293_3297_3305_3306_3308_3308_3325_3329_3333_3364_3369_3370_3372_3383_3384_3397_3415_3425_3426_3428_3443_3445_3465_3478_3478_3480_3482_
41,3,欣慰,Vt,1,5,6,,2824_2826_2907_3443_
41,1,一時,N,1,0,1,,
41,3,保留,Vt,4,15,19,238_449_457_,2062_2138_2391_2494_2495_2516_2518_2547_2761_2762_2846_3332_3373_3374_
41,3,安排,Vt,37,46,83,110_163_168_286_481_481_482_491_516_516_707_707_709_717_717_719_743_778_784_784_873_881_914_965_1020_1060_1091_1095_1106_1126_1133_1135_1169_1176_1329_1343_,2201_2211_2269_2272_2333_2334_2360_2360_2361_2361_2368_2369_2535_2671_2734_2743_2754_2754_2754_2775_2775_2836_2933_2933_2933_2933_2933_2933_3063_3163_3227_3254_3255_3256_3272_3274_3371_3371_3388_3388_3388_3433_3435_3438_3447_
41,3,客戶,N,36,62,98,41_41_41_160_212_225_276_449_457_471_475_481_546_555_584_714_724_753_924_924_932_932_995_996_1037_1205_1311_1311_1311_1315_1315_1315_1329_1431_1450_,2081_2083_2246_2258_2259_2267_2309_2322_2322_2322_2360_2360_2360_2361_2361_2361_2388_2388_2475_2498_2504_2549_2550_2630_2640_2640_2665_2671_2672_2824_2824_2826_2826_2842_2843_3035_3038_3039_3043_3043_3076_3139_3220_3221_3231_3231_3288_3288_3294_3296_3345_3345_3345_3345_3345_3345_3371_3371_3433_3435_3443_
41,1,尊重,Vt,1,0,1,,
41,3,當然,ADV,22,24,46,95_149_214_281_546_555_662_711_714_721_724_835_885_893_904_905_917_1025_1213_1423_1451_,2124_2161_2272_2295_2522_2564_2596_2597_2609_2659_2746_2776_3037_3055_3083_3098_3103_3306_3409_3433_3433_3435_3435_
41,1,雕,Vt,1,0,1,,
41,3,首先,ADV,14,47,61,103_157_516_568_577_889_897_910_940_982_1088_1309_1313_,2039_2041_2095_2097_2124_2126_2144_2145_2333_2334_2359_2473_2589_2616_2623_2651_2654_2671_2718_2721_2742_2746_2759_2840_2862_2862_2872_2881_2883_3049_3055_3072_3095_3150_3190_3223_3232_3345_3371_3386_3388_3397_3431_3432_3448_3453_
41,3,唯一,A,50,49,99,91_102_114_116_184_194_293_301_392_509_572_581_711_721_733_751_786_787_788_817_817_834_855_856_864_865_885_893_924_932_959_981_990_993_1031_1062_1070_1077_1090_1228_1230_1277_1284_1335_1366_1419_1429_1429_1499_,2085_2189_2196_2205_2258_2259_2274_2283_2287_2288_2339_2340_2341_2360_2361_2452_2517_2519_2522_2574_2670_2671_2671_2689_2748_2815_2824_2826_2829_2870_2873_2881_2907_2924_2976_3065_3067_3149_3235_3246_3333_3365_3371_3380_3389_3390_3397_3443_
41,1,好歹,ADV,2,0,2,700_,
41,3,找,Vt,42,116,158,101_103_112_320_320_392_451_459_502_670_686_691_710_711_720_721_793_796_847_875_883_886_887_890_894_895_898_902_902_944_1201_1204_1242_1246_1290_1311_1315_1333_1339_1366_1472_,2066_2095_2097_2126_2136_2140_2167_2211_2220_2222_2231_2231_2231_2266_2269_2290_2294_2314_2317_2354_2355_2359_2359_2360_2361_2391_2419_2484_2492_2514_2534_2554_2554_2555_2555_2559_2566_2579_2584_2584_2587_2641_2645_2659_2669_2690_2710_2712_2739_2742_2757_2758_2769_2770_2775_2795_2802_2803_2816_2818_2824_2826_2835_2852_2861_2865_2869_2872_2889_2890_2902_2902_2904_2904_2914_2919_2923_2933_2968_2975_2976_2987_3040_3065_3067_3074_3074_3083_3099_3118_3142_3182_3183_3193_3196_3205_3231_3253_3281_3281_3281_3289_3289_3290_3290_3333_3347_3349_3365_3373_3374_3443_3454_3454_3463_
41,1,套用,Vt,1,0,1,,
41,3,不用,ADV,18,14,32,181_191_245_255_363_364_368_369_764_819_916_924_932_949_1145_1249_1251_,2189_2189_2313_2316_2384_2606_2739_2746_3246_3255_3256_3419_3446_
41,3,投訴,Vi,2,48,50,1042_,2039_2041_2055_2081_2083_2104_2155_2159_2159_2167_2206_2206_2232_2276_2322_2338_2338_2363_2517_2519_2531_2594_2606_2608_2608_2671_2690_2690_2746_2750_2759_2775_2776_2945_2980_2999_3058_3071_3113_3181_3207_3253_3253_3351_3373_3374_3443_
41,1,標配,Vt,1,0,1,,
41,1,老話,N,1,0,1,,
41,3,增加,Vt,5,4,9,816_1054_1481_1488_,3115_3391_3393_
41,3,9月,N,6,26,32,364_369_412_768_1343_,2081_2083_2095_2095_2097_2097_2284_2362_2417_2464_2466_2554_2555_2565_2680_2680_2680_2680_2680_2761_2762_2836_2854_3232_3316_
41,1,朽木,N,1,0,1,,
41,3,居然,ADV,53,205,258,67_74_115_119_127_149_186_196_229_231_238_238_263_282_322_381_384_388_424_546_546_546_555_555_555_611_620_630_674_676_702_783_887_895_921_921_939_939_988_1072_1079_1100_1181_1187_1282_1289_1294_1298_1319_1324_1472_1472_,2037_2039_2039_2041_2041_2059_2059_2065_2090_2107_2114_2117_2126_2148_2149_2149_2159_2172_2174_2190_2190_2205_2207_2209_2210_2241_2244_2245_2255_2257_2258_2259_2267_2273_2273_2273_2287_2288_2312_2315_2338_2338_2338_2370_2373_2387_2387_2391_2393_2398_2450_2450_2453_2453_2463_2465_2492_2516_2518_2526_2526_2528_2537_2537_2538_2538_2543_2561_2562_2563_2585_2632_2633_2639_2650_2653_2657_2690_2690_2718_2721_2731_2731_2743_2746_2748_2753_2767_2776_2785_2791_2802_2803_2816_2816_2818_2818_2835_2838_2857_2858_2862_2884_2886_2889_2890_2918_2919_2922_2923_2923_2923_2925_2925_2930_2948_2951_2951_2958_2979_2999_3007_3008_3024_3026_3029_3038_3039_3040_3040_3046_3050_3071_3076_3076_3076_3076_3099_3102_3102_3104_3105_3110_3113_3115_3115_3115_3115_3119_3124_3145_3180_3194_3204_3213_3218_3220_3221_3231_3231_3239_3239_3243_3253_3254_3254_3254_3257_3257_3257_3266_3278_3281_3281_3295_3295_3308_3312_3321_3322_3349_3353_3353_3355_3355_3359_3363_3365_3379_3382_3401_3409_3417_3418_3423_3424_3427_3448_3453_3463_3472_3476_3476_3483_
41,3,14日,N,8,12,20,113_1028_1029_1081_1469_1470_1474_,2305_2308_2360_2361_2494_2495_2503_2573_2671_2956_2957_
41,3,終於,ADV,1,30,31,,2272_2561_2562_2742_2775_2816_2818_2946_2946_3146_3146_3184_3187_3189_3213_3218_3253_3319_3360_3360_3360_3433_3433_3433_3433_3435_3435_3435_3435_
41,3,相應,Vi,4,7,11,946_1031_1238_,2225_2226_2332_2797_3448_3453_
41,3,信息,N,11,16,27,41_222_516_516_546_555_756_758_1142_1144_,2059_2108_2177_2322_2377_2388_2560_2560_2658_2731_2925_3159_3163_3258_3462_
41,3,至少,ADV,12,13,25,109_289_551_553_560_562_698_753_1201_1319_1324_,2151_2151_2229_2342_2534_2671_2881_3163_3210_3215_3333_3344_
41,3,系統,N,5,23,28,41_217_546_555_,2071_2166_2209_2210_2287_2288_2517_2519_2700_2701_2728_2729_2746_2872_3132_3146_3146_3296_3364_3371_3396_3466_
41,1,回顧,Vt,1,0,1,,
41,3,2007年,N,29,57,86,51_157_287_334_364_369_412_588_590_631_641_732_743_768_821_983_1011_1072_1073_1079_1080_1218_1270_1273_1343_1429_1469_1470_,2040_2057_2108_2126_2134_2283_2299_2302_2305_2308_2345_2350_2359_2417_2469_2573_2608_2608_2609_2609_2647_2759_2761_2762_2765_2794_2815_2827_2854_2889_2890_2909_2910_2956_2957_2976_3014_3029_3038_3039_3103_3115_3129_3130_3158_3165_3205_3232_3257_3269_3274_3296_3296_3327_3333_3444_
41,3,記錄,N,5,4,9,137_434_1029_1451_,2924_3296_3296_
41,3,豪華,Vi,68,59,127,41_43_116_162_162_165_167_167_170_183_186_193_196_201_207_244_254_281_287_290_346_356_374_374_376_376_407_408_421_427_427_427_431_434_434_441_499_572_581_641_750_784_889_897_901_901_1009_1066_1070_1077_1089_1101_1145_1155_1162_1169_1176_1270_1273_1353_1431_1439_1444_1469_1470_1490_1493_,2201_2211_2231_2280_2298_2301_2312_2315_2365_2393_2463_2465_2549_2550_2613_2731_2740_2740_2744_2748_2761_2761_2762_2762_2776_2881_2903_2905_2925_2956_2957_3040_3040_3149_3149_3185_3210_3210_3210_3215_3215_3215_3239_3324_3327_3329_3329_3344_3344_3345_3356_3356_3364_3364_3372_3423_3424_3438_
42,3,好評,N,9,2,11,710_716_720_726_1184_1190_1309_1313_,3359_
42,3,通過,Vt,39,78,117,112_115_121_129_186_196_238_292_293_300_301_408_434_434_482_491_568_577_611_611_620_620_630_632_649_655_779_872_880_901_901_901_1032_1057_1141_1143_1293_1353_,2070_2134_2204_2284_2295_2312_2315_2359_2360_2361_2378_2412_2445_2446_2483_2502_2527_2554_2555_2564_2609_2680_2690_2714_2743_2750_2750_2750_2827_2838_2879_2880_2923_2924_2946_2968_2986_3001_3013_3032_3032_3033_3033_3083_3133_3133_3146_3146_3222_3227_3227_3231_3239_3246_3253_3253_3288_3312_3344_3371_3371_3373_3374_3386_3389_3390_3423_3424_3443_3458_3466_3484_3487_3488_3488_3490_3490_
42,3,客人,N,160,274,434,44_44_44_52_57_62_81_87_89_108_109_113_115_116_116_119_119_127_127_163_163_163_168_168_168_178_182_183_186_187_188_192_193_196_197_212_213_217_217_224_238_239_241_242_242_242_242_242_242_242_249_251_252_252_252_252_252_252_252_267_271_280_295_295_295_303_303_303_316_390_392_417_435_515_515_525_534_546_546_546_555_555_555_592_593_601_602_616_625_628_630_666_675_699_701_707_711_717_721_743_748_768_794_797_835_902_902_902_910_982_982_982_982_999_1002_1019_1020_1020_1032_1033_1033_1054_1054_1057_1060_1062_1070_1073_1073_1077_1080_1080_1087_1088_1091_1091_1098_1124_1131_1201_1201_1231_1256_1278_1279_1285_1286_1319_1319_1324_1324_1343_1348_1469_1470_1481_1488_1490_1493_,2002_2003_2005_2029_2037_2059_2059_2070_2071_2084_2084_2085_2085_2108_2108_2108_2134_2139_2143_2153_2159_2159_2163_2177_2177_2183_2189_2190_2252_2252_2253_2253_2264_2270_2284_2287_2287_2288_2288_2295_2295_2305_2305_2305_2305_2305_2305_2308_2308_2308_2308_2308_2308_2309_2309_2309_2312_2315_2322_2322_2342_2359_2359_2360_2360_2361_2361_2363_2363_2363_2363_2363_2367_2406_2408_2417_2417_2447_2450_2452_2453_2463_2465_2483_2486_2486_2509_2517_2517_2519_2519_2530_2535_2535_2541_2548_2551_2557_2557_2558_2560_2566_2589_2606_2616_2616_2616_2616_2616_2616_2618_2621_2651_2651_2654_2654_2674_2674_2680_2688_2690_2690_2740_2746_2746_2746_2746_2746_2746_2746_2746_2753_2753_2754_2754_2754_2759_2759_2759_2776_2776_2779_2794_2794_2798_2798_2798_2798_2800_2800_2800_2800_2802_2809_2822_2824_2826_2827_2835_2835_2838_2847_2847_2857_2858_2861_2862_2889_2889_2890_2890_2922_2923_2924_2927_2939_2940_2946_2949_2954_2996_3009_3009_3009_3010_3010_3010_3012_3055_3058_3076_3095_3098_3098_3110_3110_3132_3136_3146_3146_3146_3150_3160_3163_3163_3167_3180_3184_3204_3226_3226_3226_3231_3238_3240_3243_3243_3243_3243_3243_3244_3246_3246_3253_3253_3253_3253_3255_3256_3281_3282_3282_3288_3291_3292_3296_3296_3296_3296_3296_3296_3298_3301_3308_3331_3338_3345_3351_3351_3351_3360_3360_3360_3360_3371_3371_3371_3371_3373_3374_3376_3378_3397_3431_3431_3432_3432_3433_3435_3470_3471_3489_3491_
42,3,良好,Vi,15,4,19,42_400_464_610_619_641_657_982_1023_1032_1057_1337_1371_1423_,2085_2671_2872_
42,3,資源,N,1,1,2,,
42,3,活動,N,8,6,14,43_198_1057_1060_1199_1234_1498_,2167_2759_3032_3033_3265_
42,1,優化,Vi,1,0,1,,
42,1,辦公台,N,1,0,1,,
42,3,歡迎,Vt,28,16,44,43_186_196_245_255_287_316_426_442_568_577_592_601_628_630_1054_1057_1073_1080_1091_1217_1309_1313_1319_1324_1469_1470_,2177_2204_2359_2406_2408_2452_2671_2744_3032_3033_3049_3168_3169_3448_3453_
42,3,總機,N,1,9,10,,2360_2361_2361_2651_2654_2671_3044_3048_
42,3,聯繫,Vt,18,53,71,153_185_195_320_466_628_681_682_710_720_749_749_1224_1226_1234_1343_1343_,2104_2104_2232_2237_2238_2244_2245_2467_2468_2483_2498_2574_2590_2672_2690_2779_2816_2816_2818_2818_2865_2965_2966_2979_3031_3052_3053_3118_3132_3170_3170_3172_3172_3182_3183_3196_3231_3252_3270_3283_3319_3329_3337_3366_3433_3433_3433_3433_3435_3435_3435_3435_
42,3,幫助,Vt,6,8,14,745_984_1359_1364_1431_,2651_2654_2881_2988_3083_3253_3272_
42,3,1月,N,9,25,34,43_44_44_281_788_962_1062_1428_,2108_2177_2193_2266_2322_2322_2360_2361_2406_2408_2503_2510_2511_2746_2816_2816_2818_2818_3055_3055_3141_3254_3269_3327_
42,3,網速,N,9,8,17,411_630_630_630_954_1237_1309_1313_,2009_2009_2127_2662_3099_3099_3103_
42,3,升級,Vi,66,19,85,43_43_57_62_108_109_235_431_434_434_434_441_482_491_521_530_612_612_621_621_665_672_707_717_771_775_780_784_809_843_872_880_887_888_889_895_896_897_915_916_920_922_925_928_930_933_936_1003_1054_1057_1164_1166_1234_1238_1251_1252_1309_1311_1313_1315_1393_1402_1472_1495_1498_,2209_2209_2210_2210_2280_2309_2754_2754_2776_2806_2841_2872_2872_2872_3047_3051_3210_3215_
42,1,推廣,Vt,1,0,1,,
42,3,適合,Vi,32,13,45,69_76_89_90_148_158_176_219_334_350_360_607_633_687_692_784_851_859_860_868_890_898_968_980_1018_1031_1091_1168_1175_1256_1292_,2168_2322_2322_2509_2742_2848_2918_2918_2980_3265_3353_3355_
42,3,衛生間,N,87,146,233,44_51_91_99_100_102_103_109_163_168_176_223_231_248_258_281_335_342_352_389_443_499_523_532_543_553_562_594_603_631_672_676_749_753_753_755_757_773_773_777_777_783_794_795_797_798_802_808_830_870_875_875_878_883_883_885_889_893_897_910_910_957_972_980_982_982_984_995_996_1001_1005_1024_1058_1141_1143_1171_1178_1293_1341_1350_1356_1361_1362_1451_1481_1488_,2006_2033_2035_2037_2050_2053_2069_2084_2085_2086_2095_2097_2114_2114_2117_2117_2126_2130_2132_2146_2161_2162_2170_2172_2180_2184_2190_2196_2204_2211_2231_2272_2272_2272_2289_2299_2302_2310_2311_2344_2345_2349_2350_2382_2389_2404_2412_2421_2445_2446_2492_2512_2528_2540_2547_2553_2579_2579_2600_2606_2607_2709_2711_2756_2814_2814_2824_2826_2828_2845_2872_2893_2911_2917_2919_2922_2938_2941_2946_2950_2975_2988_3017_3018_3019_3030_3059_3074_3083_3084_3085_3098_3100_3108_3109_3132_3141_3152_3159_3170_3172_3177_3242_3246_3246_3246_3249_3265_3266_3288_3289_3289_3290_3290_3293_3295_3295_3317_3318_3318_3321_3322_3333_3345_3357_3363_3369_3370_3376_3376_3378_3378_3385_3403_3408_3409_3433_3435_3443_3448_3453_3466_3466_3471_3484_
42,3,16日,N,5,7,12,43_568_577_1337_,2193_2433_3055_3333_3345_3418_
42,3,個人,N,49,80,129,42_51_69_76_186_196_228_309_313_379_450_458_522_531_540_540_546_546_551_555_555_560_600_609_672_707_717_812_814_818_847_891_899_902_964_986_1020_1023_1082_1082_1083_1108_1114_1115_1116_1338_1425_1500_,2005_2016_2070_2070_2070_2070_2167_2195_2202_2232_2247_2269_2310_2311_2367_2377_2452_2454_2454_2455_2455_2509_2516_2518_2535_2547_2548_2565_2596_2597_2608_2608_2608_2624_2683_2686_2691_2691_2691_2705_2706_2718_2721_2746_2754_2769_2769_2769_2770_2770_2770_2796_2838_2861_2861_2862_2872_2893_2906_2908_2925_3049_3150_3207_3246_3246_3246_3253_3295_3308_3345_3388_3397_3433_3435_3443_3446_3462_3472_
42,3,進一步,ADV,9,3,12,546_549_555_558_982_1030_1213_1426_,2671_2862_
42,3,習慣,N,14,6,20,51_271_326_331_707_717_886_894_921_982_1423_1443_1448_,2523_2795_2861_3040_3087_
42,3,一致,Vi,5,3,8,710_710_720_720_,3104_3339_
43,1,意外,N,9,0,9,632_872_880_922_930_1062_1096_1423_,
43,3,基礎,N,1,2,3,,2654_
43,1,年終,N,2,0,2,43_,
43,3,目前,N,12,13,25,44_322_517_743_982_1013_1067_1074_1250_1250_1263_,2226_2305_2308_2391_2409_2410_2531_2924_2924_2924_3146_3397_
43,3,級別,N,5,9,14,198_506_630_1495_,2426_2775_2786_2788_2824_2826_2953_3165_
43,3,更,ADV,87,126,213,44_119_127_155_186_196_227_242_252_287_297_305_316_320_334_342_342_352_352_482_491_499_546_555_568_577_616_625_630_632_644_669_670_674_703_705_710_713_720_723_753_762_773_777_793_796_802_804_835_885_890_893_898_902_914_917_921_924_928_932_936_952_953_1025_1124_1126_1126_1131_1133_1133_1182_1188_1201_1252_1309_1313_1319_1324_1351_1353_1371_1419_1419_1436_1500_1500_,2004_2006_2012_2012_2012_2037_2037_2069_2134_2161_2161_2190_2195_2202_2232_2264_2297_2300_2335_2371_2372_2374_2375_2387_2396_2398_2421_2450_2453_2454_2455_2492_2523_2523_2572_2584_2587_2600_2600_2603_2605_2607_2647_2651_2654_2671_2672_2690_2710_2712_2739_2744_2746_2747_2748_2750_2757_2758_2767_2775_2829_2840_2877_2878_2882_2889_2890_2903_2905_2944_2945_2958_2959_2976_2976_3007_3014_3030_3047_3051_3055_3069_3070_3076_3078_3146_3150_3163_3163_3228_3229_3253_3255_3256_3296_3319_3331_3345_3345_3347_3347_3353_3355_3357_3361_3362_3364_3364_3409_3413_3413_3413_3431_3432_3433_3435_3448_3451_3453_3456_3458_3462_3480_3482_3486_
43,3,房型,N,7,21,28,43_213_412_1009_1393_1402_,2209_2210_2322_2372_2372_2375_2375_2416_2589_2606_2775_2840_3146_3146_3345_3364_3364_3364_3413_3413_
43,3,喜歡,Vt,57,32,89,81_87_113_113_186_196_224_224_227_231_247_257_271_292_300_390_404_405_412_508_522_524_531_533_667_683_710_720_837_837_846_872_880_919_962_964_979_1055_1088_1097_1098_1112_1115_1120_1319_1319_1324_1324_1350_1387_1427_1442_1447_1472_1497_1499_,2012_2162_2299_2302_2549_2549_2549_2550_2550_2550_2624_2781_2933_2933_2938_2967_2976_3282_3327_3353_3353_3353_3355_3355_3355_3434_3434_3436_3436_3480_3482_
43,3,全新,Vi,3,2,5,157_1097_,2259_
43,3,為,Vt,40,68,108,44_68_75_108_119_127_242_242_252_252_276_281_316_515_546_546_555_555_568_577_628_649_655_711_721_753_995_996_1028_1029_1231_1253_1359_1364_1367_1423_1480_1487_1500_,2016_2037_2081_2083_2108_2154_2305_2308_2388_2388_2388_2406_2408_2417_2434_2517_2519_2530_2535_2608_2616_2616_2671_2671_2746_2750_2750_2759_2775_2790_2824_2826_2827_2840_2841_2846_2872_2924_3001_3007_3024_3026_3032_3032_3033_3033_3073_3107_3115_3132_3163_3163_3236_3260_3260_3308_3319_3345_3345_3347_3371_3431_3431_3432_3432_3489_3491_
43,1,間高,N,1,0,1,,
43,1,回饋,Vt,1,0,1,,
43,3,推出,Vt,1,5,6,,2621_3282_3383_3384_
44,3,相信,Vt,5,27,32,644_982_1171_1178_,2089_2159_2190_2231_2260_2370_2373_2445_2446_2504_2573_2803_2804_2824_2826_2838_2852_2924_3076_3076_3084_3253_3279_3294_3345_3458_
44,1,謹,ADV,1,0,1,,
44,3,贊,Vt,17,1,18,162_167_276_373_386_407_551_560_711_721_889_897_1056_1059_1234_1352_,
44,3,全體,N,1,6,7,,2359_2609_2609_3448_3453_
44,3,總體,N,148,40,188,45_48_51_68_75_95_100_142_173_182_192_203_209_214_224_224_245_248_255_258_269_279_308_312_322_339_341_374_391_391_395_407_412_434_465_480_489_502_508_546_553_555_562_566_575_585_630_662_668_668_670_681_682_683_695_732_734_740_743_750_756_758_768_771_775_778_783_787_792_794_797_799_803_809_815_825_887_895_912_940_943_955_963_972_974_978_987_991_994_1005_1009_1011_1019_1021_1022_1025_1032_1039_1054_1068_1075_1100_1109_1113_1117_1121_1139_1139_1141_1143_1155_1162_1163_1165_1199_1204_1213_1218_1240_1250_1256_1259_1261_1272_1275_1303_1306_1309_1313_1316_1321_1343_1345_1349_1352_1355_1360_1393_1402_1431_1439_1444_1451_1456_1489_1492_1498_,2062_2110_2192_2209_2210_2235_2236_2314_2317_2342_2377_2399_2401_2470_2539_2547_2621_2634_2647_2647_2667_2670_2714_2784_2790_2815_2883_2933_2974_2983_2984_2988_3015_3019_3104_3187_3189_3286_3304_
44,3,還可以,ADV,100,41,141,54_59_96_104_104_162_167_200_206_223_232_282_340_374_375_376_416_425_426_437_444_452_495_518_565_573_574_586_590_630_630_636_638_643_644_670_680_686_691_746_750_752_765_771_775_794_795_797_798_814_830_842_846_847_851_860_871_872_872_879_880_880_904_904_978_980_997_1006_1019_1036_1037_1039_1049_1057_1058_1219_1221_1223_1225_1239_1240_1262_1295_1296_1299_1300_1334_1351_1356_1356_1361_1361_1408_1413_1425_1454_1456_1473_1496_,2291_2299_2302_2346_2351_2360_2361_2393_2438_2440_2490_2546_2608_2608_2648_2713_2719_2722_2799_2807_2833_2861_2879_2880_2913_2938_3011_3016_3056_3072_3092_3249_3258_3270_3289_3290_3293_3380_3401_3443_
44,3,公司,N,21,15,36,225_406_587_588_590_649_655_667_699_999_999_1005_1010_1106_1195_1198_1203_1203_1203_1455_,2537_2538_2551_2690_2902_2904_2919_3040_3142_3146_3170_3172_3193_3437_
44,3,宣傳,N,4,6,10,287_794_797_,2394_3187_3189_3245_3364_
44,1,中文字,N,1,0,1,,
44,3,同仁,N,1,1,2,,
44,1,一流,Vi,37,0,37,110_114_241_251_520_528_529_537_707_707_707_709_714_714_717_717_717_719_724_724_740_835_925_928_933_936_949_1215_1303_1306_1437_1439_1441_1444_1446_1471_,
44,3,均,ADV,8,21,29,50_109_260_262_280_661_960_,2057_2057_2134_2363_2363_2406_2408_2671_2761_2762_2845_2873_2873_2893_2976_3013_3024_3026_3345_3371_
44,3,國,N,3,11,14,738_828_,2466_2579_2824_2826_2936_2937_3253_3460_3495_3497_
44,3,馬桶,N,15,40,55,44_52_52_346_356_382_385_546_555_631_957_1409_1479_1486_,2123_2123_2139_2143_2183_2196_2211_2272_2326_2540_2573_2607_2707_2708_2718_2721_2784_2823_2825_2928_2975_2975_2987_2987_3013_3017_3018_3076_3084_3095_3114_3161_3249_3254_3310_3353_3355_3409_3472_
44,3,尤其,ADV,53,26,79,51_77_83_113_114_122_130_183_193_212_212_281_337_351_351_361_361_405_470_474_506_546_546_550_555_555_559_630_672_678_714_724_738_751_768_837_924_932_1125_1129_1132_1136_1141_1143_1172_1179_1290_1294_1298_1362_1428_1497_,2043_2045_2084_2085_2161_2183_2233_2500_2501_2517_2519_2528_2559_2592_2609_2750_2753_2846_2881_2950_2990_2992_3142_3225_3342_
44,3,未來,N,1,2,3,,3294_
44,3,超級,A,15,29,44,54_59_732_780_841_871_871_871_879_879_879_1070_1077_1350_,2005_2010_2016_2126_2126_2454_2455_2523_2600_2680_2775_2867_2872_3059_3207_3210_3210_3210_3210_3215_3215_3215_3215_3334_3389_3390_3470_3477_
44,3,市區,N,40,33,73,138_139_145_271_335_335_364_369_422_467_644_649_650_655_656_666_686_686_691_691_768_783_816_856_859_865_868_902_902_1082_1090_1141_1143_1231_1241_1245_1346_1437_1437_,2035_2124_2299_2299_2302_2302_2360_2361_2458_2639_2698_2760_2835_2848_2849_2851_2909_2910_2944_3159_3163_3163_3163_3163_3273_3376_3378_3405_3410_3414_3434_3436_
44,3,怎麼樣,Vi,14,26,40,600_600_609_609_635_637_782_782_793_796_1034_1294_1298_,2104_2113_2192_2199_2202_2232_2276_2378_2626_2746_2769_2770_2861_2902_2904_2988_3046_3050_3106_3234_3264_3306_3333_3431_3432_
44,3,天,N,3,16,19,320_939_,2483_2497_2564_2611_2680_2824_2826_2828_2934_2975_3159_3159_3317_3443_3487_
44,3,標示,N,1,1,2,,
44,3,投入,Vt,2,4,6,275_,2305_2308_2308_
44,3,代表,Vt,1,7,8,,2232_2445_2446_2744_3065_3067_
44,3,使用,Vt,12,33,45,44_226_230_439_551_560_734_750_756_758_1057_,2162_2190_2305_2308_2616_2651_2651_2654_2654_2718_2721_2754_2761_2761_2762_2762_2790_2869_2882_2916_2945_3035_3071_3072_3101_3132_3139_3253_3409_3427_3489_3491_
44,3,普遍,Vi,2,1,3,213_,
44,1,電控,N,2,0,2,44_,
44,1,日,N,3,0,3,67_74_,
44,3,敢,Vt,17,69,86,52_320_387_416_617_626_669_786_1010_1028_1088_1091_1197_1200_1217_1266_,2037_2058_2069_2072_2090_2094_2096_2124_2127_2131_2133_2180_2197_2211_2260_2289_2385_2483_2504_2527_2530_2544_2549_2549_2550_2550_2608_2707_2708_2742_2748_2766_2781_2799_2804_2806_2842_2843_2846_2864_2958_2976_3079_3084_3103_3107_3107_3112_3163_3170_3172_3174_3181_3193_3194_3243_3260_3289_3290_3294_3347_3415_3467_3470_3472_3480_3482_3485_
44,1,外籍,A,1,0,1,,
44,1,川日,N,1,0,1,,
44,3,展開,Vt,3,1,4,1319_1324_,
44,3,技術,N,3,3,6,390_1387_,2823_2825_
44,3,9日,N,7,6,13,631_1031_1072_1073_1079_1080_,2097_2827_2976_3044_3048_
44,3,正式,Vi,3,2,5,65_72_,2967_
44,3,相當,ADV,40,41,81,277_288_318_324_419_525_534_549_553_558_562_599_608_628_684_819_823_823_823_842_842_842_874_882_892_900_967_967_983_1081_1104_1238_1242_1246_1257_1350_1439_1444_1495_,2059_2237_2238_2249_2251_2270_2318_2319_2326_2372_2375_2390_2417_2434_2478_2523_2530_2564_2590_2764_2775_2798_2800_2829_2855_2856_2892_2893_2953_2973_3008_3043_3083_3085_3086_3240_3319_3373_3374_3400_
44,3,日本,N,4,7,11,44_51_1105_,2461_2867_2867_3246_3353_3355_
44,3,安裝,Vt,3,8,11,1142_1144_,2651_2654_2671_2671_2702_2702_2702_
44,3,知,Vt,21,48,69,109_162_162_167_167_275_394_546_555_699_779_917_938_1019_1061_1073_1080_1367_1371_1383_,2162_2162_2189_2234_2239_2376_2419_2445_2446_2452_2483_2521_2528_2544_2544_2579_2606_2651_2654_2669_2779_2847_2869_2916_2961_2963_2967_2983_2984_3153_3185_3205_3232_3232_3233_3239_3319_3319_3331_3331_3364_3385_3418_3423_3424_3433_3435_
44,3,結束,Vt,7,13,20,99_334_710_720_749_910_,2246_2411_2607_2674_2714_2769_2769_2770_2770_2867_2968_2968_
44,3,用,Vt,19,83,102,178_188_213_216_281_281_391_522_531_573_628_674_1016_1096_1257_1430_1481_1488_,2037_2038_2040_2051_2054_2099_2163_2183_2231_2252_2252_2253_2253_2272_2272_2368_2369_2445_2446_2604_2616_2649_2649_2680_2690_2746_2747_2761_2762_2768_2773_2775_2809_2815_2815_2845_2848_2848_2869_2892_2939_2940_2969_2970_2975_2977_3038_3039_3084_3084_3098_3106_3108_3109_3118_3119_3124_3146_3150_3160_3161_3174_3187_3189_3213_3218_3231_3246_3253_3253_3289_3290_3385_3385_3433_3435_3451_3456_3458_3463_3470_3477_
44,3,10日,N,8,11,19,109_334_515_516_1149_1156_1199_,2469_2510_2511_2608_3009_3010_3044_3048_3373_3374_
44,3,味道,N,61,93,154,91_91_91_92_94_175_227_227_237_245_255_374_410_433_481_522_531_570_579_582_583_771_775_795_798_802_827_838_870_878_887_889_895_897_913_917_967_982_982_1005_1021_1037_1037_1067_1074_1088_1091_1114_1124_1131_1149_1156_1228_1230_1333_1334_1409_1418_1473_1496_,2037_2037_2037_2037_2058_2061_2093_2126_2131_2133_2153_2161_2183_2190_2247_2266_2271_2272_2299_2302_2321_2335_2335_2340_2341_2344_2349_2358_2412_2483_2484_2517_2517_2519_2519_2587_2734_2742_2748_2766_2775_2782_2806_2807_2813_2863_2863_2863_2863_2863_2864_2864_2908_2939_2940_2952_2975_2995_3030_3032_3033_3071_3085_3087_3092_3120_3122_3125_3127_3174_3224_3253_3270_3319_3319_3326_3344_3344_3347_3349_3351_3383_3384_3397_3443_3443_3443_3443_3443_3452_3457_3477_
44,1,新型,N,1,0,1,,
44,3,可愛,Vi,4,3,7,674_710_720_,2097_3237_
44,3,開始,Vt,25,65,90,69_76_91_104_136_173_203_209_211_448_456_546_555_592_601_629_707_717_783_1197_1200_1272_1275_1353_,2023_2099_2162_2206_2211_2211_2260_2322_2354_2355_2517_2519_2527_2534_2534_2604_2604_2609_2609_2615_2639_2707_2708_2710_2710_2710_2712_2712_2712_2740_2748_2816_2818_2828_2861_2861_2867_2908_2908_2922_2933_2952_2967_2972_2976_3158_3159_3274_3289_3290_3341_3360_3397_3418_3418_3433_3433_3433_3435_3435_3435_3458_3471_3487_
44,1,龐大,Vi,1,0,1,,
44,3,熟練,Vi,4,2,6,68_75_1498_,3093_
44,3,生意,N,9,12,21,94_522_531_610_619_732_794_797_,2815_2939_2940_3202_3225_3228_3229_3294_3294_3383_3384_
44,3,廣告,N,7,18,25,466_681_682_1224_1226_1234_,2237_2238_2342_2467_2468_2502_2574_2681_2779_2865_2934_2965_2966_2979_3182_3183_3487_
44,3,老外,N,5,11,16,44_227_289_1207_,2598_2691_2698_2740_2746_2746_2746_3231_3392_3394_
44,1,烘乾,Vt,1,0,1,,
44,3,廣大,Vi,2,1,3,982_,
44,3,為什麼,ADV,12,53,65,428_481_593_602_766_806_872_880_901_1001_1428_,2006_2050_2053_2099_2104_2170_2183_2193_2211_2278_2376_2376_2416_2475_2544_2553_2691_2754_2754_2782_2827_2828_2852_2862_2872_2872_2889_2890_2902_2904_2909_2910_2953_3115_3153_3184_3246_3270_3315_3330_3331_3366_3371_3433_3433_3435_3435_3443_3458_3466_3470_3470_
44,3,功能,N,3,6,9,44_978_,2097_2702_2857_2858_3031_
45,3,睡覺,Vi,5,41,46,412_507_980_1431_,2029_2072_2148_2161_2175_2188_2192_2271_2273_2275_2327_2329_2512_2540_2549_2550_2636_2750_2773_2776_2816_2818_2848_2861_2863_2873_2889_2890_3164_3270_3278_3278_3281_3397_3433_3435_3470_3471_3473_3493_
45,3,噪聲,N,1,1,2,,
45,3,吵,Vi,32,106,138,66_73_156_246_247_256_257_341_408_412_697_986_1005_1054_1056_1243_1243_1247_1247_1278_1279_1285_1286_1328_1331_1356_1361_1418_1421_1463_1468_,2005_2076_2089_2136_2140_2151_2159_2162_2162_2181_2188_2211_2275_2299_2302_2304_2307_2312_2315_2324_2327_2329_2345_2350_2367_2368_2369_2390_2487_2488_2494_2495_2510_2511_2525_2535_2549_2550_2631_2634_2704_2714_2724_2740_2747_2766_2809_2855_2856_2869_2875_2889_2890_2908_2909_2910_2914_2922_2932_3031_3031_3032_3033_3038_3039_3040_3040_3046_3050_3084_3092_3098_3106_3113_3117_3152_3186_3187_3188_3189_3192_3228_3229_3231_3233_3311_3338_3341_3351_3351_3375_3376_3377_3378_3431_3431_3431_3432_3432_3432_3483_3485_3487_3495_3497_
45,3,自助餐,N,20,6,26,116_228_253_253_439_610_619_811_983_1005_1028_1033_1066_1081_1181_1187_1338_1490_1493_,2509_2731_2979_3360_3400_
45,3,晚上,N,133,260,393,79_81_85_87_148_148_162_163_167_168_184_186_194_196_214_215_220_229_231_234_238_239_246_248_249_253_256_258_283_335_338_341_373_386_408_419_427_442_460_484_493_522_531_550_551_559_560_565_574_584_607_630_634_636_638_660_670_670_685_690_697_714_724_738_783_784_786_794_794_794_797_797_797_872_875_880_883_889_897_901_902_910_921_923_931_939_957_958_973_979_980_986_990_993_1005_1005_1031_1040_1061_1082_1085_1087_1088_1091_1091_1201_1238_1242_1246_1254_1282_1289_1319_1324_1331_1332_1337_1339_1343_1345_1348_1348_1348_1348_1348_1352_1383_1431_1437_1457_1459_1464_,2009_2011_2013_2020_2021_2029_2033_2035_2037_2042_2048_2072_2072_2123_2128_2136_2140_2149_2153_2155_2159_2161_2161_2162_2162_2162_2162_2175_2175_2188_2192_2212_2258_2259_2269_2272_2275_2276_2276_2276_2281_2282_2289_2292_2309_2313_2316_2327_2329_2333_2334_2360_2361_2365_2383_2383_2383_2383_2387_2391_2406_2408_2419_2432_2432_2435_2435_2438_2440_2462_2487_2488_2494_2495_2505_2508_2512_2516_2517_2518_2519_2531_2531_2531_2535_2537_2538_2540_2549_2549_2550_2550_2557_2560_2561_2562_2567_2569_2576_2577_2579_2592_2594_2608_2625_2631_2636_2637_2638_2642_2646_2652_2655_2671_2683_2686_2690_2707_2708_2714_2725_2725_2746_2746_2753_2756_2773_2775_2776_2785_2790_2790_2795_2807_2816_2818_2822_2828_2849_2855_2856_2857_2858_2861_2861_2863_2867_2869_2872_2875_2881_2881_2882_2914_2916_2923_2928_2933_2939_2940_2946_2952_2958_2959_2959_2972_2973_2999_3007_3008_3012_3019_3029_3030_3032_3033_3034_3035_3040_3040_3040_3040_3044_3048_3063_3063_3071_3073_3083_3103_3103_3115_3118_3118_3133_3146_3164_3181_3187_3189_3195_3207_3213_3218_3223_3231_3231_3243_3246_3253_3257_3260_3264_3274_3277_3277_3281_3289_3290_3291_3292_3304_3308_3309_3318_3341_3341_3347_3360_3360_3360_3369_3370_3405_3410_3421_3425_3428_3431_3431_3431_3432_3432_3432_3433_3435_3443_3443_3444_3448_3453_3454_3458_3464_3471_3475_3478_3483_3493_
45,3,空調,N,62,156,218,146_161_166_171_229_229_229_280_280_308_312_338_379_380_383_390_427_520_529_554_563_573_631_636_638_674_710_711_720_721_820_825_825_886_891_894_899_1021_1040_1070_1077_1087_1087_1088_1088_1088_1088_1088_1091_1092_1183_1189_1217_1348_1348_1348_1352_1352_1375_1473_1496_,2006_2014_2020_2020_2030_2031_2033_2035_2042_2042_2042_2042_2057_2062_2103_2104_2153_2183_2183_2192_2247_2247_2273_2304_2307_2339_2343_2343_2398_2460_2461_2462_2467_2468_2477_2489_2505_2512_2517_2519_2528_2530_2531_2531_2534_2568_2594_2611_2630_2647_2647_2649_2703_2709_2711_2715_2716_2728_2729_2740_2743_2753_2756_2759_2759_2768_2793_2857_2858_2863_2867_2868_2888_2898_2900_2908_2914_2915_2922_2939_2940_2944_2946_2959_2971_2972_2976_2999_3007_3009_3009_3009_3010_3010_3010_3019_3034_3040_3040_3046_3050_3065_3067_3073_3077_3089_3105_3105_3117_3132_3133_3133_3158_3180_3180_3181_3187_3187_3189_3189_3194_3196_3196_3196_3196_3196_3202_3202_3208_3223_3252_3252_3270_3300_3303_3304_3304_3304_3327_3389_3390_3396_3397_3397_3397_3405_3410_3434_3436_3443_3443_3447_3466_3476_3484_
47,3,講,Vt,22,33,55,150_213_288_380_383_478_480_487_489_644_815_885_889_893_897_902_943_1032_1088_1410_1415_,2083_2126_2137_2137_2141_2141_2235_2236_2247_2264_2287_2288_2473_2554_2555_2582_2594_2621_2671_2700_2701_2717_2720_2739_2739_2771_3005_3223_3227_3315_3403_3408_
47,3,服務生,N,40,37,77,286_320_320_408_434_481_522_531_550_554_559_563_674_707_707_711_717_717_721_745_939_1054_1082_1093_1094_1106_1114_1148_1237_1238_1319_1324_1375_1376_1408_1413_1423_1440_1445_,2134_2134_2163_2163_2462_2500_2501_2505_2738_2775_2780_2869_2895_2946_2946_2968_2968_3083_3083_3083_3083_3083_3108_3109_3133_3147_3171_3173_3295_3298_3301_3331_3360_3360_3361_3362_
47,3,確認,Vt,10,47,57,186_186_196_196_408_460_593_602_1020_,2037_2225_2226_2360_2360_2360_2361_2361_2361_2391_2554_2555_2559_2629_2632_2633_2637_2637_2638_2638_2675_2677_2731_2739_2767_2767_2767_2767_2767_2828_2956_2957_3083_3146_3146_3227_3254_3254_3255_3255_3256_3256_3257_3296_3397_3470_
47,3,奢侈,Vi,1,1,2,,
47,1,拖延,Vt,1,0,1,,
47,3,定單,N,1,10,11,,2638_2671_2671_2671_2731_2731_3174_3294_3294_
47,3,意識,N,11,50,61,109_111_316_317_390_435_1103_1129_1136_1436_,2227_2312_2315_2322_2338_2359_2388_2500_2501_2566_2569_2608_2609_2609_2609_2630_2651_2651_2651_2654_2654_2654_2671_2731_2809_2816_2818_3032_3032_3033_3033_3052_3053_3121_3126_3133_3147_3225_3243_3246_3281_3397_3431_3431_3432_3432_3450_3455_3458_
47,3,偶,ADV,4,5,9,630_630_641_,2057_2273_3433_3435_
47,3,外,N,22,37,59,54_59_103_286_334_378_641_670_714_724_746_771_775_891_899_1005_1012_1015_1311_1315_1409_,2126_2277_2322_2359_2460_2461_2471_2510_2511_2530_2636_2691_2731_2750_2872_2908_3065_3067_3099_3111_3117_3139_3160_3180_3194_3197_3199_3253_3288_3319_3332_3371_3417_3423_3424_3486_
47,3,內部,N,12,23,35,100_176_595_604_628_1031_1100_1249_1439_1444_1473_,2060_2062_2113_2136_2140_2189_2388_2454_2455_2480_2637_2638_2662_2691_2840_2861_2896_2941_3003_3009_3010_3347_
47,3,時間,N,76,124,200,67_74_82_88_89_99_116_118_120_122_126_128_130_157_157_211_271_276_282_283_392_397_410_422_480_489_494_520_529_546_546_546_555_555_555_573_595_604_632_709_710_719_720_749_754_786_792_800_816_828_830_835_835_846_885_893_921_924_932_935_944_982_1025_1032_1054_1061_1100_1145_1203_1277_1284_1367_1428_1437_1465_,2081_2083_2136_2139_2140_2143_2159_2161_2164_2190_2211_2220_2222_2231_2232_2244_2245_2252_2253_2258_2259_2266_2267_2273_2287_2288_2292_2324_2326_2338_2353_2359_2360_2361_2372_2375_2377_2392_2450_2453_2471_2483_2486_2494_2495_2498_2516_2518_2544_2547_2554_2555_2576_2582_2589_2590_2596_2597_2604_2607_2616_2667_2671_2674_2684_2687_2700_2701_2707_2708_2710_2712_2766_2775_2775_2834_2844_2845_2846_2857_2858_2889_2890_2919_2923_2924_2928_2945_2968_2970_2981_2982_3001_3012_3037_3049_3049_3049_3083_3083_3099_3103_3118_3132_3146_3146_3159_3163_3184_3213_3218_3231_3246_3296_3316_3316_3319_3339_3341_3341_3470_3477_3483_
47,3,自助,Vi,7,10,17,180_190_234_334_684_1362_,2232_2426_2769_2770_3011_3011_3012_3260_3419_
47,3,東東,N,1,4,5,,2794_2998_3277_
48,3,燒水,Vi,1,8,9,,2053_2198_2387_3103_3433_3435_3477_
48,3,對面,N,39,34,73,103_163_165_168_170_176_176_239_249_272_288_340_373_375_378_412_413_418_543_546_555_669_822_869_877_901_913_990_993_1141_1143_1151_1158_1243_1247_1267_1316_1321_,2126_2168_2211_2235_2236_2432_2435_2525_2699_2714_2827_2851_2892_2892_2988_3040_3091_3137_3252_3277_3326_3375_3376_3377_3378_3392_3394_3475_3475_3480_3482_3487_3487_
48,3,含,Vt,12,15,27,287_290_373_483_492_677_753_942_957_1201_1437_,2414_2421_2615_2623_2707_2708_2735_2736_2986_3162_3252_3363_3376_3378_
48,3,偏,ADV,46,35,81,142_158_198_203_209_275_344_350_354_360_420_422_423_505_751_752_784_790_790_821_839_847_885_887_893_895_917_942_954_964_1012_1014_1015_1015_1142_1144_1155_1162_1186_1192_1204_1214_1331_1418_1473_,2112_2179_2206_2281_2282_2426_2598_2623_2656_2766_2772_2779_2794_2795_2815_2831_2832_2835_2929_2941_3032_3033_3089_3090_3099_3175_3176_3182_3183_3209_3311_3319_3319_3364_
48,3,衛生,N,36,58,94,51_51_51_79_85_100_106_173_239_249_326_331_339_339_379_415_470_474_641_660_699_740_892_900_912_912_913_983_1070_1077_1145_1350_1386_1429_1431_,2140_2161_2184_2258_2258_2259_2259_2296_2310_2311_2378_2380_2413_2442_2460_2461_2544_2636_2647_2713_2714_2740_2766_2781_2784_2816_2818_2865_2882_2883_2896_2976_2978_2978_2988_2995_3011_3114_3121_3126_3129_3129_3129_3130_3130_3130_3137_3159_3174_3203_3257_3266_3277_3293_3305_3310_3443_
48,1,尚佳,Vi,1,0,1,,
48,1,早餐店,N,1,0,1,,
48,3,顯得,Vt,16,12,28,57_62_65_72_116_630_749_842_888_896_1059_1236_1244_1248_1499_,2139_2143_2171_2246_2544_2549_2550_2556_2619_2620_2946_
48,3,地理,N,117,36,153,50_51_67_74_91_94_104_149_176_204_210_226_244_254_264_265_267_275_275_276_279_284_364_369_391_391_393_405_413_507_512_520_524_526_529_533_535_546_552_555_561_599_608_629_630_630_642_659_668_686_691_735_752_764_808_826_828_874_875_882_883_892_900_904_915_921_942_947_954_957_990_993_1023_1024_1081_1092_1093_1094_1124_1129_1131_1136_1139_1154_1161_1173_1180_1199_1224_1226_1231_1241_1245_1259_1261_1311_1315_1332_1335_1336_1344_1345_1348_1351_1374_1376_1377_1378_1385_1393_1402_1431_1463_1468_1496_1498_,2104_2159_2175_2177_2179_2235_2236_2400_2402_2450_2453_2541_2587_2607_2671_2671_2702_2714_2781_2792_2805_2822_2838_2844_2846_3012_3012_3059_3108_3109_3148_3360_3422_3423_3424_
48,3,還好,Vi,25,33,58,93_101_338_373_408_466_494_522_531_587_589_594_603_672_676_761_779_826_885_893_1003_1005_1146_1496_,2137_2141_2260_2264_2326_2337_2389_2392_2397_2483_2549_2550_2576_2586_2649_2662_2756_2892_2928_2995_3044_3048_3065_3067_3108_3109_3213_3218_3312_3454_3459_3487_
48,3,而言,Vt,7,5,12,275_527_536_971_1023_1371_,2161_2548_2584_2634_
48,3,不能,ADV,53,220,273,50_103_103_116_118_126_153_173_173_178_188_213_219_238_277_308_312_340_364_369_374_429_445_453_628_697_700_748_756_758_783_784_820_835_855_864_888_896_905_939_948_988_990_993_1018_1073_1080_1086_1237_1366_1423_1496_,2024_2036_2038_2040_2042_2047_2047_2048_2048_2051_2051_2054_2054_2059_2084_2085_2095_2095_2095_2097_2097_2097_2099_2099_2099_2101_2101_2101_2102_2102_2102_2104_2124_2126_2149_2149_2162_2168_2169_2180_2180_2183_2190_2193_2193_2193_2225_2226_2228_2229_2231_2232_2232_2232_2241_2252_2253_2267_2267_2273_2280_2291_2305_2308_2318_2319_2325_2342_2356_2360_2360_2360_2361_2361_2361_2363_2367_2368_2369_2405_2405_2407_2407_2425_2428_2447_2480_2483_2503_2515_2517_2519_2527_2541_2551_2552_2576_2582_2582_2594_2606_2611_2616_2629_2630_2630_2636_2648_2650_2651_2653_2654_2665_2702_2717_2720_2724_2731_2734_2761_2762_2764_2768_2769_2770_2840_2869_2906_2919_2919_2919_2919_2934_2945_2969_2970_3012_3014_3035_3044_3048_3049_3069_3070_3072_3074_3077_3105_3115_3115_3118_3118_3119_3124_3132_3132_3133_3141_3146_3147_3150_3151_3158_3174_3175_3176_3184_3184_3186_3188_3193_3196_3204_3205_3210_3215_3231_3246_3272_3274_3282_3288_3289_3290_3327_3327_3330_3330_3341_3347_3363_3388_3397_3397_3397_3401_3406_3411_3414_3431_3431_3432_3432_3433_3433_3433_3435_3435_3435_3443_3448_3453_3458_3470_3472_3487_3487_3495_3497_
48,3,住客,N,11,26,37,161_166_245_253_255_521_530_610_619_1500_,2016_2106_2232_2291_2291_2436_2436_2530_2609_2862_3001_3069_3069_3069_3070_3070_3070_3076_3111_3119_3124_3132_3352_3354_3446_
49,3,不少,Vi,4,4,8,186_196_423_,2844_3119_3124_
49,3,地段,N,19,21,40,54_59_67_74_218_275_278_430_515_741_790_833_916_1039_1241_1245_1375_1450_,2012_2099_2339_2343_2436_2484_2537_2538_2541_2627_2779_2889_2890_3078_3267_3311_3376_3378_3413_3437_
49,1,中價位,N,1,0,1,,
49,3,繁華,Vi,21,9,30,67_74_118_126_381_384_422_677_747_787_1005_1141_1141_1143_1143_1204_1241_1245_1442_1447_,2445_2446_2541_2647_2925_3088_3267_3483_
49,3,適中,Vi,11,3,14,246_256_414_641_735_851_853_860_862_1261_,3223_3273_
50,3,上,N,158,326,484,52_52_68_75_100_103_109_162_162_162_167_167_167_173_186_196_214_239_239_241_242_242_249_249_251_252_252_276_277_278_281_316_316_320_320_326_331_391_396_431_480_489_501_521_526_530_535_540_546_555_567_576_599_608_629_629_629_630_657_669_677_683_686_691_703_705_707_707_710_714_717_717_720_724_745_783_783_783_785_787_793_795_796_798_822_828_835_837_851_854_858_860_863_867_872_876_880_884_886_886_890_894_894_898_910_962_964_983_1005_1005_1054_1057_1061_1062_1066_1086_1087_1091_1093_1094_1125_1132_1149_1156_1169_1176_1195_1198_1208_1211_1220_1222_1231_1232_1309_1311_1313_1315_1408_1408_1413_1413_1418_1421_1423_1423_1423_1423_1452_1469_1470_1473_1481_1488_1489_1492_1500_,2012_2012_2012_2012_2029_2037_2037_2038_2040_2048_2069_2069_2086_2086_2089_2093_2098_2108_2134_2135_2139_2139_2143_2143_2144_2145_2151_2161_2162_2164_2165_2170_2190_2190_2196_2196_2197_2204_2209_2210_2220_2222_2229_2231_2231_2232_2232_2235_2236_2247_2252_2252_2252_2253_2253_2253_2260_2272_2272_2279_2290_2290_2309_2342_2342_2360_2361_2362_2372_2375_2380_2381_2384_2388_2391_2391_2392_2414_2416_2419_2419_2421_2425_2426_2428_2444_2445_2446_2452_2454_2455_2476_2483_2492_2493_2494_2495_2500_2501_2502_2502_2505_2517_2519_2521_2521_2528_2531_2541_2541_2544_2549_2549_2550_2550_2553_2567_2571_2572_2584_2593_2594_2601_2608_2609_2609_2647_2649_2652_2655_2674_2683_2684_2686_2687_2698_2702_2714_2718_2718_2718_2718_2721_2721_2721_2721_2723_2730_2731_2731_2742_2744_2748_2756_2756_2756_2764_2767_2769_2769_2770_2770_2775_2794_2816_2818_2828_2834_2838_2840_2841_2846_2852_2861_2861_2861_2882_2888_2899_2902_2904_2908_2932_2933_2933_2933_2934_2945_2946_2946_2951_2953_2953_2954_2961_2963_2976_2976_2976_3014_3022_3023_3035_3040_3042_3047_3049_3051_3055_3059_3069_3070_3076_3076_3076_3076_3076_3076_3083_3083_3099_3099_3101_3103_3103_3103_3103_3115_3129_3130_3133_3137_3150_3163_3163_3174_3178_3184_3186_3188_3193_3204_3205_3205_3213_3218_3231_3235_3239_3239_3239_3245_3246_3246_3246_3253_3255_3255_3256_3256_3260_3260_3261_3274_3289_3289_3290_3290_3294_3296_3315_3319_3319_3319_3319_3319_3319_3327_3327_3331_3335_3339_3357_3363_3371_3385_3388_3392_3394_3397_3409_3409_3415_3418_3418_3419_3431_3431_3431_3431_3431_3431_3431_3431_3432_3432_3432_3432_3432_3432_3432_3432_3437_3443_3451_3454_3456_3458_3471_3478_3483_3485_3487_3492_3493_
50,3,舊,Vi,93,147,240,52_54_59_82_88_109_118_126_133_139_246_256_342_352_389_400_410_483_492_507_518_540_553_562_566_575_584_585_594_600_603_609_610_619_631_635_637_669_670_676_679_680_683_739_744_749_762_764_765_767_768_801_808_831_843_1020_1039_1058_1059_1072_1072_1073_1079_1079_1080_1092_1098_1104_1108_1109_1111_1116_1117_1119_1163_1165_1236_1238_1263_1264_1267_1270_1270_1273_1273_1276_1283_1304_1307_1328_1362_1429_,2019_2036_2037_2037_2038_2038_2040_2040_2056_2059_2066_2068_2076_2105_2122_2136_2140_2153_2153_2154_2154_2171_2181_2199_2200_2215_2219_2219_2221_2221_2227_2261_2263_2274_2275_2304_2305_2307_2308_2313_2316_2318_2319_2338_2343_2345_2350_2356_2378_2392_2392_2392_2399_2400_2401_2402_2418_2432_2435_2439_2450_2453_2489_2491_2517_2519_2564_2565_2574_2578_2578_2610_2641_2645_2662_2735_2736_2745_2763_2767_2773_2773_2785_2810_2811_2813_2815_2815_2827_2850_2855_2856_2857_2858_2864_2868_2876_2892_2892_2892_2896_2897_2913_2922_2927_2938_2938_2941_2969_2980_2995_3029_3078_3091_3094_3097_3108_3109_3151_3164_3201_3205_3214_3219_3223_3223_3236_3249_3249_3293_3318_3318_3319_3327_3333_3356_3358_3363_3423_3424_3433_3435_3454_3458_3459_3477_
50,3,夜景,N,10,2,12,51_69_76_374_710_720_835_1172_1179_,2092_
50,3,邊,N,53,72,125,50_52_107_186_186_196_196_239_239_249_249_374_393_394_431_433_567_576_670_677_749_749_783_785_804_823_828_854_857_863_866_875_875_883_883_886_894_948_948_948_962_1005_1093_1094_1261_1304_1307_1328_1332_1408_1413_1473_,2016_2050_2053_2139_2143_2163_2164_2165_2196_2313_2316_2324_2394_2394_2604_2604_2659_2671_2691_2714_2730_2769_2770_2838_2841_2861_2879_2880_2917_2919_2919_2922_2975_3046_3046_3050_3050_3089_3089_3111_3119_3121_3124_3126_3163_3204_3235_3246_3246_3254_3295_3310_3319_3319_3347_3347_3371_3405_3409_3410_3418_3419_3422_3431_3432_3437_3443_3448_3453_3487_3493_
50,3,錢,N,39,125,164,152_248_258_364_369_388_439_520_529_612_621_649_655_701_730_806_835_835_842_886_886_886_886_894_894_894_894_974_1086_1096_1124_1131_1242_1242_1246_1246_1450_1495_,2057_2081_2081_2083_2083_2095_2097_2099_2099_2104_2104_2124_2139_2143_2162_2208_2232_2232_2232_2244_2245_2252_2252_2253_2253_2272_2272_2272_2354_2355_2360_2360_2360_2361_2361_2361_2393_2399_2401_2419_2460_2461_2480_2480_2493_2530_2549_2549_2549_2549_2549_2549_2549_2550_2550_2550_2550_2550_2550_2550_2573_2604_2606_2615_2626_2649_2680_2690_2745_2746_2746_2746_2775_2775_2797_2797_2812_2846_2847_2867_2893_2893_2893_2967_3013_3016_3016_3032_3033_3074_3083_3084_3115_3146_3146_3159_3159_3232_3236_3236_3246_3253_3254_3262_3263_3294_3296_3308_3313_3320_3329_3333_3361_3362_3397_3397_3399_3399_3438_3458_3471_3478_3478_3487_
50,3,中山,N,6,4,10,50_52_91_512_669_,2361_2754_2754_
50,3,景區,N,7,2,9,386_389_465_465_525_534_,2509_
50,1,美麗,Vi,9,0,9,51_242_252_379_669_780_828_1371_,
50,3,11樓,N,1,2,3,,2428_
50,3,多元,A,1,2,3,,2518_
50,3,廣場,N,35,10,45,50_52_248_258_482_491_567_571_576_580_649_655_668_669_782_801_815_821_828_828_844_849_901_1005_1005_1070_1077_1140_1326_1326_1459_1463_1464_1468_,2253_2797_2797_2809_3074_3074_3372_3448_3453_
51,1,購物區,N,3,0,3,164_169_,
51,3,直達,Vt,9,1,10,239_249_783_833_849_923_931_1054_,
51,1,視野,N,7,0,7,273_419_482_491_641_663_,
51,3,一,ADV,61,152,213,109_111_119_127_241_248_251_258_323_328_333_390_470_474_481_528_537_550_559_592_601_672_702_708_711_718_721_734_738_783_787_872_876_880_884_887_889_891_895_897_899_990_993_1007_1020_1020_1020_1020_1020_1026_1082_1108_1112_1114_1115_1116_1120_1320_1325_1327_,2037_2038_2040_2057_2090_2099_2124_2148_2162_2162_2162_2162_2162_2162_2163_2163_2165_2170_2175_2183_2211_2232_2247_2264_2264_2272_2272_2272_2272_2287_2288_2289_2309_2356_2360_2361_2380_2381_2400_2400_2402_2402_2425_2425_2428_2428_2445_2446_2450_2453_2454_2455_2475_2509_2516_2518_2521_2521_2527_2531_2565_2565_2585_2604_2604_2606_2608_2608_2637_2637_2638_2638_2639_2703_2718_2721_2744_2744_2744_2746_2754_2784_2828_2828_2863_2866_2872_2872_2925_2928_2945_2946_2954_2976_2976_2987_3032_3033_3038_3039_3040_3040_3069_3070_3076_3076_3083_3083_3083_3103_3103_3111_3182_3183_3185_3195_3210_3212_3215_3217_3227_3233_3271_3288_3304_3310_3318_3344_3351_3351_3360_3363_3376_3378_3379_3382_3389_3390_3391_3393_3431_3432_3434_3436_3443_3446_3448_3453_3458_3463_3463_
51,3,得到,Vt,9,26,35,52_341_592_593_601_602_841_1471_,2287_2288_2290_2432_2435_2494_2495_2522_2575_2584_2671_2747_2759_2764_2812_2836_2946_2999_3083_3083_3133_3231_3253_3267_3470_
51,3,友好,Vi,5,4,9,395_707_717_828_,2674_3345_3483_
51,3,人員,N,113,152,265,64_71_81_81_87_87_119_127_151_182_182_183_192_192_193_217_222_273_275_317_336_364_369_372_377_381_384_386_409_410_414_434_504_514_514_523_532_546_555_589_617_617_626_626_628_628_630_630_663_665_665_668_710_720_733_743_745_748_756_758_773_777_802_802_814_819_875_883_886_889_894_897_928_934_934_936_960_983_1008_1013_1042_1057_1061_1061_1093_1094_1114_1142_1144_1151_1155_1158_1162_1207_1208_1212_1212_1236_1250_1290_1359_1359_1364_1364_1383_1387_1394_1396_1403_1405_1430_1430_,2037_2038_2040_2050_2053_2081_2081_2083_2083_2089_2108_2134_2136_2136_2140_2140_2159_2159_2161_2168_2174_2189_2209_2210_2229_2273_2273_2273_2305_2308_2309_2322_2327_2329_2333_2334_2359_2359_2359_2388_2390_2391_2439_2444_2444_2450_2453_2463_2465_2485_2510_2511_2517_2519_2528_2530_2530_2532_2533_2587_2587_2608_2609_2609_2609_2635_2637_2638_2651_2651_2654_2654_2671_2671_2671_2731_2731_2731_2731_2743_2767_2767_2779_2782_2782_2837_2846_2861_2861_2917_2917_2945_2945_2946_2950_2974_2996_3007_3032_3033_3034_3054_3056_3076_3098_3105_3107_3108_3109_3132_3146_3146_3149_3161_3163_3163_3163_3210_3215_3225_3226_3254_3257_3281_3288_3312_3415_3419_3423_3424_3434_3436_3438_3448_3448_3448_3448_3453_3453_3453_3453_3466_3468_3468_3470_3470_3470_3470_3478_3487_3487_
51,3,在意,Vt,3,5,8,710_720_,2816_2818_2818_3110_
51,3,打掃,Vt,24,36,60,173_263_316_379_699_743_799_886_889_894_897_912_912_912_995_995_996_996_1072_1073_1079_1080_1145_,2011_2011_2011_2134_2241_2247_2528_2540_2541_2740_2753_2767_2961_2963_2975_2987_2987_2987_2988_2988_3013_3040_3040_3201_3207_3210_3215_3266_3296_3388_3388_3388_3462_3483_3483_
51,3,過,Vt,32,50,82,90_118_126_140_278_308_312_320_341_410_517_711_721_738_787_795_798_815_887_889_895_897_902_1091_1124_1131_1139_1277_1284_1311_1315_,2005_2095_2097_2099_2186_2225_2226_2272_2287_2287_2287_2288_2288_2288_2289_2299_2302_2333_2334_2384_2452_2492_2494_2495_2531_2534_2587_2604_2690_2740_2740_2742_2746_2775_2785_2861_2946_2981_2982_3103_3184_3333_3433_3433_3433_3435_3435_3435_3470_
51,3,熱情,Vi,97,32,129,52_68_75_81_87_103_105_106_155_178_186_188_196_204_210_217_226_286_337_338_340_341_373_386_438_470_474_482_491_512_514_522_523_531_532_629_631_634_634_672_709_714_719_724_765_787_793_796_799_801_912_912_924_932_943_944_949_960_966_974_983_1008_1013_1048_1057_1057_1059_1085_1093_1094_1103_1114_1149_1156_1208_1211_1211_1212_1213_1252_1302_1305_1311_1315_1341_1375_1376_1383_1386_1388_1419_1423_1459_1462_1464_1467_,2161_2167_2231_2231_2397_2416_2460_2461_2492_2609_2642_2646_2793_2815_2815_2907_2933_2960_2962_3108_3109_3149_3153_3225_3324_3331_3360_3360_3380_3480_3482_
51,1,博覽,Vt,1,0,1,,
51,3,值得,Vi,62,34,96,111_141_246_256_279_318_335_391_422_430_440_470_474_528_537_546_546_550_550_555_555_559_559_708_718_734_738_738_739_768_856_865_940_976_1004_1020_1033_1041_1092_1105_1108_1116_1139_1149_1156_1217_1244_1248_1282_1289_1309_1313_1320_1325_1326_1327_1335_1451_1475_1482_1495_,2221_2318_2319_2323_2346_2351_2389_2504_2517_2519_2616_2651_2654_2671_2671_2750_2775_2784_2861_3046_3050_3118_3154_3155_3192_3197_3199_3318_3323_3327_3365_3389_3390_
51,3,今年,N,7,5,12,217_240_250_856_865_1251_,2616_2995_3013_3277_
51,3,提,Vt,34,37,71,155_162_167_186_196_339_341_391_470_474_521_522_530_531_546_550_555_559_610_619_707_717_956_1020_1054_1108_1116_1139_1211_1281_1288_1320_1325_,2040_2165_2206_2338_2390_2544_2553_2553_2698_2714_2744_2753_2828_2946_3014_3083_3149_3168_3169_3184_3184_3194_3244_3282_3282_3318_3331_3388_3389_3390_3392_3394_3409_3412_3463_3464_
51,3,公交車,N,13,8,21,103_145_204_210_239_249_270_669_819_964_1430_1437_,2143_2163_3038_3039_3185_3213_3218_
51,3,8月,N,36,39,75,213_316_365_370_434_435_436_711_721_885_893_944_977_983_983_1028_1029_1029_1030_1142_1142_1144_1144_1149_1150_1156_1157_1167_1168_1174_1175_1208_1309_1313_1437_,2037_2114_2117_2193_2225_2226_2231_2258_2259_2295_2386_2450_2450_2453_2453_2530_2547_2582_2582_2589_2647_2740_2798_2800_2840_2923_2924_2924_3049_3163_3205_3222_3316_3333_3383_3384_3418_3483_
51,3,解決,Vt,22,39,61,111_217_242_245_252_255_289_434_505_628_779_784_973_1042_1139_1242_1246_1337_1455_1469_1470_,2097_2223_2231_2252_2253_2372_2372_2375_2375_2391_2483_2589_2650_2653_2671_2671_2710_2712_2744_2796_2823_2825_2946_3049_3103_3149_3165_3196_3202_3227_3288_3316_3341_3349_3421_3431_3432_3470_
51,3,以前,N,31,30,61,53_58_294_302_428_494_495_495_518_518_518_582_583_747_788_842_913_940_976_1009_1045_1057_1124_1131_1195_1198_1205_1399_1399_1423_,2360_2361_2541_2599_2618_2621_2621_2621_2651_2654_2745_2816_2816_2818_2818_2852_2882_2883_2925_3038_3039_3049_3049_3083_3105_3226_3388_3413_3458_
51,3,決定,Vt,9,16,25,155_187_197_438_610_619_710_720_,2450_2453_2528_2549_2550_2641_2645_2975_2976_3083_3253_3319_3319_3448_3453_
51,3,重要,Vi,13,11,24,56_61_89_482_491_526_535_628_630_793_796_1015_,2195_2517_2519_2636_3037_3228_3229_3319_3371_3458_
51,3,24日,N,6,10,16,115_891_899_1020_1429_,2361_2737_3049_3084_3232_3327_3448_3453_3454_
51,3,討厭,Vt,2,3,5,1496_,2708_2775_
52,1,前端,N,2,0,2,52_,
52,3,裡,N,119,250,369,68_75_109_114_117_118_125_126_162_162_162_162_163_163_167_167_167_167_168_168_204_210_213_219_231_245_248_253_255_258_281_298_306_316_320_336_345_355_391_409_419_482_491_499_545_599_608_616_625_628_630_630_630_669_670_701_707_710_710_714_714_717_720_720_724_724_736_738_745_749_779_783_783_783_813_817_842_851_860_889_889_889_889_889_897_897_897_897_897_906_924_932_966_974_978_980_982_1020_1052_1081_1091_1113_1121_1270_1273_1398_1398_1407_1407_1409_1430_1442_1442_1447_1447_1450_1456_1456_,2014_2037_2037_2037_2037_2038_2040_2051_2054_2066_2069_2077_2090_2094_2096_2104_2126_2126_2149_2153_2163_2170_2175_2190_2196_2231_2231_2231_2231_2235_2235_2236_2236_2246_2246_2258_2259_2266_2266_2271_2271_2272_2272_2272_2276_2294_2298_2301_2305_2308_2323_2326_2333_2334_2335_2340_2341_2359_2367_2382_2382_2385_2390_2391_2391_2394_2395_2419_2444_2445_2446_2487_2488_2492_2497_2498_2500_2501_2505_2509_2510_2511_2526_2531_2532_2533_2543_2544_2544_2544_2544_2574_2574_2578_2579_2585_2595_2599_2607_2616_2636_2649_2656_2669_2671_2681_2683_2683_2686_2686_2695_2698_2705_2706_2710_2712_2730_2740_2740_2743_2746_2750_2750_2753_2753_2756_2766_2769_2770_2772_2783_2791_2806_2807_2809_2809_2841_2861_2874_2889_2890_2898_2914_2915_2923_2923_2925_2931_2933_2939_2939_2939_2940_2940_2940_2946_2946_2946_2948_2975_2976_2987_2987_3013_3022_3023_3032_3032_3033_3033_3071_3072_3074_3074_3074_3091_3095_3132_3132_3132_3141_3177_3184_3186_3187_3188_3189_3194_3222_3234_3245_3246_3246_3254_3254_3267_3278_3289_3290_3293_3293_3319_3319_3321_3322_3324_3326_3327_3331_3331_3333_3333_3341_3347_3347_3358_3376_3376_3378_3378_3385_3385_3389_3390_3392_3394_3396_3397_3419_3422_3431_3432_3433_3434_3435_3436_3443_3451_3452_3456_3457_3473_3473_3478_3480_3482_3484_3488_3490_
52,1,細緻,Vi,8,0,8,372_514_515_634_714_724_1497_,
52,3,中午,N,14,32,46,122_130_546_546_555_555_610_619_672_684_990_993_1096_,2081_2083_2252_2253_2287_2288_2353_2483_2531_2576_2604_2609_2640_2700_2701_2753_2838_2872_2873_2981_2982_3001_3008_3205_3253_3308_3308_3316_3419_3462_3483_
52,3,費,Vt,13,17,30,275_401_522_524_531_533_670_670_801_1336_1491_1494_,2069_2206_2549_2549_2550_2550_2607_2616_2616_2688_2730_2731_2787_2789_2947_3083_
52,3,不應該,ADV,4,5,9,327_332_428_,2445_2446_2536_3313_
52,3,後來,N,50,134,184,183_186_186_193_196_196_238_437_448_456_461_481_669_687_692_710_710_710_714_720_720_720_724_784_788_872_880_885_888_889_893_896_897_912_1005_1089_1270_1272_1273_1275_1319_1324_1352_1353_1421_1425_1469_1470_1498_,2020_2065_2069_2090_2090_2134_2135_2139_2143_2155_2225_2226_2229_2231_2244_2244_2245_2245_2258_2259_2260_2264_2269_2287_2287_2288_2288_2290_2360_2360_2361_2361_2363_2372_2375_2378_2387_2387_2450_2453_2457_2457_2483_2505_2521_2525_2525_2544_2549_2549_2549_2550_2550_2550_2557_2604_2604_2606_2637_2638_2639_2707_2708_2718_2718_2721_2721_2731_2740_2746_2750_2753_2771_2816_2818_2823_2825_2828_2861_2861_2863_2881_2902_2904_2909_2910_2928_2964_2970_2993_2994_2995_3013_3038_3038_3039_3039_3065_3067_3099_3160_3184_3184_3184_3184_3184_3184_3184_3227_3231_3241_3289_3290_3308_3318_3319_3319_3319_3319_3319_3324_3329_3341_3360_3360_3360_3388_3458_3470_3471_3476_3488_3490_
52,3,令,Vt,26,51,77,239_249_585_710_711_711_720_721_721_740_749_749_801_842_924_932_982_1045_1101_1127_1134_1211_1334_1472_1472_,2161_2195_2195_2252_2252_2253_2253_2258_2259_2289_2335_2388_2417_2516_2516_2518_2518_2531_2548_2552_2603_2605_2616_2662_2683_2683_2686_2686_2700_2700_2701_2701_2776_2791_2791_2951_2951_2960_2962_2978_2986_3014_3062_3116_3223_3233_3272_3345_3397_3443_
52,3,打電話,Vi,36,146,182,151_153_186_196_203_209_238_248_258_320_321_434_434_481_521_530_736_740_814_887_895_1049_1061_1106_1232_1232_1257_1272_1275_1319_1324_1343_1431_1477_1484_,2043_2045_2081_2081_2083_2083_2104_2134_2161_2205_2225_2226_2228_2229_2229_2231_2252_2253_2269_2287_2287_2288_2288_2309_2326_2360_2360_2360_2361_2361_2361_2387_2389_2390_2391_2450_2453_2483_2483_2494_2495_2508_2510_2511_2526_2527_2527_2534_2554_2555_2573_2579_2587_2604_2604_2604_2632_2633_2637_2638_2657_2671_2675_2677_2731_2739_2746_2754_2759_2759_2767_2775_2795_2796_2802_2807_2809_2812_2815_2828_2862_2869_2881_2889_2890_2902_2902_2904_2904_2972_3002_3038_3039_3052_3053_3055_3083_3103_3110_3113_3150_3159_3160_3184_3185_3185_3194_3196_3205_3227_3231_3253_3254_3255_3256_3257_3264_3264_3268_3289_3289_3289_3290_3290_3290_3291_3292_3308_3316_3319_3319_3333_3333_3337_3349_3360_3386_3386_3431_3432_3443_3473_3487_3495_3497_
52,1,絡腮鬍,N,1,0,1,,
52,3,鑰匙,N,7,15,22,540_1062_1062_1408_1413_1474_,2134_2139_2143_2148_2232_2714_2958_2968_2968_3213_3218_3243_3433_3435_
52,3,喝,Vt,13,18,31,78_79_84_85_145_186_196_335_395_785_821_1437_,2050_2053_2188_2360_2361_2551_2551_2552_2596_2597_2951_3038_3039_3103_3103_3360_3400_
52,3,問,Vt,50,174,224,52_112_112_148_229_238_238_320_320_363_368_379_390_423_546_555_635_637_702_710_720_793_796_837_837_871_871_871_879_879_879_887_889_895_897_902_903_912_938_943_1020_1054_1102_1259_1272_1275_1319_1324_1348_,2040_2043_2045_2047_2099_2099_2126_2126_2134_2134_2139_2143_2151_2151_2151_2155_2170_2183_2183_2186_2189_2231_2247_2289_2291_2294_2309_2322_2342_2342_2360_2360_2360_2360_2360_2361_2361_2361_2361_2361_2372_2375_2377_2387_2445_2446_2450_2453_2483_2497_2517_2519_2529_2531_2534_2549_2550_2565_2565_2567_2573_2594_2596_2597_2611_2630_2671_2671_2691_2691_2707_2708_2742_2742_2744_2746_2746_2746_2746_2746_2747_2754_2759_2767_2773_2773_2782_2784_2784_2795_2816_2818_2824_2826_2848_2889_2889_2890_2890_2925_2933_2933_2946_3013_3013_3031_3049_3073_3074_3095_3103_3108_3109_3110_3115_3115_3115_3119_3124_3159_3184_3184_3184_3184_3185_3186_3188_3195_3207_3233_3234_3243_3243_3243_3243_3246_3254_3254_3267_3281_3286_3288_3289_3289_3290_3290_3331_3331_3363_3397_3431_3432_3433_3433_3433_3433_3433_3433_3433_3433_3435_3435_3435_3435_3435_3435_3435_3435_3443_3447_3451_3456_3460_
52,3,答覆,N,4,29,33,276_335_1025_,2045_2055_2104_2191_2353_2391_2494_2495_2582_2773_2812_2816_2818_2999_3049_3083_3083_3105_3132_3133_3241_3286_3329_3433_3433_3435_3435_3470_
52,3,沖洗,Vt,1,5,6,,2928_3117_3433_3435_
52,3,那樣,Vi,7,9,16,173_783_842_1319_1324_1423_,2610_2681_2926_3049_3363_3363_3363_3364_
52,3,坐,Vi,61,34,95,78_84_89_103_107_521_530_641_670_670_677_783_783_786_790_792_793_796_815_818_835_842_842_849_856_865_886_886_887_887_888_888_888_889_889_894_894_895_895_896_896_896_897_897_901_910_916_916_922_930_935_943_1007_1007_1016_1151_1158_1243_1247_1430_,2162_2180_2180_2283_2298_2301_2434_2450_2453_2649_2688_2717_2718_2718_2720_2721_2721_2861_2861_2881_2881_2892_3013_3013_3103_3185_3185_3185_3213_3218_3224_3254_3295_
52,3,嚇,Vt,4,8,12,1243_1247_1425_,2148_2272_2812_2861_3212_3217_3344_
52,3,第二天,N,16,37,53,186_196_248_258_363_368_521_530_546_555_677_707_717_939_980_,2039_2041_2134_2161_2211_2233_2353_2445_2446_2549_2550_2625_2669_2671_2791_2872_2881_2987_3020_3044_3048_3083_3099_3099_3175_3176_3180_3210_3215_3243_3246_3253_3264_3319_3472_3483_
52,3,下樓,Vi,15,14,29,162_167_783_886_887_894_895_921_923_931_935_999_1410_1415_,2083_2700_2701_2724_2828_2828_2861_2873_3186_3188_3339_3360_3473_
52,1,垂下來,Vi,1,0,1,,
52,3,市中心,N,54,10,64,67_74_81_87_91_117_123_125_131_139_148_150_155_159_165_170_185_195_216_228_288_315_336_338_420_480_489_525_534_567_576_587_629_679_780_858_867_919_958_1029_1082_1151_1158_1167_1174_1204_1208_1235_1259_1329_1330_1369_1419_,2058_2139_2143_2198_2821_3074_3148_3333_3399_
52,3,洗澡水,N,2,17,19,1423_,2117_2490_2492_2525_2702_2773_2828_2958_2971_2974_2983_2984_3295_3376_3378_3444_
52,3,可,ADV,59,122,181,113_172_181_191_213_225_227_239_249_275_326_331_418_467_477_481_486_520_521_529_530_568_577_646_652_711_721_736_743_783_793_796_876_884_889_890_897_898_902_906_948_1016_1037_1104_1211_1294_1298_1318_1323_1334_1336_1359_1359_1364_1364_1367_1408_1413_,2047_2047_2071_2103_2104_2153_2154_2154_2208_2225_2226_2231_2231_2231_2247_2264_2267_2284_2284_2287_2287_2288_2288_2313_2316_2359_2360_2361_2416_2448_2450_2451_2452_2453_2454_2454_2454_2454_2455_2455_2455_2455_2483_2483_2483_2502_2516_2518_2525_2543_2567_2589_2589_2590_2627_2639_2650_2653_2702_2724_2746_2761_2762_2782_2790_2806_2829_2836_2841_2848_2869_2883_2895_2908_2912_2915_2933_2933_2942_2959_2968_2975_2976_2983_2984_3029_3074_3083_3103_3111_3133_3159_3159_3163_3170_3172_3174_3175_3176_3222_3226_3231_3232_3232_3237_3274_3313_3327_3345_3360_3363_3397_3409_3443_3446_3446_3446_3463_3477_3480_3482_
52,3,印象,N,29,43,72,115_163_168_214_228_268_321_707_710_717_720_852_861_940_940_944_990_993_1002_1020_1025_1028_1029_1091_1102_1251_1296_1300_,2008_2071_2099_2131_2133_2134_2162_2175_2235_2236_2260_2260_2335_2444_2454_2455_2464_2466_2531_2539_2549_2550_2613_2616_2618_2671_2680_2689_2754_2786_2788_2807_2883_2883_2902_2904_3015_3015_3055_3313_3433_3435_
52,3,桶裝水,N,1,4,5,,2450_2453_2492_
52,3,趕緊,ADV,2,15,17,1239_,2224_2337_2528_2812_3186_3188_3231_3233_3289_3290_3413_3470_3470_3470_
52,1,工夫,N,3,0,3,1490_1493_,
52,3,碰到,Vt,7,19,26,108_268_281_409_886_894_,2492_2608_2608_2608_2608_2609_2609_2609_2837_2923_3013_3044_3048_3115_3115_3196_3423_3424_
52,1,底部,N,1,0,1,,
52,3,小型,N,3,1,4,1070_1077_,
52,3,子,N,3,4,7,242_252_,3074_3451_3456_
52,1,水力,N,1,0,1,,
52,3,才,ADV,92,348,440,176_186_196_213_213_241_251_272_272_292_293_300_301_328_333_334_345_355_408_418_431_544_546_546_546_546_551_555_555_555_555_560_573_600_609_630_662_662_670_708_713_716_718_723_726_771_775_790_790_793_796_803_817_837_871_872_876_879_880_884_885_886_886_887_888_888_893_894_894_895_896_896_944_964_1009_1031_1049_1061_1082_1091_1098_1106_1114_1164_1166_1211_1319_1324_1374_1425_1425_,2005_2009_2009_2012_2012_2015_2023_2037_2037_2037_2057_2059_2059_2062_2071_2101_2102_2112_2128_2134_2162_2175_2186_2205_2207_2209_2209_2210_2210_2225_2226_2229_2231_2232_2240_2244_2244_2245_2245_2255_2257_2258_2258_2259_2259_2264_2266_2269_2269_2280_2283_2284_2287_2288_2289_2292_2305_2308_2309_2324_2333_2334_2338_2342_2354_2355_2360_2360_2360_2361_2361_2361_2363_2372_2372_2375_2375_2384_2384_2391_2391_2391_2391_2426_2436_2445_2446_2450_2453_2457_2459_2490_2498_2505_2509_2516_2518_2521_2527_2527_2527_2531_2534_2534_2537_2538_2544_2547_2549_2550_2554_2555_2567_2567_2579_2579_2601_2606_2606_2606_2608_2623_2637_2638_2642_2646_2651_2654_2671_2671_2675_2677_2690_2691_2698_2698_2698_2700_2701_2710_2712_2718_2721_2724_2730_2731_2731_2731_2731_2731_2731_2734_2739_2742_2745_2746_2754_2756_2767_2776_2791_2806_2806_2807_2812_2815_2816_2818_2824_2824_2826_2826_2828_2828_2828_2828_2836_2836_2837_2838_2855_2856_2857_2858_2861_2861_2861_2861_2862_2862_2867_2869_2869_2881_2881_2906_2908_2919_2922_2925_2932_2939_2940_2941_2946_2946_2946_2953_2953_2961_2963_2968_2970_2974_2980_2986_2997_3000_3001_3007_3020_3020_3031_3038_3038_3039_3039_3040_3044_3044_3048_3048_3049_3049_3056_3059_3061_3069_3070_3074_3074_3076_3083_3089_3097_3103_3103_3103_3110_3118_3118_3129_3129_3130_3130_3142_3146_3146_3146_3150_3159_3159_3161_3165_3170_3170_3172_3172_3181_3186_3188_3195_3202_3202_3206_3207_3227_3231_3232_3233_3233_3237_3239_3239_3253_3253_3253_3253_3255_3256_3260_3264_3283_3289_3290_3291_3291_3292_3292_3293_3308_3308_3313_3316_3319_3319_3319_3327_3339_3339_3344_3349_3360_3360_3373_3374_3379_3386_3388_3388_3395_3419_3431_3431_3431_3432_3432_3432_3433_3433_3433_3435_3435_3435_3438_3448_3448_3448_3451_3453_3453_3453_3456_3462_3463_3467_3470_
52,3,怪,Vi,9,8,17,150_349_359_546_555_870_878_1409_,2361_2588_2601_2864_2995_3319_3380_
52,3,深,Vi,13,5,18,161_166_214_228_268_669_885_893_1296_1300_1320_1325_,2598_2769_2770_3231_
52,3,淺,Vi,3,1,4,1481_1488_,
52,1,小伙子,N,10,0,10,388_710_710_710_710_720_720_720_720_,
52,3,回來,Vi,34,39,73,186_186_196_196_321_484_493_546_555_582_583_670_710_714_720_724_788_799_872_876_880_884_885_886_893_894_902_923_931_1102_1408_1413_1472_,2047_2047_2211_2384_2531_2658_2707_2708_2739_2746_2750_2861_2870_2873_2907_2933_2933_2983_2984_2987_3008_3038_3039_3040_3129_3130_3132_3163_3213_3218_3281_3337_3341_3433_3435_3480_3482_3487_
52,1,小便處,N,1,0,1,,
52,3,洗手間,N,21,50,71,68_75_158_162_167_842_856_865_887_895_943_1042_1068_1075_1181_1187_1476_1483_1490_1493_,2235_2236_2252_2252_2252_2252_2253_2253_2253_2253_2275_2285_2345_2350_2388_2432_2434_2435_2487_2488_2492_2679_2714_2745_2753_2753_2780_2914_2931_2990_2992_3112_3253_3253_3318_3319_3319_3357_3380_3389_3390_3401_3425_3428_3451_3456_3478_3479_3481_
52,3,失誤,N,1,7,8,,2315_2651_2654_2690_2771_3163_
52,3,不足,Vi,44,15,59,102_114_150_182_184_192_194_273_298_306_341_374_413_447_455_546_546_555_555_572_581_745_960_1026_1030_1037_1057_1104_1112_1120_1228_1230_1277_1284_1304_1307_1335_1343_1352_1398_1407_1419_1450_,2145_2258_2259_2324_2359_2530_2840_2882_2947_3007_3153_3333_3448_3453_
52,3,燒,Vt,3,10,13,145_1087_,2143_2387_2551_2566_2585_2714_3103_3103_3280_
52,3,進入,Vt,13,20,33,109_308_312_445_445_453_453_482_491_630_707_717_,2083_2124_2134_2609_2641_2645_2674_2746_2748_2748_2775_2793_2988_3001_3001_3001_3146_3327_3470_
52,3,大便,N,2,2,4,52_,2825_
52,3,非得,ADV,2,1,3,907_,
52,3,開門,Vi,8,35,43,889_897_990_993_1169_1176_1451_,2089_2175_2232_2272_2309_2383_2464_2466_2489_2523_2561_2562_2582_2582_2582_2631_2651_2654_2828_2908_2924_2926_2958_3034_3076_3205_3213_3218_3231_3304_3319_3341_3351_3351_
53,3,進行,Vt,19,47,66,58_109_417_515_517_517_520_529_540_540_553_562_780_982_982_1030_1169_1176_,2037_2037_2062_2062_2062_2167_2177_2180_2305_2308_2322_2322_2363_2432_2435_2445_2446_2575_2608_2609_2609_2609_2647_2671_2674_2732_2746_2746_2747_2759_2861_2882_3040_3049_3055_3055_3055_3160_3231_3383_3384_3433_3433_3435_3435_3483_
53,3,翻新,Vt,5,1,6,58_1238_1304_1307_,
53,3,別,ADV,13,47,60,58_364_369_600_609_610_619_677_808_876_884_1084_,2030_2031_2057_2099_2129_2163_2232_2246_2276_2354_2355_2526_2544_2609_2630_2650_2653_2680_2748_2771_2779_2867_2915_2967_2967_3036_3038_3039_3054_3065_3067_3110_3347_3352_3354_3360_3361_3362_3397_3405_3409_3409_3410_3463_3463_3477_
53,3,中心,N,50,36,86,56_58_61_69_76_94_149_215_218_222_226_227_227_229_391_418_546_555_669_669_686_691_733_736_742_780_828_828_828_854_863_901_901_901_904_921_990_993_1001_1062_1088_1100_1106_1145_1171_1178_1240_1431_1431_,2361_2424_2424_2426_2450_2450_2453_2453_2528_2625_2746_2746_2815_2882_2902_2904_2945_2965_2966_3041_3118_3171_3173_3195_3264_3281_3345_3376_3378_3385_3405_3410_3422_3431_3432_
53,3,一直,ADV,39,75,114,58_89_227_341_351_361_391_391_431_663_732_783_783_872_880_885_893_917_921_1045_1061_1061_1067_1074_1197_1200_1262_1319_1319_1324_1324_1343_1359_1364_1433_1435_1469_1470_,2016_2086_2090_2094_2096_2144_2145_2162_2175_2276_2305_2305_2308_2308_2360_2361_2509_2540_2540_2549_2550_2557_2594_2604_2606_2608_2618_2621_2680_2710_2712_2730_2730_2759_2796_2796_2823_2824_2824_2825_2826_2826_2883_2889_2890_3029_3056_3062_3071_3079_3083_3115_3132_3174_3237_3296_3308_3341_3371_3371_3371_3375_3377_3388_3391_3393_3405_3405_3410_3410_3433_3435_3443_3447_
53,1,寫字樓區,N,2,0,2,58_,
53,3,漲,Vi,2,3,5,58_,2386_2386_
53,3,到時,ADV,2,2,4,58_,3388_
53,3,靠近,Vt,17,17,34,58_163_168_394_397_629_857_866_966_1092_1251_1296_1300_1328_1491_1494_,2305_2307_2308_2607_2724_2857_2858_2875_2965_2966_3040_3089_3092_3170_3172_3242_
53,3,陳舊,Vi,61,148,209,57_58_62_161_166_176_213_231_240_250_270_315_381_384_390_391_391_396_409_415_417_522_523_531_532_674_736_739_753_811_812_827_850_856_859_865_868_886_894_949_1023_1057_1057_1088_1091_1091_1140_1154_1161_1231_1293_1327_1336_1345_1355_1360_1374_1375_1376_1399_,2013_2048_2049_2050_2052_2053_2058_2062_2073_2074_2094_2096_2109_2110_2111_2130_2132_2139_2143_2149_2161_2163_2191_2204_2211_2213_2216_2216_2242_2267_2285_2305_2308_2342_2345_2350_2358_2362_2377_2393_2400_2402_2412_2418_2426_2454_2455_2457_2462_2470_2480_2515_2517_2519_2521_2522_2529_2547_2548_2558_2572_2581_2586_2589_2596_2597_2603_2605_2613_2619_2620_2626_2629_2651_2654_2656_2678_2679_2709_2711_2713_2718_2721_2731_2749_2750_2756_2786_2788_2790_2804_2805_2814_2830_2840_2841_2844_2860_2869_2882_2885_2887_2895_2916_2948_2949_2950_2972_2976_2977_3012_3034_3037_3047_3051_3083_3103_3114_3118_3134_3159_3160_3182_3183_3190_3222_3225_3233_3238_3258_3287_3288_3305_3305_3318_3325_3343_3403_3408_3433_3434_3435_3436_3446_3466_3488_3490_
53,3,設備,N,42,54,96,58_80_86_149_176_239_249_286_466_484_493_546_555_641_648_654_754_773_777_788_821_903_925_929_933_937_960_980_1005_1021_1021_1021_1032_1040_1250_1359_1359_1364_1364_1398_1407_,2040_2073_2116_2119_2136_2140_2204_2216_2240_2254_2256_2281_2282_2390_2480_2498_2529_2534_2565_2587_2596_2597_2603_2605_2607_2679_2790_2791_2862_2965_2966_3012_3034_3093_3103_3111_3114_3121_3126_3159_3168_3169_3201_3212_3217_3233_3238_3293_3305_3342_3345_3371_3427_
54,3,經營,Vt,4,4,8,59_275_632_,2759_3246_3267_
54,1,有如,Vt,2,0,2,59_,
54,3,那裡,N,36,37,73,59_147_177_186_196_232_285_481_497_628_665_736_765_830_846_856_859_865_868_912_916_1040_1088_1088_1105_1212_1319_1324_1326_1392_1401_1462_1467_1491_1494_,2342_2391_2391_2450_2453_2536_2609_2609_2637_2637_2638_2638_2698_2748_2812_2863_2933_2998_2999_3011_3015_3016_3055_3071_3103_3185_3185_3185_3244_3274_3282_3361_3362_3415_3418_3460_
54,3,桑拿,N,5,11,16,59_80_86_287_,2313_2316_2759_2824_2824_2826_2826_3016_3495_3497_
54,3,一樣,Vi,41,111,152,59_161_166_228_228_260_262_411_468_472_546_555_630_636_638_700_745_764_793_796_847_887_887_895_895_976_990_993_1031_1054_1057_1060_1090_1244_1248_1332_1343_1348_1418_1456_,2057_2068_2090_2149_2154_2154_2163_2170_2201_2206_2208_2247_2267_2296_2326_2344_2349_2383_2392_2394_2416_2432_2435_2459_2460_2461_2483_2500_2501_2517_2519_2540_2561_2562_2589_2629_2630_2637_2638_2649_2671_2717_2720_2759_2769_2770_2776_2782_2791_2803_2815_2839_2862_2863_2867_2879_2880_2934_2951_2951_2967_2987_2997_3022_3023_3049_3055_3073_3074_3078_3121_3126_3139_3175_3176_3180_3184_3187_3189_3223_3232_3243_3246_3246_3253_3267_3268_3274_3291_3292_3293_3305_3308_3324_3327_3327_3333_3363_3364_3364_3364_3371_3397_3417_3418_3431_3432_3433_3435_3485_
54,3,倒是,ADV,20,16,36,57_59_62_289_364_369_566_575_670_677_830_1033_1359_1364_1408_1413_1427_1430_1437_,2816_2818_2914_2939_2940_2997_3131_3214_3219_3225_3254_3360_3386_3430_3472_
55,3,機會,N,33,15,48,60_110_147_284_374_469_473_684_716_726_743_745_765_887_888_891_895_896_899_919_956_1030_1054_1058_1060_1082_1304_1307_1429_1491_1494_1499_,2192_2305_2308_2445_2446_3072_3146_3187_3189_3231_3345_3427_3431_3432_
55,3,寫,Vt,15,19,34,60_276_320_365_370_599_608_630_710_720_944_964_1149_1156_,2102_2134_2338_2360_2360_2361_2361_2502_2553_2596_2597_2834_2846_2881_2968_3253_3253_3397_
55,3,更加,ADV,15,12,27,60_515_914_965_982_1030_1031_1054_1065_1309_1313_1319_1324_1326_,2334_2388_2596_2597_2616_2616_2700_2701_3047_3051_3345_
55,3,繼續,Vt,17,17,34,60_162_167_282_282_517_538_592_601_871_879_915_976_989_992_1028_,2499_2516_2518_2609_2623_2710_2712_2747_2776_2924_2946_3150_3288_3319_3489_3491_
56,3,考慮,Vt,34,40,74,61_116_118_126_162_167_217_288_338_362_367_402_515_610_619_641_773_777_790_800_891_899_904_1091_1095_1204_1234_1239_1428_1440_1445_1481_1488_,2211_2232_2283_2309_2328_2330_2382_2454_2455_2483_2517_2519_2549_2549_2550_2550_2647_2665_2695_2704_2745_2745_2775_2786_2788_2860_2944_2981_2982_3118_3187_3189_3193_3196_3223_3294_3438_3489_3491_
56,3,它,N,32,51,83,61_140_225_316_433_433_632_707_707_715_717_717_725_795_798_875_883_885_893_928_936_1011_1011_1011_1115_1211_1211_1239_1326_1350_1421_,2057_2058_2058_2070_2099_2099_2116_2119_2162_2162_2175_2177_2197_2286_2389_2525_2547_2753_2781_2793_2796_2797_2834_2842_2843_2864_2908_2922_2922_2922_3025_3027_3032_3033_3043_3101_3101_3197_3199_3243_3243_3244_3282_3282_3294_3320_3433_3435_3454_3466_
56,1,金融,N,2,0,2,61_,
56,3,哪裡,N,19,13,32,61_410_616_625_708_711_718_721_786_887_892_895_900_946_946_1217_1350_1495_,2159_2432_2435_2541_2611_2968_3103_3194_3241_3246_3347_3418_
56,3,再次,ADV,55,81,136,61_157_157_162_167_213_246_256_316_316_336_426_434_435_436_437_438_438_439_440_441_443_443_443_516_517_685_690_743_905_910_976_982_982_1028_1028_1029_1029_1030_1030_1031_1031_1032_1150_1157_1271_1274_1309_1313_1319_1324_1440_1445_1451_,2070_2126_2126_2175_2191_2225_2226_2258_2259_2305_2305_2308_2308_2322_2359_2386_2391_2406_2408_2417_2445_2446_2447_2475_2527_2589_2590_2608_2608_2609_2609_2609_2616_2616_2671_2680_2702_2702_2753_2761_2762_2857_2858_2883_2987_3049_3055_3083_3146_3146_3146_3146_3146_3146_3163_3163_3231_3231_3253_3345_3371_3371_3413_3431_3431_3432_3432_3433_3433_3433_3435_3435_3435_3448_3448_3453_3453_3466_3470_3483_
57,3,外國,N,2,3,5,62_,2070_3240_
57,3,豪華閣,N,2,4,6,62_,2754_2754_2754_
57,3,普通,Vi,24,35,59,57_62_62_376_412_431_444_452_551_560_610_619_658_821_843_853_862_959_970_1099_1115_1425_1431_,2065_2065_2072_2126_2197_2232_2232_2233_2246_2280_2322_2385_2393_2463_2465_2595_2718_2721_2740_2871_2934_2975_3115_3174_3185_3210_3215_3324_3345_3365_3392_3394_3422_3471_
57,3,遇到,Vt,22,43,65,57_62_62_111_163_168_247_257_316_546_555_701_885_893_910_1020_1091_1207_1311_1315_1436_,2040_2057_2167_2190_2258_2259_2270_2305_2308_2359_2372_2375_2421_2450_2453_2516_2518_2522_2589_2589_2590_2590_2651_2654_2691_2754_2775_2862_2882_2961_2963_3038_3039_3065_3067_3150_3150_3212_3217_3255_3256_3446_
57,3,經常,ADV,12,23,35,62_427_441_442_498_728_737_828_918_1047_1054_,2098_2211_2324_2346_2351_2450_2453_2464_2466_2630_2714_2740_2759_2907_3059_3099_3233_3295_3438_3443_3443_3446_
57,3,聽說,Vt,22,22,44,62_241_251_281_407_407_480_482_489_491_714_724_886_894_1240_1240_1254_1296_1300_1326_1419_,2232_2388_2399_2400_2401_2402_2436_2436_2436_2454_2455_2525_2551_2739_3132_3140_3255_3256_3288_3488_3490_
63,3,周邊,N,39,28,67,70_77_83_95_100_270_340_374_375_479_488_572_581_650_656_782_805_818_842_844_849_854_863_904_1105_1106_1112_1120_1141_1143_1204_1263_1337_1345_1408_1413_1463_1468_,2093_2198_2231_2231_2264_2365_2365_2399_2401_2606_2678_2739_2747_2763_2821_2824_2826_2882_2929_2980_3019_3119_3124_3269_3318_3433_3435_
63,3,位於,Vt,23,5,28,70_91_219_242_252_336_480_489_550_559_695_733_788_789_790_822_835_847_1041_1234_1333_1348_,2136_2140_2802_2908_
64,3,改善,Vt,15,8,23,71_227_276_281_515_597_630_1065_1124_1131_1239_1334_1334_1451_,2060_2084_2085_2258_2259_2575_2737_
64,3,有得,ADV,2,1,3,71_,
64,3,無法,ADV,20,77,97,64_68_71_71_75_163_168_220_279_434_669_750_754_838_944_982_1396_1405_1451_,2035_2061_2070_2074_2089_2089_2089_2095_2097_2190_2232_2248_2250_2269_2298_2301_2344_2349_2370_2373_2398_2460_2461_2512_2530_2530_2535_2535_2557_2569_2596_2597_2606_2606_2635_2639_2683_2686_2725_2740_2824_2826_2861_2862_2863_2867_2872_2873_2873_2921_2979_3076_3118_3132_3162_3162_3170_3172_3187_3189_3204_3205_3233_3279_3307_3331_3333_3357_3405_3410_3413_3460_3462_3484_3488_3490_
64,3,收,Vt,19,81,100,66_71_73_145_152_226_320_388_554_563_612_621_680_740_939_1228_1230_1336_,2041_2047_2074_2081_2081_2081_2081_2083_2083_2083_2083_2104_2111_2183_2208_2208_2208_2244_2245_2255_2257_2272_2272_2287_2287_2288_2288_2303_2306_2318_2319_2328_2330_2354_2355_2359_2391_2421_2534_2549_2549_2550_2550_2554_2555_2739_2746_2769_2770_2771_2787_2789_2824_2826_2848_2915_2919_2947_2981_2982_2986_3034_3069_3069_3070_3070_3107_3184_3253_3253_3253_3255_3256_3264_3268_3313_3313_3331_3385_3397_
64,3,郵件,N,2,6,8,71_,2919_3281_3281_3289_3290_
64,3,效率,N,12,12,24,71_225_226_273_628_674_819_960_1327_1395_1404_,2085_2168_2205_2949_2996_3295_3335_3406_3411_3433_3435_
64,3,網頁,N,2,3,5,71_,3170_3172_
65,1,大商,N,2,0,2,72_,
65,3,四星,N,31,88,119,65_72_72_89_89_173_213_276_277_279_386_419_424_440_526_535_553_562_660_803_1013_1039_1048_1059_1113_1121_1163_1165_1173_1180_,2036_2036_2038_2038_2038_2038_2038_2040_2040_2040_2040_2040_2043_2045_2070_2071_2075_2105_2158_2158_2196_2232_2240_2241_2266_2266_2328_2328_2328_2328_2330_2330_2330_2330_2360_2361_2384_2419_2438_2440_2445_2445_2446_2446_2651_2651_2654_2654_2773_2773_2804_2817_2819_2916_2922_2922_2922_2944_2996_3069_3070_3076_3077_3156_3191_3233_3239_3283_3347_3347_3347_3360_3380_3385_3392_3394_3423_3424_3433_3433_3435_3435_3439_3441_3460_3489_3491_
65,3,掛牌,Vi,6,13,19,72_526_535_753_1089_,2243_2266_2335_2824_2824_2826_2826_2967_2972_3132_3132_3233_
65,3,准,Vt,3,5,8,72_429_,2531_2651_2654_3141_
65,3,商場,N,29,3,32,72_478_483_484_487_492_493_571_580_596_605_771_775_782_854_863_889_897_903_924_932_950_1005_1070_1077_1238_1427_1496_,3376_3378_
65,3,正,ADV,20,21,41,72_99_229_229_245_255_286_320_437_743_830_921_957_957_1031_1056_1356_1361_1371_,2008_2012_2305_2308_2324_2432_2435_2639_2717_2720_2753_2802_2848_2919_3041_3108_3109_3253_3281_3484_
65,3,便利,Vt,27,6,33,68_72_75_105_381_384_505_521_530_585_630_779_783_789_907_940_974_983_1129_1136_1171_1178_1194_1204_1251_1349_,2219_2221_2333_2334_2805_
65,1,立,Vt,2,0,2,72_,
65,3,購物,Vi,37,6,43,69_72_76_164_169_374_375_406_550_559_686_691_771_775_779_780_786_801_814_815_832_842_901_901_907_924_932_991_994_1029_1070_1077_1208_1263_1329_1419_,2426_2901_3032_3033_3041_
66,3,聲音,N,20,69,89,73_161_166_239_249_413_546_555_660_707_717_971_1042_1055_1332_1366_1366_1366_1456_,2110_2126_2153_2208_2239_2272_2272_2292_2326_2367_2425_2428_2432_2435_2445_2446_2460_2461_2489_2489_2492_2510_2511_2526_2540_2547_2631_2649_2740_2742_2753_2756_2784_2791_2867_2875_2908_2996_3016_3038_3039_3040_3071_3098_3098_3113_3119_3124_3146_3233_3233_3239_3311_3319_3319_3331_3333_3333_3341_3341_3431_3432_3443_3447_3454_3466_3471_3486_
66,3,上網費,N,2,1,3,73_,
66,3,聽,Vt,11,38,49,73_155_407_434_507_546_555_1268_1295_1299_,2161_2164_2166_2287_2288_2382_2406_2408_2409_2410_2540_2637_2638_2862_2875_2926_2969_3032_3033_3072_3117_3146_3210_3215_3231_3231_3260_3272_3278_3278_3319_3347_3388_3431_3432_3433_3435_
66,3,費用,N,6,25,31,73_185_195_813_816_,2081_2083_2083_2318_2319_2417_2549_2549_2550_2550_2616_2616_2623_2806_2842_2843_2848_2946_2981_2982_3162_3193_3331_3486_
66,3,根本,ADV,11,132,143,73_91_112_698_1029_1272_1275_1295_1299_1348_,2061_2065_2104_2123_2139_2143_2158_2188_2196_2198_2198_2202_2204_2206_2246_2252_2253_2291_2291_2323_2384_2388_2390_2394_2436_2445_2446_2450_2450_2450_2453_2453_2453_2460_2461_2509_2524_2532_2533_2569_2571_2574_2578_2606_2637_2638_2680_2700_2701_2709_2711_2715_2716_2731_2732_2732_2739_2750_2775_2816_2818_2869_2871_2871_2872_2885_2887_2944_2945_2945_2945_2949_2959_2976_2987_3014_3020_3043_3055_3076_3076_3077_3093_3115_3118_3150_3170_3172_3185_3194_3194_3207_3207_3227_3227_3243_3245_3245_3253_3253_3261_3274_3274_3274_3278_3278_3289_3290_3297_3308_3331_3331_3332_3333_3333_3342_3344_3388_3389_3390_3397_3423_3424_3427_3430_3458_3475_3477_3488_3490_3492_
66,3,感到,Vt,20,17,37,73_116_184_194_242_252_342_352_707_710_710_714_717_720_720_724_982_1062_1387_,2225_2226_2229_2335_2530_2558_2609_2815_2907_2928_3076_3246_3433_3433_3435_3435_
66,3,值,Vi,34,11,45,73_101_242_252_310_314_334_334_437_599_608_610_610_619_619_640_647_653_771_775_815_941_954_983_1008_1029_1193_1254_1271_1272_1274_1275_1371_,2354_2355_2409_2410_2412_3020_3034_3249_3272_3320_
66,3,換,Vt,39,201,240,73_239_249_342_342_352_352_481_494_540_546_555_636_638_663_771_775_787_823_835_870_878_889_897_961_1018_1066_1098_1099_1139_1207_1240_1240_1270_1273_1353_1366_1498_,2037_2037_2039_2041_2061_2061_2071_2077_2079_2090_2095_2097_2114_2117_2134_2135_2144_2145_2162_2162_2175_2175_2194_2219_2221_2228_2228_2231_2247_2258_2259_2260_2273_2273_2290_2312_2312_2312_2315_2315_2315_2328_2330_2342_2363_2387_2392_2393_2393_2416_2416_2416_2450_2453_2483_2508_2517_2517_2517_2519_2519_2519_2528_2540_2544_2547_2557_2594_2594_2594_2594_2625_2631_2639_2650_2653_2657_2669_2709_2711_2718_2721_2731_2740_2740_2742_2743_2745_2745_2748_2775_2775_2775_2775_2775_2776_2791_2809_2814_2814_2828_2828_2828_2841_2841_2841_2846_2863_2863_2863_2873_2881_2889_2890_2907_2916_2917_2923_2928_2938_2951_2972_2995_2995_2995_3007_3036_3054_3063_3063_3069_3069_3070_3070_3076_3083_3083_3087_3095_3095_3099_3100_3103_3103_3129_3130_3141_3146_3146_3168_3169_3174_3174_3184_3184_3184_3202_3210_3210_3213_3215_3215_3218_3231_3232_3239_3243_3243_3260_3293_3319_3341_3341_3341_3386_3386_3388_3431_3431_3431_3432_3432_3432_3433_3433_3433_3435_3435_3435_3445_3448_3452_3453_3457_3458_3467_3470_3472_3473_3473_
66,3,以為,Vt,9,41,50,73_802_887_895_922_930_1371_1431_,2041_2099_2166_2344_2349_2360_2361_2454_2455_2492_2517_2519_2576_2606_2625_2684_2687_2744_2761_2762_2791_2815_2848_2861_2869_2871_2976_3049_3065_3067_3243_3282_3305_3319_3331_3344_3352_3354_3458_3476_
66,3,提出,Vt,37,69,106,73_109_157_160_186_186_196_196_213_213_213_217_217_217_437_443_470_474_515_515_743_982_982_982_1029_1029_1054_1091_1169_1176_1319_1324_1340_1359_1364_1371_,2005_2037_2037_2081_2081_2083_2083_2089_2108_2161_2258_2259_2287_2287_2288_2288_2294_2322_2342_2359_2406_2406_2408_2408_2417_2445_2446_2447_2454_2455_2475_2510_2511_2575_2595_2606_2671_2731_2731_2746_2759_2840_2881_3031_3049_3049_3055_3071_3146_3180_3231_3232_3232_3253_3253_3371_3383_3384_3431_3431_3432_3432_3448_3448_3453_3453_3466_3466_
66,1,17樓,N,2,0,2,73_,
66,3,原本,ADV,3,12,15,73_1088_,2128_2391_2528_2752_2767_2775_2790_2911_3163_3288_3324_
67,3,收到,Vt,12,15,27,74_177_320_788_982_982_1020_1020_1062_1203_1203_,2104_2305_2308_2391_2534_2567_2637_2638_2836_2956_2957_3255_3256_3421_
67,3,軌,N,5,5,10,74_891_899_940_,2324_2611_2651_2654_
67,1,清泥窪,N,2,0,2,74_,
67,3,想像,N,21,22,43,68_74_75_133_416_668_809_820_848_887_895_912_913_1082_1257_1408_1413_1421_1436_1500_,2241_2267_2517_2519_2608_2790_2828_2917_2931_2972_3013_3076_3076_3095_3103_3105_3185_3233_3260_3279_3307_
67,3,電視,N,66,91,157,74_93_154_176_494_499_499_519_520_529_541_630_631_669_750_754_788_794_797_818_831_869_874_875_875_877_882_883_883_885_889_893_897_972_972_974_981_990_990_993_993_1007_1007_1007_1042_1070_1077_1091_1141_1141_1143_1143_1183_1189_1219_1221_1366_1366_1366_1394_1396_1403_1405_1473_1474_,2054_2070_2070_2147_2159_2163_2183_2240_2240_2299_2302_2335_2381_2383_2383_2388_2418_2500_2501_2512_2523_2540_2541_2565_2594_2616_2652_2655_2662_2688_2702_2702_2702_2702_2702_2702_2718_2718_2718_2721_2721_2721_2740_2790_2793_2807_2815_2899_2915_2916_2987_2988_2996_2997_3071_3076_3076_3076_3083_3089_3098_3119_3124_3153_3153_3160_3161_3213_3218_3325_3333_3353_3355_3380_3389_3390_3391_3393_3409_3409_3409_3418_3431_3431_3432_3432_3433_3435_3454_3476_
67,1,天津街,N,2,0,2,74_,
67,3,收費,Vt,27,60,87,74_108_109_115_124_132_142_142_161_163_166_168_213_327_332_424_427_494_495_740_857_866_1168_1175_1201_1258_,2040_2062_2094_2096_2108_2108_2136_2140_2180_2208_2299_2299_2302_2302_2318_2318_2319_2319_2323_2360_2361_2365_2391_2436_2492_2498_2553_2553_2561_2562_2669_2698_2724_2775_2824_2826_2865_2939_2940_2972_2972_2972_2972_3084_3139_3139_3170_3172_3350_3386_3386_3386_3423_3423_3424_3424_3444_3477_3492_
67,1,電車,N,10,0,10,74_843_847_847_885_891_893_899_940_,
67,1,韓,N,2,0,2,74_,
67,1,8平,N,2,0,2,74_,
67,3,港,N,2,1,3,74_,
67,3,標,N,36,60,96,74_139_171_175_199_205_241_251_272_272_373_374_395_412_431_435_611_620_679_750_847_935_981_1007_1068_1075_1139_1201_1201_1259_1352_1352_1353_1431_1431_,2045_2058_2065_2065_2070_2070_2073_2077_2162_2206_2232_2243_2280_2280_2365_2389_2393_2393_2487_2488_2606_2606_2606_2606_2740_2846_2897_2949_2972_3005_3040_3040_3040_3059_3065_3065_3065_3067_3067_3067_3112_3146_3177_3239_3277_3308_3308_3308_3308_3319_3324_3324_3329_3344_3347_3413_3422_3472_3472_
67,3,樓下,N,31,19,50,74_215_272_483_484_492_493_546_555_596_605_700_732_740_771_775_811_815_869_877_886_894_917_967_1036_1223_1225_1311_1315_1473_,2434_2528_2766_2784_2784_2795_2797_2802_2809_3030_3074_3103_3349_3353_3355_3418_3418_3472_
67,3,有有,Vi,4,1,5,74_891_899_,
67,3,不遠,Vi,16,4,20,74_81_87_339_412_657_856_865_891_891_899_899_1151_1158_1474_,2965_2966_3347_
67,3,美,N,30,3,33,69_74_76_110_247_257_279_364_369_377_514_582_583_630_670_695_698_698_708_718_785_919_1086_1088_1088_1088_1091_1168_1175_,2909_2910_
67,3,清晰,Vi,3,3,6,74_1020_,3333_3418_
67,3,覺得,Vt,79,85,164,74_161_162_166_167_242_252_283_287_422_427_461_471_475_482_491_513_521_521_530_530_550_559_584_643_648_654_677_701_704_706_711_721_732_787_788_788_870_870_878_878_885_885_887_893_893_895_923_931_1026_1056_1082_1082_1084_1088_1088_1088_1088_1089_1106_1112_1120_1124_1124_1131_1131_1138_1211_1214_1262_1296_1300_1356_1361_1423_1423_1423_1495_,2005_2030_2031_2037_2058_2069_2104_2126_2144_2145_2175_2181_2181_2193_2229_2258_2259_2283_2298_2301_2360_2361_2432_2435_2439_2444_2450_2453_2458_2491_2510_2511_2549_2549_2550_2550_2551_2604_2647_2688_2705_2706_2718_2721_2775_2803_2824_2826_2861_2863_2864_2909_2910_2915_2939_2940_2988_2998_3000_3037_3059_3078_3083_3084_3084_3084_3105_3105_3137_3196_3196_3196_3231_3313_3319_3357_3371_3380_3397_3405_3410_3421_3433_3435_
68,3,很多,Vi,24,21,45,75_99_112_183_193_235_235_335_393_395_610_619_790_830_1057_1091_1207_1215_1319_1324_1339_1421_1472_,2143_2283_2463_2465_2510_2511_2540_2576_2637_2638_2743_2946_2995_3041_3099_3115_3186_3188_3267_3311_
68,3,合適,Vi,13,3,16,75_179_189_222_223_234_448_456_584_630_1005_1085_,3255_3256_
68,3,玻璃,N,18,23,41,75_162_167_228_374_495_662_687_692_761_815_889_897_1124_1131_1212_1431_,2102_2126_2137_2141_2492_2537_2538_2575_2703_3085_3246_3333_3351_3352_3352_3353_3354_3354_3355_3357_3484_3493_
68,3,迷你,Vi,2,7,9,75_,3213_3213_3214_3218_3218_3219_
68,3,換氣,Vi,2,2,4,75_,2766_
68,3,質量,N,29,66,95,75_94_109_109_123_131_245_255_628_660_714_724_733_858_867_964_973_988_1043_1091_1124_1131_1266_1292_1338_1345_1408_1413_,2014_2139_2143_2212_2231_2246_2258_2259_2270_2273_2287_2288_2291_2294_2322_2359_2359_2363_2390_2512_2530_2548_2608_2609_2609_2619_2620_2642_2646_2651_2654_2714_2761_2762_2840_2846_2857_2858_2864_2864_2916_2928_2951_2951_2975_2976_3014_3069_3070_3097_3098_3132_3163_3243_3246_3253_3265_3325_3341_3349_3386_3388_3433_3435_3446_
68,3,業務,N,9,19,28,75_466_504_681_682_1224_1226_1234_,2237_2238_2467_2468_2498_2574_2761_2762_2779_2865_2965_2966_2979_3093_3182_3183_3252_3267_
68,3,查房,Vi,2,25,27,75_,2222_2252_2253_2294_2527_2534_2534_2534_2534_2616_2861_2917_2977_3029_3110_3150_3220_3221_3288_3289_3290_3291_3292_3397_
68,3,退房,Vi,43,157,200,75_116_149_155_177_290_296_304_363_368_520_521_529_530_554_563_570_579_617_617_626_626_636_638_709_719_738_767_800_820_872_880_889_897_1008_1032_1032_1054_1061_1112_1120_1431_,2012_2037_2042_2047_2048_2065_2081_2083_2095_2097_2112_2136_2140_2189_2193_2209_2210_2211_2233_2239_2252_2252_2252_2252_2253_2253_2253_2253_2269_2272_2287_2288_2293_2293_2309_2342_2342_2353_2363_2363_2364_2372_2375_2384_2394_2394_2394_2394_2447_2484_2516_2518_2527_2529_2557_2567_2569_2606_2606_2608_2680_2691_2691_2705_2706_2719_2722_2731_2740_2746_2746_2747_2748_2754_2767_2775_2806_2828_2837_2837_2838_2838_2853_2855_2856_2864_2869_2876_2882_2898_2909_2910_2933_2946_2958_2970_2981_2982_2986_3032_3033_3073_3074_3083_3083_3084_3101_3103_3110_3149_3149_3150_3150_3150_3197_3199_3205_3220_3221_3226_3226_3227_3233_3234_3239_3239_3243_3253_3253_3253_3254_3254_3254_3264_3265_3279_3288_3288_3291_3292_3295_3316_3360_3388_3413_3416_3416_3416_3431_3432_3447_3451_3456_3462_3478_3478_
68,3,用品,N,22,26,48,75_109_109_707_717_793_795_796_798_842_906_964_1005_1021_1030_1030_1057_1251_1418_1419_1496_,2240_2252_2253_2310_2311_2342_2392_2426_2516_2517_2518_2519_2544_2631_2756_2933_2951_2953_3049_3069_3070_3073_3073_3418_3446_
68,3,幕牆,N,2,2,4,75_,2102_
68,3,極為,ADV,4,2,6,75_616_625_,3133_
69,3,商業,N,7,5,12,76_94_784_1171_1178_1326_,2453_2828_2965_2966_
69,1,猶豫,Vt,4,0,4,76_1270_1273_,
69,3,中,N,39,40,79,76_116_122_130_156_175_281_320_520_529_630_641_644_715_725_740_805_826_848_889_897_929_937_940_986_1004_1097_1114_1164_1166_1228_1230_1296_1300_1334_1436_1442_1447_,2314_2316_2317_2389_2445_2445_2445_2445_2446_2446_2446_2446_2530_2596_2597_2671_2754_2769_2770_2798_2800_2817_2819_2835_2883_2893_2908_2946_2979_3082_3237_3253_3327_3345_3380_3392_3394_3489_3491_
69,3,特別,Vi,116,69,185,76_79_85_91_118_126_150_164_169_183_185_193_195_214_242_242_242_242_242_242_242_242_245_252_252_252_252_252_252_252_252_255_321_346_346_347_347_356_356_357_357_401_401_448_456_462_482_491_508_544_552_561_566_575_592_601_616_618_625_627_745_760_768_783_783_800_808_835_910_921_943_982_985_1020_1029_1043_1059_1083_1091_1124_1131_1135_1145_1149_1154_1154_1156_1161_1161_1168_1169_1175_1176_1208_1227_1229_1254_1293_1294_1296_1296_1298_1300_1300_1386_1389_1409_1423_1425_1476_1480_1481_1483_1487_1488_,2089_2099_2104_2159_2207_2318_2318_2319_2319_2353_2353_2360_2361_2390_2394_2445_2446_2480_2481_2482_2510_2511_2527_2565_2626_2689_2703_2703_2707_2708_2771_2775_2817_2819_2889_2890_2927_2969_2978_2978_3013_3032_3033_3038_3038_3039_3039_3041_3083_3084_3149_3150_3166_3242_3278_3278_3318_3319_3333_3335_3352_3354_3360_3360_3367_3368_3421_3475_
69,3,正常,Vi,8,17,25,76_157_223_339_707_717_1366_,2161_2190_2231_2280_2324_2512_2609_2746_3012_3105_3278_3414_3433_3433_3435_3435_
69,3,這麼,ADV,21,66,87,76_89_204_210_424_499_550_559_630_707_717_788_793_796_842_922_924_930_932_1145_,2059_2161_2211_2273_2283_2287_2288_2318_2319_2360_2361_2391_2393_2445_2446_2454_2455_2502_2553_2553_2564_2589_2589_2608_2608_2608_2651_2654_2717_2720_2754_2824_2826_2841_2879_2880_2923_2956_2957_2961_2963_2976_3038_3039_3049_3083_3144_3207_3213_3218_3255_3256_3264_3289_3290_3306_3333_3379_3388_3415_3443_3443_3443_3458_3470_
69,3,剛,ADV,35,48,83,76_81_87_104_175_203_209_419_482_491_522_531_629_630_630_783_787_787_872_876_880_884_891_899_973_1057_1062_1102_1139_1155_1162_1270_1273_1418_,2126_2126_2179_2183_2186_2228_2231_2340_2341_2354_2355_2360_2361_2483_2505_2609_2679_2714_2862_2908_2923_2933_2959_2983_2984_3056_3056_3065_3067_3074_3083_3087_3095_3120_3125_3146_3158_3274_3282_3309_3316_3388_3433_3435_3475_3480_3482_
69,3,實在,ADV,59,176,235,76_157_176_204_210_229_253_286_290_320_387_424_477_481_486_506_600_609_611_620_649_655_711_721_761_788_835_841_854_863_949_988_988_990_990_993_993_1005_1009_1010_1010_1051_1057_1087_1088_1088_1091_1107_1232_1328_1332_1333_1378_1429_1442_1447_1455_1472_,2020_2024_2037_2051_2054_2058_2061_2065_2071_2084_2085_2089_2099_2113_2126_2131_2133_2163_2189_2195_2234_2244_2245_2252_2252_2253_2253_2289_2312_2315_2318_2318_2319_2319_2320_2332_2335_2371_2374_2381_2382_2383_2389_2392_2425_2428_2434_2492_2510_2511_2522_2522_2527_2534_2537_2538_2549_2550_2569_2585_2587_2587_2589_2589_2615_2615_2626_2631_2649_2649_2657_2658_2659_2662_2662_2671_2691_2698_2698_2718_2721_2731_2740_2741_2744_2746_2750_2750_2773_2773_2806_2806_2806_2815_2816_2818_2839_2862_2864_2864_2865_2873_2907_2916_2922_2923_2930_2969_2976_3000_3024_3026_3029_3029_3031_3031_3044_3046_3046_3048_3050_3050_3064_3072_3079_3089_3098_3100_3116_3159_3159_3161_3175_3176_3177_3181_3185_3186_3188_3195_3205_3213_3218_3227_3231_3243_3244_3253_3257_3257_3260_3268_3287_3294_3320_3331_3340_3366_3379_3379_3382_3387_3387_3405_3409_3410_3422_3425_3431_3431_3432_3432_3458_3467_3467_
69,3,找到,Vt,16,32,48,76_151_184_194_239_249_410_592_601_610_619_788_887_895_1024_,2070_2105_2342_2493_2544_2598_2671_2671_2671_2671_2671_2769_2770_2793_2892_2902_2904_3103_3184_3281_3289_3289_3290_3290_3341_3360_3402_3407_3433_3435_3476_
69,1,人士,N,3,0,3,76_787_,
69,3,容易,Vi,10,6,16,76_348_714_724_960_1024_1331_1333_1409_,2742_2756_2793_2847_3139_
69,3,四星級,N,33,85,118,76_77_83_119_127_163_168_187_197_204_210_278_316_334_391_424_429_433_434_762_842_945_1038_1060_1061_1062_1149_1156_1170_1177_1213_1240_,2039_2039_2041_2041_2065_2069_2074_2101_2102_2125_2126_2161_2181_2195_2204_2204_2204_2232_2232_2246_2273_2287_2288_2340_2341_2364_2364_2417_2417_2418_2436_2481_2482_2516_2518_2528_2544_2544_2561_2561_2562_2562_2564_2579_2585_2631_2662_2709_2711_2723_2723_2790_2798_2800_2816_2818_2824_2824_2826_2826_2847_2847_2871_2879_2880_2919_2922_3009_3010_3025_3027_3056_3103_3103_3194_3222_3240_3246_3271_3287_3423_3424_3488_3490_
69,3,差異,N,2,4,6,76_,2318_2319_2759_
77,3,浴室,N,30,43,73,83_133_162_162_167_167_219_291_299_374_397_675_815_815_964_964_981_1057_1092_1124_1129_1131_1136_1270_1273_1359_1364_1398_1407_,2144_2145_2163_2195_2198_2200_2202_2391_2391_2508_2525_2528_2569_2571_2647_2707_2708_2730_2815_2854_2873_2907_2928_2980_2986_3007_3016_3071_3111_3160_3223_3234_3294_3356_3357_3385_3434_3436_3448_3452_3453_3457_
77,3,散,Vi,4,5,9,83_374_1328_,2517_2519_2740_2976_
77,3,出水,Vi,4,10,14,83_397_1423_,2200_2252_2253_2500_2501_2814_2838_2947_3029_
77,3,好用,Vi,5,13,18,83_750_1021_1114_,2006_2061_2161_2164_2247_2807_3084_3119_3124_3386_3386_3417_
77,1,水量,N,6,0,6,83_573_630_1304_1307_,
77,3,噴頭,N,3,4,7,83_1021_,3023_3095_3242_
77,3,後邊,N,4,2,6,83_351_361_,3133_
77,3,調節,Vt,4,2,6,83_374_1217_,2919_
78,3,感受到,Vt,4,8,12,84_286_443_,2305_2308_2759_2791_2862_3146_3332_
78,3,推薦,Vt,73,102,175,84_91_91_91_92_94_103_139_141_201_207_245_255_279_318_320_335_386_391_407_421_422_434_440_460_521_530_546_546_553_555_555_562_665_753_816_823_910_913_923_931_940_974_976_1004_1033_1105_1110_1118_1124_1131_1149_1156_1168_1175_1208_1280_1287_1309_1313_1326_1326_1342_1366_1367_1386_1423_1423_1477_1484_1495_1500_,2053_2062_2069_2111_2153_2231_2231_2231_2252_2253_2321_2322_2322_2323_2346_2351_2457_2459_2473_2481_2482_2535_2535_2548_2559_2561_2562_2565_2621_2651_2654_2671_2690_2699_2709_2711_2717_2718_2718_2720_2721_2721_2753_2761_2762_2763_2809_2824_2826_2831_2832_2846_2861_2917_2921_2933_2949_2954_2961_2963_2976_2985_3059_3069_3070_3076_3076_3084_3092_3103_3103_3119_3123_3124_3133_3140_3141_3159_3160_3184_3192_3195_3252_3306_3308_3323_3323_3324_3333_3382_3388_3440_3442_3452_3457_3459_3460_3487_3489_3491_3493_
78,1,送上,Vt,11,0,11,84_242_252_520_529_711_711_721_721_1378_,
78,1,夏日,N,3,0,3,84_433_,
78,1,檸檬茶,N,2,0,2,84_,
78,3,啤酒,N,5,2,7,78_84_84_785_,2908_
78,1,冰,N,3,0,3,84_745_,
78,3,夜晚,N,4,6,10,84_837_904_,2813_2861_3009_3010_3397_
78,3,朋友,N,79,100,179,78_84_84_101_120_128_151_201_207_242_252_281_281_390_396_401_401_407_407_424_442_446_454_461_461_462_462_499_521_530_554_563_630_630_630_649_649_655_655_684_704_706_773_777_837_901_901_910_935_957_970_974_995_996_1062_1169_1176_1195_1195_1197_1198_1198_1200_1211_1232_1242_1246_1254_1254_1317_1322_1339_1345_1366_1423_1431_1473_1497_,2009_2009_2036_2069_2104_2131_2133_2161_2195_2234_2264_2284_2354_2355_2360_2360_2361_2361_2388_2388_2400_2402_2497_2516_2516_2518_2518_2525_2528_2529_2543_2549_2549_2550_2550_2621_2621_2621_2669_2669_2669_2704_2739_2743_2743_2743_2746_2750_2750_2753_2769_2770_2775_2836_2881_2883_2908_2946_2956_2957_3007_3016_3016_3043_3056_3072_3074_3083_3142_3146_3160_3181_3193_3196_3246_3249_3272_3274_3279_3296_3320_3329_3340_3353_3353_3353_3353_3355_3355_3355_3355_3360_3397_3414_3418_3418_3429_3443_3478_
78,1,適時,ADV,2,0,2,84_,
78,3,貼心,Vi,7,2,9,84_424_550_550_559_559_,2762_
78,3,露天,N,10,4,14,79_84_85_707_717_856_865_1343_1437_,2361_2561_2562_
78,1,暢談,Vt,2,0,2,84_,
78,1,愜意,Vi,12,0,12,84_228_242_252_268_335_716_726_805_885_893_,
79,3,軟,Vi,4,4,8,85_540_806_,2446_2791_2864_
79,3,單調,Vi,5,1,6,85_647_653_1007_,
79,3,吹,Vt,4,3,7,85_711_721_,2703_3484_
79,3,酒,N,7,12,19,85_819_1087_1398_1407_1437_,2085_2093_2101_2102_2463_2465_3089_3174_3308_3495_3497_
79,1,些少,A,2,0,2,85_,
79,3,到位,Vi,31,8,39,85_141_316_373_381_384_411_667_755_757_888_896_906_913_948_1030_1067_1074_1110_1115_1118_1184_1190_1254_1259_1349_1473_1480_1487_1500_,2631_2781_2853_2907_3008_3084_3241_
79,3,主要,ADV,24,21,45,85_231_269_412_498_572_581_885_893_914_1107_1141_1143_1234_1328_1328_1337_1374_1431_1491_1491_1494_1494_,2305_2308_2308_2409_2410_2483_2500_2501_2549_2550_2746_2781_2817_2819_2844_3031_3259_3283_3388_3395_
79,3,周到,Vi,64,4,68,85_104_153_187_197_242_242_242_247_248_252_252_252_257_258_337_347_347_357_357_372_470_474_503_514_514_522_523_531_532_607_613_622_629_634_710_714_720_724_765_773_777_819_959_961_962_1018_1046_1083_1129_1136_1237_1237_1238_1309_1313_1419_1481_1488_1490_1493_1495_1497_,2780_3083_3146_
79,1,啤酒節,N,2,0,2,85_,
79,1,涼爽,Vi,2,0,2,85_,
80,3,原因,N,23,34,57,86_103_108_121_129_275_294_302_322_444_452_494_540_582_583_887_895_1091_1311_1315_1427_1497_,2081_2083_2104_2106_2155_2158_2219_2221_2276_2309_2367_2388_2419_2473_2517_2519_2522_2525_2669_2684_2687_2705_2706_2781_2862_2889_2890_2956_2957_3074_3132_3224_3371_
80,3,賺錢,Vi,2,4,6,86_,2535_2815_3159_
80,3,維修,Vt,4,3,7,86_335_675_,2140_2528_
80,3,真正,A,15,8,23,86_108_242_242_242_252_252_252_662_710_720_907_1098_1387_,2309_2534_2535_2862_3296_3347_3347_
80,3,理由,N,2,24,26,86_,2211_2231_2295_2318_2319_2322_2565_2776_2816_2818_2841_3038_3039_3073_3146_3193_3260_3319_3331_3341_3413_3419_3473_
81,3,空間,N,20,10,30,87_160_227_248_258_376_395_641_818_925_933_971_980_981_1055_1211_1334_1337_1418_,2298_2301_2338_2434_2483_2589_2866_2946_3333_
81,3,團隊,N,3,5,8,87_830_,2305_2308_2851_3115_
81,3,氣氛,N,4,1,5,87_794_797_,
81,1,演奏,Vt,2,0,2,87_,
81,1,唱,Vt,2,0,2,87_,
81,3,歐式,A,3,1,4,87_844_,
81,3,裝飾,N,13,10,23,87_242_252_295_303_341_407_506_628_663_1439_1444_,2417_2492_2761_2762_2934_3110_3392_3394_3414_
81,3,帶,Vt,60,56,116,87_186_196_215_231_231_245_255_276_298_306_315_316_316_388_669_674_716_726_738_755_756_757_758_773_777_852_861_872_872_873_880_880_881_887_895_901_906_1016_1016_1057_1057_1062_1087_1091_1106_1204_1211_1249_1251_1311_1315_1326_1411_1416_1423_1472_1481_1488_,2047_2070_2175_2206_2284_2291_2298_2301_2322_2333_2334_2384_2445_2446_2483_2483_2517_2519_2534_2541_2566_2606_2629_2629_2649_2666_2718_2721_2731_2746_2775_2776_2816_2818_2861_2869_2918_2934_2946_3016_3086_3119_3119_3124_3124_3274_3274_3360_3418_3418_3427_3443_3448_3453_3463_
81,3,表演,N,5,2,7,87_91_967_1371_,2008_
81,1,有禮,Vi,3,0,3,87_641_,
81,3,風格,N,11,5,16,87_139_283_323_788_846_1010_1051_1244_1248_,2417_2703_2703_3345_
81,3,一起,ADV,17,25,42,87_295_303_628_738_770_774_856_865_1061_1115_1211_1242_1246_1345_1409_,2192_2211_2269_2338_2517_2519_2769_2769_2770_2770_2775_2829_2836_2946_2964_3061_3289_3290_3296_3331_3341_3360_3397_3487_
81,1,趕巧,Vi,2,0,2,87_,
81,3,溫馨,Vi,42,9,51,87_106_242_246_252_256_334_341_351_361_434_436_482_491_548_550_557_559_594_603_659_793_794_795_796_797_798_813_819_1007_1026_1050_1181_1187_1309_1313_1397_1406_1419_1481_1488_,2753_2862_2906_3213_3213_3218_3218_3282_
82,3,低,Vi,29,64,93,88_101_103_109_119_127_156_227_273_411_636_638_662_842_870_878_887_887_895_895_1049_1061_1112_1120_1127_1134_1138_1204_,2060_2074_2075_2131_2133_2153_2174_2205_2243_2328_2330_2335_2342_2452_2471_2478_2522_2559_2586_2594_2714_2750_2761_2762_2838_2854_2864_2879_2880_2883_2895_2949_2955_2996_2996_2999_3046_3050_3108_3109_3177_3196_3262_3263_3295_3319_3320_3344_3345_3372_3400_3406_3406_3411_3411_3433_3434_3435_3436_3448_3453_3473_3492_
82,3,稍微,ADV,21,12,33,88_118_126_160_213_227_246_256_483_492_551_560_669_677_770_774_1038_1235_1261_1377_,2207_2353_2509_2718_2721_2857_2858_3243_3246_3451_3456_
82,3,拖鞋,N,13,33,46,88_171_672_787_978_1029_1029_1091_1091_1154_1161_1499_,2193_2231_2318_2318_2318_2318_2319_2319_2319_2319_2398_2404_2450_2453_2516_2518_2534_2553_2553_2642_2646_2649_2649_2824_2826_2874_2972_3204_3205_3266_3288_3419_
82,3,家,N,47,78,125,88_89_94_242_252_431_468_472_499_700_701_701_702_703_704_705_706_707_710_717_720_793_796_819_962_1007_1051_1051_1054_1054_1062_1089_1149_1156_1181_1187_1209_1310_1310_1311_1314_1314_1315_1387_1387_1389_,2043_2045_2074_2252_2252_2253_2253_2255_2257_2284_2284_2284_2284_2333_2334_2389_2439_2442_2454_2455_2525_2587_2637_2637_2638_2638_2707_2708_2719_2722_2747_2750_2750_2750_2766_2806_2851_2852_2862_2862_2863_2869_2889_2890_2893_2898_2898_2906_2925_2972_2972_3020_3062_3064_3073_3074_3076_3085_3112_3134_3201_3214_3219_3242_3257_3275_3281_3293_3347_3360_3360_3397_3418_3426_3463_3473_3473_
82,3,放,Vt,29,78,107,88_186_196_203_209_287_290_374_376_546_555_630_699_699_701_754_822_842_1217_1270_1273_1367_1371_1473_1481_1488_1490_1493_,2047_2057_2057_2135_2151_2161_2175_2205_2211_2240_2252_2252_2253_2253_2269_2298_2301_2391_2419_2487_2488_2490_2490_2525_2525_2651_2654_2679_2680_2718_2721_2753_2804_2881_2888_2902_2904_2907_2939_2940_2954_2970_2974_3001_3043_3055_3115_3139_3139_3150_3184_3204_3213_3218_3231_3279_3289_3289_3289_3289_3289_3290_3290_3290_3290_3290_3310_3327_3375_3377_3448_3448_3448_3453_3453_3453_3473_
82,3,傢俱,N,12,30,42,88_109_342_352_551_560_611_620_736_974_1039_,2109_2153_2240_2267_2388_2406_2408_2417_2418_2517_2519_2544_2616_2651_2654_2731_2742_2742_2742_2756_2815_2997_3012_3103_3104_3214_3219_3265_3473_
82,3,價位,N,32,10,42,88_101_103_213_229_287_447_455_631_645_651_700_735_787_788_789_830_886_894_939_968_986_1181_1187_1244_1248_1318_1323_1399_1491_1494_,2426_2489_2698_2740_2797_2840_3430_3473_3473_
82,3,4星,N,21,57,78,88_109_114_253_323_339_341_427_427_440_551_560_566_575_753_753_987_1089_1251_1257_,2078_2202_2229_2258_2258_2259_2259_2266_2367_2452_2551_2573_2728_2729_2768_2768_2768_2798_2800_2815_2824_2826_2869_2877_2878_2917_2917_2953_2954_2961_2961_2963_2963_2972_2972_3001_3024_3026_3038_3039_3088_3097_3101_3102_3180_3190_3242_3331_3347_3347_3347_3425_3458_3458_3463_3492_
82,3,算是,Vt,36,20,56,88_118_126_154_154_222_228_228_278_285_412_424_440_466_500_783_784_786_786_833_885_893_923_931_1171_1178_1213_1236_1242_1246_1268_1271_1274_1409_1437_,2162_2299_2302_2532_2533_2731_2775_2786_2788_2836_2846_3152_3163_3223_3364_3422_3458_3488_3490_
82,3,一般,Vi,92,166,258,88_90_91_109_133_149_150_160_186_196_234_253_260_262_290_321_328_333_336_376_386_389_428_466_476_479_485_488_495_549_558_610_611_619_620_632_644_644_688_688_689_693_693_694_746_780_783_784_784_794_797_812_907_910_921_923_931_935_945_954_962_968_977_1005_1040_1044_1054_1112_1114_1120_1145_1171_1178_1202_1204_1219_1221_1256_1334_1343_1355_1355_1360_1360_1408_1413_1427_1430_1437_1437_1438_,2014_2014_2032_2034_2037_2037_2042_2057_2060_2066_2068_2073_2077_2088_2089_2098_2108_2136_2139_2140_2143_2153_2186_2198_2220_2222_2232_2235_2236_2242_2260_2264_2265_2265_2280_2289_2292_2318_2318_2319_2319_2353_2358_2389_2396_2417_2424_2426_2448_2451_2492_2505_2506_2507_2546_2587_2592_2596_2597_2624_2626_2630_2634_2634_2648_2651_2652_2652_2654_2655_2655_2662_2698_2698_2707_2708_2730_2734_2741_2741_2761_2762_2764_2764_2766_2771_2783_2794_2815_2817_2819_2820_2829_2834_2841_2846_2850_2860_2860_2866_2874_2907_2912_2917_2932_2943_2951_2953_2987_3012_3012_3025_3027_3032_3033_3040_3055_3066_3068_3074_3088_3099_3103_3111_3116_3119_3124_3135_3145_3145_3154_3155_3157_3171_3171_3173_3173_3185_3192_3197_3199_3211_3213_3216_3218_3233_3249_3273_3282_3307_3319_3335_3336_3339_3414_3415_3439_3440_3441_3442_3464_3467_3487_3494_3496_
82,1,清潔工,N,3,0,3,88_316_,
89,3,擔心,Vt,5,5,10,226_629_819_910_,2724_2798_2800_3056_
89,3,確定,Vt,2,5,7,1232_,2818_2873_3294_3386_
89,3,走進,Vt,5,5,10,714_724_738_902_,2378_2492_3223_3397_
89,3,溫暖,Vt,10,2,12,316_522_531_710_720_889_897_1023_1062_,2967_
89,3,步行,Vi,42,9,51,101_103_106_113_148_165_170_185_195_272_381_384_394_410_521_530_584_771_775_801_811_813_828_837_849_849_875_883_901_912_1062_1067_1067_1070_1074_1074_1077_1228_1230_1386_1386_,2484_2509_2656_2725_2815_3011_3171_3173_
89,3,船,N,3,4,7,89_908_,3434_3436_3436_
89,1,得以,ADV,2,0,2,1031_,
89,3,有效,Vi,3,4,7,1319_1324_,2747_3032_3033_
89,1,大連灣,N,1,0,1,,
89,3,大概,ADV,17,20,37,248_258_316_630_630_670_674_710_720_808_835_917_1020_1081_1140_1211_,2015_2269_2269_2339_2342_2372_2375_2426_3013_3061_3150_3185_3431_3432_3433_3434_3435_3436_3443_
89,3,親切,Vi,16,6,22,335_582_583_630_714_724_875_883_910_1060_1088_1296_1300_1437_1500_,2259_2360_2361_2508_3146_
89,1,大連港,N,1,0,1,,
89,3,三星,N,15,66,81,149_213_410_411_419_641_743_991_994_1048_1140_1193_1329_1436_,2058_2073_2084_2085_2093_2099_2115_2118_2124_2144_2145_2181_2186_2190_2197_2267_2320_2342_2370_2373_2378_2384_2388_2399_2401_2419_2424_2426_2450_2453_2457_2470_2483_2504_2504_2517_2519_2524_2608_2608_2679_2690_2767_2773_2836_2885_2887_2906_2907_2931_3020_3020_3052_3053_3088_3141_3191_3213_3218_3232_3242_3347_3347_3395_3397_
89,3,快捷,Vi,10,24,34,155_961_1054_1244_1248_1309_1310_1313_1314_,2053_2060_2153_2153_2252_2252_2253_2253_2637_2637_2638_2638_2670_2851_2862_2862_2919_2949_3020_3062_3165_3448_3453_
89,3,碼頭,N,9,4,13,339_783_842_842_842_888_896_921_,3434_3436_3436_
89,3,有空,Vi,1,1,2,,
89,3,忐忑不安,Vi,1,1,2,,
89,3,早,Vi,27,34,61,172_244_254_290_290_340_373_524_533_595_604_630_753_754_786_830_982_1003_1008_1100_1228_1230_1271_1274_1303_1306_,2163_2211_2224_2246_2266_2279_2342_2426_2438_2440_2534_2546_2623_2731_2775_2867_2873_2882_2967_2988_3119_3124_3153_3184_3195_3202_3258_3289_3290_3312_3360_3379_3492_
89,3,掛,Vt,9,32,41,334_427_520_529_641_1139_1481_1488_,2081_2083_2235_2236_2240_2241_2267_2320_2328_2328_2330_2330_2360_2361_2674_2723_2764_2922_2967_3008_3076_3076_3152_3194_3234_3397_3397_3433_3433_3435_3435_
89,3,然後,ADV,10,64,74,112_320_320_584_923_931_1089_1316_1321_,2072_2164_2206_2208_2231_2252_2253_2269_2269_2322_2387_2391_2510_2511_2549_2549_2550_2550_2565_2565_2584_2604_2608_2647_2775_2775_2775_2775_2834_2861_2869_2922_2925_3040_3074_3083_3119_3124_3129_3130_3132_3150_3170_3172_3226_3254_3255_3256_3274_3281_3288_3289_3290_3433_3433_3433_3435_3435_3435_3448_3453_3462_3477_
89,3,打車,N,18,9,27,348_520_529_582_583_632_844_854_863_886_894_1005_1005_1020_1140_1304_1307_,2795_2815_2956_2957_3032_3033_3319_3447_
89,3,對得起,Vt,8,1,9,395_432_551_560_746_885_893_,
89,3,遊客,N,9,17,26,245_255_521_530_782_816_913_964_,2036_2197_2326_2517_2519_2769_2770_2933_3132_3225_3246_3246_3246_3253_3433_3435_
89,3,只有,ADV,24,44,68,112_213_287_413_471_475_592_601_701_835_875_883_886_894_1009_1033_1062_1106_1112_1120_1411_1416_1418_,2162_2194_2232_2264_2266_2372_2375_2386_2434_2473_2517_2519_2623_2636_2639_2698_2724_2731_2742_2821_2888_2893_2919_2980_3009_3010_3022_3023_3056_3065_3067_3076_3132_3171_3173_3205_3331_3434_3436_3460_3462_3476_3478_
89,1,王國,N,1,0,1,,
89,3,早上,N,49,81,130,112_116_156_172_173_186_196_239_249_283_363_363_368_368_379_397_412_471_475_517_546_555_582_583_617_626_628_783_805_821_835_849_889_897_910_912_923_931_939_980_1008_1055_1088_1088_1319_1324_1421_1465_,2026_2037_2039_2041_2134_2136_2140_2148_2162_2211_2233_2272_2291_2324_2326_2406_2408_2436_2444_2445_2446_2483_2493_2531_2540_2549_2550_2576_2647_2671_2674_2710_2712_2767_2795_2809_2816_2818_2828_2853_2861_2862_2864_2867_2875_2881_2953_2979_3013_3016_3020_3040_3044_3044_3048_3048_3083_3103_3150_3175_3176_3180_3239_3243_3246_3253_3278_3291_3291_3292_3292_3308_3308_3331_3360_3418_3431_3432_3470_3470_
89,1,溫和,Vi,3,0,3,887_895_,
89,3,外出,Vi,7,8,15,714_724_962_1233_1463_1468_,2301_2582_2835_2924_3129_3130_3288_
89,3,送到,Vt,13,9,22,185_195_554_563_631_632_709_719_782_886_894_966_,2143_2609_2798_2800_3186_3188_3431_3432_
89,1,趕往,Vt,1,0,1,,
89,3,休息,Vi,10,34,44,100_107_435_628_707_717_1040_1442_1447_,2134_2191_2191_2191_2211_2231_2231_2246_2417_2561_2562_2575_2579_2700_2701_2734_2740_2861_2867_3008_3119_3124_3247_3253_3259_3341_3360_3360_3360_3375_3377_3431_3432_
90,3,馬馬虎虎,Vi,3,4,7,1463_1468_,2541_3132_3243_
91,3,超出,Vt,3,1,4,929_937_,
91,1,隆重,Vi,1,0,1,,
91,1,達美,N,1,0,1,,
91,3,早餐券,N,7,15,22,91_91_91_540_1096_1452_,2454_2454_2455_2455_2761_2762_2893_3083_3083_3431_3431_3432_3432_3471_
91,3,面積,N,29,21,50,201_207_260_262_275_281_291_299_328_333_341_433_553_562_753_788_790_804_827_850_906_917_978_1155_1162_1183_1189_1235_,2388_2389_2463_2465_2586_2607_2726_2727_2804_2840_2882_2951_2954_3083_3083_3111_3171_3173_3345_3345_
91,3,遠遠,Vi,2,6,8,902_,2266_3007_3133_3352_3354_
91,3,茶,N,9,2,11,641_790_814_819_857_866_921_1251_,3280_
91,1,印度,N,2,0,2,1048_,
91,3,孩子,N,19,15,34,239_245_245_249_255_255_316_443_710_710_720_720_872_873_880_881_901_1057_,2231_2322_2333_2334_2384_2384_2483_2517_2517_2519_2519_2869_2946_2946_
91,3,顯,Vt,23,4,27,95_118_126_342_352_415_522_523_531_532_618_627_811_949_960_1020_1327_1329_1345_1383_1481_1488_,2454_2455_2971_
91,3,大氣,N,4,2,6,293_301_1017_,2302_
91,1,俄羅斯,N,2,0,2,431_,
91,3,門童,N,7,30,37,670_886_886_894_894_1376_,2206_2362_2388_2419_2450_2453_2464_2466_2492_2572_2757_2757_2758_2758_2809_2838_2838_2988_3076_3133_3231_3231_3231_3282_3425_3433_3433_3435_3435_
91,3,現場,N,1,6,7,,2530_2873_3418_3489_3491_
91,1,調節稅,N,1,0,1,,
91,3,雙人,N,11,11,22,91_276_540_540_1070_1077_1270_1270_1273_1273_,2008_2057_2325_2454_2455_2494_2495_2754_2775_2846_
91,3,支付,Vt,3,6,9,756_758_,2893_3246_3246_3255_3256_
91,3,5星級,N,4,5,9,1394_1403_1437_,2854_2923_2923_2923_
91,1,鷯哥,N,1,0,1,,
91,1,勝過,Vt,1,0,1,,
91,3,特色,N,35,9,44,99_101_228_246_256_386_468_472_482_491_520_529_554_563_644_657_711_721_815_892_900_957_1007_1007_1103_1114_1164_1166_1271_1274_1326_1389_1481_1488_,2347_2492_2740_2741_2764_3115_3132_3458_
91,3,泰,N,1,2,3,,2970_
91,3,晚餐,N,14,4,18,184_194_228_520_520_529_529_707_717_852_861_1028_1086_,2520_2520_3062_
91,3,自費,Vi,1,3,4,,3177_3177_
91,3,吸引,Vt,5,3,8,641_714_724_739_,3111_3360_
91,3,付費,Vi,1,6,7,,2616_2714_2972_3360_3445_
91,3,不要,ADV,20,146,166,281_320_417_670_711_721_730_807_870_871_873_878_879_881_974_1212_1342_1423_1472_,2020_2043_2044_2045_2066_2074_2081_2083_2108_2116_2119_2124_2127_2131_2133_2136_2140_2151_2231_2232_2237_2238_2260_2273_2287_2288_2323_2328_2330_2384_2384_2388_2391_2398_2417_2450_2453_2457_2476_2486_2492_2492_2497_2502_2510_2511_2517_2519_2521_2523_2527_2535_2547_2549_2550_2551_2572_2573_2573_2595_2600_2604_2608_2608_2631_2669_2671_2674_2710_2712_2746_2746_2746_2757_2758_2759_2773_2782_2794_2796_2802_2803_2831_2832_2881_2908_2946_2958_2975_3001_3004_3015_3016_3038_3039_3043_3056_3071_3076_3076_3123_3133_3138_3142_3160_3160_3163_3184_3185_3193_3205_3231_3249_3252_3272_3288_3296_3307_3316_3340_3342_3345_3347_3359_3361_3362_3391_3393_3397_3397_3418_3418_3433_3434_3435_3436_3440_3442_3443_3446_3452_3457_3460_3488_3490_
91,1,俄式,A,1,0,1,,
91,1,爵,Vt,1,0,1,,
91,1,羊扒,N,1,0,1,,
91,1,男女聲,N,1,0,1,,
91,1,抵用,Vt,1,0,1,,
91,1,烤制,N,1,0,1,,
91,3,你好,Vt,1,2,3,,2453_
91,1,侷促,Vi,3,0,3,641_842_,
91,3,提供,Vt,66,94,160,91_112_113_113_115_149_171_184_186_194_196_316_449_457_499_499_515_538_568_577_585_628_630_631_632_641_660_714_714_724_724_756_758_766_766_801_885_893_944_1005_1029_1029_1030_1032_1054_1054_1069_1076_1100_1126_1129_1133_1136_1208_1231_1239_1309_1313_1319_1324_1352_1371_1436_1450_1500_,2037_2037_2037_2050_2053_2094_2096_2232_2232_2280_2284_2303_2305_2306_2308_2388_2399_2401_2417_2419_2445_2445_2446_2446_2517_2519_2551_2552_2552_2553_2553_2573_2606_2616_2616_2647_2656_2672_2674_2702_2714_2746_2747_2761_2761_2762_2762_2784_2791_2794_2847_2869_2881_2973_2980_3031_3031_3031_3035_3038_3039_3049_3069_3070_3073_3097_3118_3118_3118_3129_3129_3130_3130_3132_3139_3146_3153_3158_3158_3158_3246_3252_3341_3345_3345_3345_3371_3431_3432_3443_3466_3475_3477_
92,3,點心,N,18,3,21,245_245_246_255_255_256_424_550_559_669_710_720_795_798_1005_1334_1425_,2754_2754_
92,3,女士,N,8,10,18,482_482_491_491_890_898_1029_,2671_2671_2671_2671_2746_2746_2976_3163_3205_
92,1,店不好,Vt,1,0,1,,
92,1,美酒,N,1,0,1,,
92,3,經驗,N,4,6,10,1061_1091_1211_,2360_2361_2609_3448_3453_
92,3,停車,Vi,24,27,51,123_124_131_132_142_155_162_163_167_168_268_320_327_332_401_439_445_453_663_680_727_842_1345_,2040_2074_2136_2140_2208_2360_2360_2361_2361_2589_2889_2890_2907_2934_2934_2975_3038_3039_3142_3225_3241_3241_3376_3376_3378_3378_
92,3,吸取,Vt,2,1,3,1091_,
93,3,趕上,Vt,14,7,21,99_113_288_335_377_582_583_708_718_830_1005_1249_1254_,2008_2124_2616_2815_2953_3041_
93,3,超過,Vt,3,17,20,940_1239_,2146_2353_2391_2492_2498_2502_2516_2518_2616_2893_2959_3289_3290_3307_3418_3460_
93,3,結賬,Vi,20,18,38,334_397_546_546_546_546_546_546_555_555_555_555_555_555_792_921_921_960_1336_,2126_2170_2421_2515_2549_2550_2567_2567_2592_2667_2680_2700_2701_2847_3264_3264_3473_
94,1,洗髮膏,N,1,0,1,,
94,3,聞,Vt,4,6,10,481_870_878_,2444_2863_3030_3289_3290_
94,1,串,Vt,2,0,2,1211_,
94,1,雞肉,N,1,0,1,,
94,3,好吃,Vi,19,12,31,116_276_283_287_540_571_580_821_835_891_899_952_953_1040_1042_1057_1334_1358_,2133_2509_2537_2538_2756_2847_2941_3186_3188_3333_3475_
94,3,看得出來,Vt,1,1,2,,
94,3,沐浴,Vi,1,3,4,,3448_3453_
94,3,強烈,Vi,11,51,62,139_320_477_486_540_665_974_1203_1366_1423_,2111_2244_2245_2266_2273_2290_2323_2363_2363_2457_2510_2511_2516_2517_2518_2519_2521_2669_2709_2711_2731_2791_2802_2837_2861_2879_2880_2908_2954_2961_2963_3059_3069_3070_3071_3085_3098_3119_3124_3133_3255_3256_3288_3324_3382_3386_3389_3390_3414_3493_
94,3,出,Vt,32,47,79,150_215_245_255_275_336_445_453_481_618_627_710_720_793_796_823_856_859_865_868_910_944_1141_1143_1239_1256_1337_1366_1418_1423_1472_,2012_2015_2059_2099_2186_2269_2272_2303_2306_2318_2319_2392_2425_2428_2484_2489_2498_2521_2579_2598_2730_2756_2842_2843_2892_2892_2898_2907_2976_2986_2988_3022_3023_3062_3074_3074_3103_3111_3205_3237_3260_3289_3290_3294_3336_3356_
94,1,章魚,N,1,0,1,,
94,3,左,N,4,2,6,418_670_1017_,3475_
94,1,丸子,N,2,0,2,94_,
94,1,小路,N,4,0,4,351_361_1040_,
94,1,霜,N,1,0,1,,
94,3,露,Vt,1,1,2,,
94,3,5星,N,15,6,21,109_246_256_287_506_517_646_652_858_867_1001_1086_1089_1089_,2335_2731_2873_3110_3342_
94,1,坐落,Vi,3,0,3,783_792_,
94,3,要好,Vi,7,4,11,246_256_391_428_1060_1088_,2879_2880_3103_
94,3,後面,N,16,26,42,338_517_547_556_611_620_701_728_792_848_1016_1040_1114_1231_1343_,2077_2151_2322_2372_2375_2391_2436_2527_2567_2572_2572_2576_2744_2756_2835_3020_3115_3175_3176_3184_3231_3264_3319_3341_3360_
94,3,繞到,Vt,1,1,2,,
94,1,潤膚,Vi,1,0,1,,
94,3,門面,N,2,5,7,842_,2098_2353_2682_2685_
94,3,久遠,Vi,1,3,4,,3479_3481_
95,3,嘈雜,Vi,5,9,14,902_957_1346_1425_,2110_2120_2121_2164_2168_2246_2740_2845_
95,3,略,ADV,19,6,25,118_126_245_255_523_532_676_679_779_949_1005_1005_1005_1020_1037_1327_1345_1366_,2642_2646_2646_3319_3336_
98,3,逛街,Vi,12,9,21,550_559_679_782_786_805_907_923_931_1431_1496_,2189_2299_2302_2360_2361_2829_2939_2940_
98,1,打法,N,1,0,1,,
98,3,大巴,N,18,8,26,271_271_584_886_886_886_886_894_894_894_894_949_1011_1316_1321_1386_1431_,2231_2283_2283_2283_2525_3013_3013_
98,1,商城,N,1,0,1,,
98,3,火車,N,7,14,21,152_152_379_677_677_957_,2136_2138_2140_2140_2295_2603_2605_2744_3049_3118_3149_3291_3292_
98,1,恆基,N,1,0,1,,
98,3,時光,N,3,1,4,710_720_,
98,3,機場,N,51,53,104,227_227_227_498_500_503_521_530_582_583_644_646_649_652_655_670_702_702_702_702_709_719_783_783_801_842_844_849_906_917_949_1011_1011_1052_1082_1090_1201_1201_1201_1201_1256_1343_1385_1386_1431_1440_1445_1455_1469_1470_,2137_2141_2162_2162_2206_2283_2283_2304_2305_2305_2307_2308_2308_2458_2525_2651_2654_2688_2689_2700_2700_2701_2701_2754_2754_2772_2798_2800_2812_2813_2961_2963_2969_2972_3055_3074_3159_3159_3159_3159_3159_3159_3159_3159_3159_3159_3254_3255_3256_3414_3447_3475_
98,3,汽車,N,3,7,10,632_1267_,3051_3098_3118_3205_3332_3476_
99,3,九點鐘,N,1,1,2,,
99,1,匠心,N,1,0,1,,
99,3,營業,Vi,7,9,16,148_162_167_990_993_1005_,2557_2802_2861_2945_2952_3118_3360_3487_
99,3,可口,Vi,3,3,6,639_805_,2253_3333_
99,3,胡同,N,4,9,13,101_101_1024_,2444_2484_2484_2492_2598_3195_3196_3196_
99,3,三樓,N,10,9,19,480_489_814_815_819_876_884_917_956_,2623_2946_2973_3029_3034_3319_3433_3435_
99,1,太早,ADV,1,0,1,,
99,1,對門,N,3,0,3,991_994_,
99,3,小吃,N,17,7,24,101_103_381_384_386_522_531_814_945_1070_1077_1194_1242_1243_1246_1247_,2131_2133_2133_2235_2236_3277_
99,3,半夜,N,8,49,57,239_249_408_835_1114_1383_1498_,2119_2134_2159_2159_2273_2273_2326_2522_2526_2526_2540_2544_2579_2630_2671_2784_2784_2784_2791_2861_2862_2898_2925_2926_2946_2953_2971_2972_2976_2989_2991_3041_3091_3146_3181_3204_3205_3231_3231_3289_3290_3341_3360_3380_3397_3425_3470_3476_
99,3,收視,N,1,1,2,,
99,3,飯菜,N,11,2,13,495_677_681_682_858_867_1475_1481_1482_1488_,3259_
99,3,斜,Vi,1,1,2,,
99,3,飯店,N,65,61,126,99_148_150_152_225_225_225_227_227_227_228_229_246_256_297_305_347_347_357_357_391_482_491_498_515_515_516_516_516_517_517_517_517_517_517_543_628_628_629_629_657_711_721_957_982_982_1006_1040_1040_1251_1276_1283_1296_1300_1311_1315_1344_1399_1399_1399_1472_1473_1475_1482_,2086_2089_2089_2134_2163_2166_2175_2175_2175_2175_2184_2189_2189_2189_2231_2241_2264_2347_2426_2426_2426_2462_2498_2565_2594_2613_2678_2680_2680_2680_2680_2700_2701_2730_2742_2759_2759_2772_2857_2858_2908_2976_3012_3014_3098_3149_3163_3163_3257_3279_3333_3333_3360_3360_3361_3362_3365_3448_3453_3493_
99,3,桌子,N,11,20,31,158_886_894_990_993_1007_1007_1007_1266_1430_,2574_2609_2718_2721_2869_2888_2888_3115_3150_3212_3213_3217_3218_3276_3289_3289_3290_3290_3379_
99,3,人間,N,11,8,19,100_104_521_530_540_924_932_1249_1294_1298_,2077_2103_2385_2411_2563_3019_3089_
99,3,設計,N,22,15,37,102_260_262_662_711_713_721_723_750_761_842_964_984_1029_1356_1361_1398_1407_1409_1473_1473_,2246_2264_2450_2453_2517_2519_2623_2647_2730_2741_3056_3111_3295_3345_
99,3,只是,ADV,21,40,61,145_242_252_272_365_370_553_562_593_602_808_858_867_923_931_1153_1160_1197_1200_1425_,2041_2071_2149_2194_2220_2222_2280_2287_2288_2309_2372_2375_2452_2457_2508_2569_2572_2572_2609_2861_2892_2917_2946_3049_3162_3170_3172_3194_3196_3246_3253_3283_3296_3327_3379_3397_3433_3435_3470_
99,1,別具,Vt,1,0,1,,
99,3,名字,N,11,23,34,336_422_521_530_629_710_720_856_865_1060_,2081_2081_2083_2083_2313_2316_2372_2375_2426_2484_2527_2527_2671_3163_3223_3305_3367_3367_3367_3368_3368_3368_
99,1,湯麵,N,1,0,1,,
99,3,忘記,Vt,13,11,24,136_137_137_186_196_276_282_875_883_886_894_1106_,2097_2731_2902_2904_3014_3038_3039_3234_3433_3435_
100,3,走到,Vt,9,4,13,889_897_917_1112_1120_1169_1176_1495_,2445_2446_3447_
100,3,處,N,24,17,41,109_162_167_182_192_374_657_707_717_787_837_854_863_924_932_1023_1030_1071_1078_1104_1352_1481_1488_,2239_2274_2359_2360_2361_2607_2678_2802_2883_2908_3231_3235_3246_3443_3448_3453_
100,3,回,Vt,17,52,69,308_312_320_446_454_546_555_856_865_910_1061_1082_1319_1324_1451_1472_,2012_2081_2083_2159_2161_2291_2309_2398_2549_2549_2550_2550_2565_2582_2640_2680_2683_2686_2731_2731_2742_2753_2776_2797_2798_2800_2846_2873_2919_2923_2933_3007_3013_3034_3056_3170_3172_3184_3254_3257_3319_3338_3358_3360_3373_3374_3418_3433_3433_3435_3435_
100,1,剎海,N,1,0,1,,
100,1,晚間,N,3,0,3,924_932_,
100,3,用餐,Vi,14,8,22,350_360_520_529_707_711_717_721_1081_1168_1175_1254_1437_,2488_2531_2565_2746_2834_2976_3380_
100,3,外部,N,5,3,8,246_256_859_868_,2547_3164_
100,3,影響,Vt,18,33,51,213_507_507_628_640_657_672_707_717_814_889_897_1040_1278_1279_1285_1286_,2074_2138_2191_2191_2233_2327_2329_2363_2376_2417_2510_2511_2536_2549_2550_2575_2746_2747_2750_2861_2949_2956_2957_2960_2962_3009_3010_3011_3274_3484_3488_3490_
101,3,大好,Vi,1,1,2,,
101,3,足,N,13,2,15,245_255_678_835_1067_1067_1074_1074_1092_1316_1321_1473_,3098_
101,3,確實,ADV,54,27,81,111_172_180_190_213_239_241_241_245_246_249_251_251_255_256_281_281_308_312_321_326_331_351_361_417_449_457_460_613_622_662_700_700_713_723_736_842_857_866_876_884_889_889_897_897_913_923_931_970_1057_1092_1105_1472_,2108_2175_2175_2483_2571_2637_2638_2671_2671_2671_2723_2746_2746_2771_2922_2926_2930_2969_3055_3146_3170_3172_3272_3391_3393_3445_
101,1,京,N,2,0,2,399_,
101,3,暖氣,N,6,29,35,103_104_104_678_759_,2475_2649_2656_2773_2814_2814_2815_2972_2989_2991_2999_3031_3031_3073_3073_3187_3189_3208_3252_3252_3289_3290_3470_3470_3470_3470_3470_3476_
101,3,北海,N,3,4,7,794_797_,2272_3415_3415_
101,1,故居,N,1,0,1,,
101,3,優勢,N,12,10,22,275_279_427_888_896_983_1127_1134_1149_1156_1455_,2305_2308_2750_2797_2824_2826_2893_2934_2949_
101,3,節約,Vt,1,1,2,,
101,1,同胞,N,1,0,1,,
101,1,出發,Vi,5,0,5,885_893_1061_1455_,
101,3,消費,N,13,32,45,111_163_168_391_662_783_886_886_887_894_894_895_,2544_2594_2739_2739_2739_2867_2959_2996_3038_3038_3039_3039_3069_3070_3079_3079_3147_3150_3246_3246_3279_3313_3330_3385_3391_3393_3462_3462_3462_3462_3462_
101,3,熱心,Vt,6,2,8,215_890_898_1082_1431_,3012_
101,1,街道,N,2,0,2,944_,
101,3,因素,N,1,1,2,,
101,1,梅蘭芳,N,1,0,1,,
101,1,味小,N,1,0,1,,
101,3,北京,N,25,36,61,103_103_105_106_106_151_151_242_252_290_398_401_494_617_626_630_782_969_997_1091_1211_1261_1398_1407_,2022_2023_2243_2264_2266_2390_2390_2484_2484_2492_2517_2519_2522_2551_2552_2565_2587_2742_2864_2869_2972_2972_3040_3062_3112_3154_3155_3191_3194_3194_3195_3236_3347_3422_3438_
101,3,總之,ADV,17,65,82,215_230_245_255_522_524_531_533_876_884_889_897_910_1141_1143_1423_,2008_2066_2074_2175_2202_2204_2235_2236_2260_2269_2335_2338_2358_2360_2361_2421_2444_2459_2516_2518_2549_2550_2565_2600_2601_2659_2679_2683_2686_2713_2746_2753_2756_2766_2786_2788_2797_2808_2809_2881_2896_2987_2998_3022_3023_3084_3214_3219_3243_3260_3278_3284_3285_3288_3331_3405_3410_3433_3435_3451_3456_3477_3480_3482_
101,3,介紹,N,11,27,38,155_216_748_787_1103_1211_1250_1254_1268_1418_,2198_2267_2322_2376_2553_2571_2610_2718_2721_2757_2758_2872_2881_2921_2933_3083_3119_3124_3132_3254_3345_3363_3489_3489_3491_3491_
101,1,無超,N,1,0,1,,
101,3,推薦給,Vt,1,3,4,,2826_3345_
102,3,導致,Vt,12,7,19,171_186_196_253_298_306_391_546_555_1183_1189_,2102_2232_2647_2960_2962_3076_
102,1,積水,Vi,3,0,3,802_802_,
103,3,西,N,19,1,20,104_104_104_273_274_276_277_278_280_281_783_837_842_1141_1143_1234_1431_1431_,
103,1,北師大,N,1,0,1,,
103,1,省事,Vi,1,0,1,,
103,3,小吃店,N,2,1,3,823_,
103,3,街,N,27,29,56,103_118_126_148_273_274_276_280_281_381_384_408_412_657_670_788_848_887_895_1020_1194_1316_1320_1321_1325_1328_,2162_2162_2235_2236_2436_2756_2879_2880_2917_3059_3086_3103_3121_3126_3197_3199_3204_3205_3231_3319_3319_3319_3347_3417_3454_3487_3495_3497_
103,3,下,N,17,32,49,149_163_168_229_276_320_379_837_847_847_887_895_923_931_1029_1061_,2196_2198_2272_2283_2421_2522_2526_2565_2587_2589_2717_2720_2730_2730_2750_2785_2861_2907_2933_2946_2951_3037_3074_3159_3202_3204_3246_3392_3392_3394_3394_
103,3,辦事,Vi,5,13,18,225_402_835_1209_,2229_2287_2288_2509_3038_3039_3083_3279_3288_3433_3435_3443_
103,3,水溫,N,4,5,9,700_700_981_,3448_3448_3453_3453_
103,3,星級,N,16,62,78,140_272_281_391_480_489_502_502_710_710_720_720_755_757_1091_,2039_2041_2041_2050_2053_2088_2125_2241_2377_2395_2417_2464_2466_2473_2479_2516_2518_2531_2571_2587_2662_2775_2786_2788_2816_2818_2861_2871_2872_2872_2872_2872_2872_2872_2877_2878_2899_2919_2922_2922_2959_3012_3038_3039_3242_3276_3282_3289_3289_3290_3290_3305_3325_3347_3360_3415_3415_3415_3463_3489_3491_
103,3,省錢,Vi,4,3,7,600_609_906_,2716_3103_
103,1,水果攤,N,1,0,1,,
103,1,哪,ADV,1,0,1,,
103,1,頭櫃,N,1,0,1,,
103,3,冷忽熱,N,1,3,4,,3239_3333_
103,3,店裡,N,2,1,3,814_,
103,3,假,Vi,1,4,5,,2322_2812_3275_
103,3,沖澡,N,1,3,4,,2508_2522_
103,3,護國寺,N,1,2,3,,2012_
103,3,忽,ADV,1,7,8,,2873_2924_2971_3239_3246_3333_
103,1,充電,Vi,3,0,3,103_279_,
103,3,公用,A,1,4,5,,2730_3318_3319_
103,1,留意,Vt,1,0,1,,
103,3,三星級,N,15,41,56,429_745_759_794_797_989_992_1010_1213_1304_1307_1433_1435_1453_,2095_2097_2098_2105_2105_2149_2198_2211_2246_2270_2371_2374_2411_2413_2413_2414_2531_2585_2609_2609_2609_2671_2699_2713_2759_2779_2872_2922_2922_3034_3093_3105_3114_3333_3333_3389_3390_3452_3457_3460_
103,3,長途,A,16,19,35,269_363_368_554_563_660_677_730_1164_1166_1168_1175_1336_1433_1435_,2095_2095_2095_2097_2097_2097_2097_2269_2269_2313_2316_2579_3001_3137_3158_3194_3194_3444_
103,3,缺點,N,45,25,70,163_168_171_176_204_210_246_256_308_308_312_312_381_384_392_414_465_513_540_551_560_751_821_837_843_886_894_924_932_939_942_957_981_1007_1141_1143_1194_1201_1235_1332_1337_1392_1401_1409_,2206_2281_2282_2588_2705_2706_2797_2844_2845_2965_2966_2975_3031_3031_3056_3106_3293_3318_3375_3377_3471_3483_3488_3490_
103,3,插座,N,6,9,15,103_1007_1251_1359_1364_,2299_2302_2651_2654_2916_3333_3431_3432_
103,1,煙酒,N,2,0,2,1238_,
103,1,報刊廳,N,1,0,1,,
103,3,電視機櫃,N,1,1,2,,
103,3,大街,N,1,11,12,,2012_2059_2069_2608_2828_3376_3378_3413_3413_3484_
103,3,還不如,Vt,1,4,5,,2463_2465_2779_
103,3,王府井,N,2,1,3,1005_,
103,3,網,N,30,67,97,241_242_251_252_316_380_383_432_630_695_772_776_876_884_983_1005_1057_1141_1143_1169_1176_1195_1198_1309_1311_1313_1315_1450_1450_,2038_2040_2099_2108_2198_2232_2252_2253_2290_2342_2362_2391_2417_2454_2455_2476_2492_2502_2517_2519_2549_2550_2593_2652_2655_2681_2718_2721_2740_2750_2787_2789_2809_2829_2841_2845_2852_2925_2932_2933_2959_3007_3040_3042_3119_3124_3129_3130_3133_3210_3210_3210_3213_3215_3215_3215_3218_3253_3260_3260_3282_3315_3364_3391_3393_3487_
103,3,足夠,Vi,5,2,7,641_826_962_1423_,2882_
103,1,護國寺站,N,1,0,1,,
103,1,應有盡有,Vi,1,0,1,,
103,3,站,Vi,39,32,71,271_280_631_669_677_710_710_713_720_720_723_790_801_842_842_846_847_885_886_886_888_893_894_894_896_983_1092_1319_1324_1423_1430_1431_1431_1433_1435_1437_1491_1494_,2084_2085_2231_2231_2231_2283_2287_2288_2324_2333_2334_2416_2829_2835_3038_3039_3055_3100_3112_3118_3171_3173_3185_3213_3218_3231_3243_3289_3290_3296_3415_
103,3,窗,N,37,52,89,116_172_247_257_286_374_378_395_408_412_419_669_670_670_783_783_837_842_887_891_895_899_948_1012_1014_1015_1020_1056_1212_1304_1307_1311_1315_1383_1383_1496_,2205_2299_2302_2304_2304_2307_2307_2324_2324_2337_2337_2390_2411_2530_2530_2530_2530_2530_2629_2634_2671_2671_2717_2717_2720_2720_2728_2729_2731_2740_2841_2908_2914_2933_2976_3038_3039_3040_3071_3165_3267_3319_3327_3338_3371_3371_3417_3443_3451_3456_3459_
104,3,新華,N,1,5,6,,3448_3448_3453_3453_
104,1,積水潭,N,1,0,1,,
104,1,推荐,Vt,1,0,1,,
104,1,逛逛,Vt,1,0,1,,
104,3,氣派,Vi,9,3,12,292_300_762_1013_1018_1383_1393_1402_,2920_2944_
104,3,被單,N,1,10,11,,2258_2259_2259_2505_2954_2983_2984_3253_3253_
104,3,熱水,N,23,65,88,272_339_630_630_630_630_630_630_631_640_670_677_678_830_871_879_1070_1077_1242_1246_1337_1425_,2059_2059_2128_2134_2205_2267_2324_2326_2326_2345_2350_2457_2457_2489_2490_2579_2662_2669_2707_2708_2718_2721_2907_2931_2939_2940_2948_2956_2957_3071_3074_3103_3103_3103_3103_3118_3159_3187_3187_3189_3189_3333_3360_3379_3433_3434_3435_3436_3448_3448_3448_3448_3448_3448_3452_3453_3453_3453_3453_3453_3453_3457_3480_3482_
104,1,直門,N,1,0,1,,
104,1,桶式,A,1,0,1,,
104,3,單,N,2,25,27,1249_,2077_2094_2096_2247_2385_2411_2548_2563_2731_2754_2767_2776_2842_2843_2970_3019_3089_3122_3127_3146_3213_3218_3419_3492_
104,3,冷,Vi,21,70,91,104_229_229_229_636_636_638_638_711_721_772_776_825_1031_1211_1215_1217_1266_1290_1352_,2004_2006_2006_2037_2043_2045_2094_2096_2103_2104_2110_2134_2192_2267_2297_2300_2432_2435_2477_2525_2549_2550_2703_2814_2815_2857_2858_2861_2888_2953_2985_2998_2999_2999_3022_3023_3032_3033_3089_3132_3158_3187_3187_3189_3189_3194_3196_3196_3208_3289_3290_3304_3308_3360_3405_3410_3434_3436_3443_3443_3448_3448_3453_3453_3470_3470_3470_3470_3470_
104,3,油污,N,1,2,3,,2987_
104,1,暖和,Vi,3,0,3,1211_1423_,
104,3,北,N,9,5,14,347_357_1276_1283_1359_1364_1476_1483_,2822_3059_3448_3453_
104,3,南,N,11,5,16,163_168_186_196_401_738_742_948_1359_1364_,2822_2822_3133_3385_
104,3,時,N,4,6,10,1233_1319_1324_,2596_2597_2838_3433_3435_
104,3,東,N,12,2,14,171_547_550_551_556_559_560_837_889_897_1135_,3246_
104,3,洗澡,Vi,24,59,83,186_196_272_379_390_397_443_631_631_677_772_776_817_1021_1026_1092_1239_1242_1246_1332_1356_1361_1454_,2094_2096_2134_2162_2162_2200_2269_2272_2289_2324_2326_2339_2391_2432_2435_2492_2500_2501_2579_2669_2730_2814_2814_2828_2838_2873_2926_2928_2946_2950_2953_2958_3074_3084_3103_3107_3159_3201_3239_3242_3304_3304_3325_3333_3333_3353_3355_3376_3378_3415_3417_3434_3436_3452_3457_3471_3495_3497_
104,3,洗漱,Vi,4,9,13,906_1030_1057_,2252_2253_2426_2483_2933_3448_3453_3470_
104,1,百貨商場,N,1,0,1,,
104,3,海,N,34,6,40,186_196_241_241_247_251_251_257_341_342_352_363_368_599_599_608_608_670_674_778_783_785_842_851_856_860_865_887_888_895_896_917_1429_,2861_3204_3205_3347_3358_
104,3,動物園,N,2,1,3,1054_,
104,3,廁所,N,6,30,36,546_555_670_699_1088_,2228_2255_2257_2390_2541_2600_2679_2683_2686_2861_2922_3069_3070_3161_3174_3253_3260_3260_3300_3303_3313_3319_3319_3319_3319_3319_3344_3352_3354_
104,3,新開,Vt,1,3,4,,2637_2638_
104,3,飲用水,N,3,13,16,335_978_,2551_2551_2552_2552_2553_2553_2553_2553_2553_3152_3153_3386_
104,3,熱,Vt,20,40,60,145_272_427_630_641_674_677_1031_1081_1087_1088_1088_1088_1217_1296_1300_1348_1352_1352_,2134_2326_2342_2432_2435_2509_2517_2519_2521_2525_2579_2611_2656_2662_2671_2702_2773_2782_2845_2888_2898_2917_2947_2958_2971_2972_3040_3073_3107_3187_3189_3194_3196_3246_3327_3360_3463_3480_3482_
104,1,豁口,N,2,0,2,104_,
104,3,接受,Vt,22,28,50,161_162_166_167_346_356_546_546_555_555_714_724_732_817_890_898_1057_1266_1334_1423_1472_,2245_2356_2492_2494_2495_2611_2746_2746_2754_2775_2857_2858_2863_2872_3014_3049_3133_3146_3163_3175_3176_3186_3188_3246_3283_3294_3312_
104,3,街口,N,10,2,12,274_280_547_550_551_556_559_560_1495_,2361_
106,3,一家人,N,5,5,10,187_197_716_726_,2519_2740_2923_3074_
106,3,櫃檯,N,12,14,26,297_305_546_546_555_555_674_674_674_674_1201_,2300_2604_2604_2837_3186_3188_3257_3257_3257_3257_3257_3257_3295_
106,3,賓至如歸,Vi,10,5,15,180_190_226_372_634_708_718_1462_1467_,2807_2857_2858_3049_
106,3,禮貌,N,32,19,51,119_127_155_186_196_242_252_316_364_369_429_521_530_634_640_674_709_710_719_720_886_886_894_894_944_1013_1155_1162_1184_1190_1235_,2016_2084_2085_2126_2136_2140_2264_2383_2445_2446_2642_2646_2651_2654_2780_3076_3153_3227_
106,3,感,N,4,1,5,201_207_1087_,
106,3,游,Vi,11,8,19,234_707_717_872_880_963_1171_1178_1367_1423_,2933_2933_2933_3011_3319_3434_3436_
106,3,結帳,Vi,20,73,93,155_217_246_256_308_312_377_411_510_756_758_956_982_990_993_1025_1277_1284_1425_,2015_2101_2102_2104_2139_2143_2178_2193_2207_2220_2222_2229_2229_2232_2287_2288_2295_2295_2295_2295_2383_2390_2391_2391_2452_2452_2534_2582_2588_2598_2616_2700_2701_2739_2739_2754_2754_2754_2827_2842_2842_2843_2843_2846_2996_3029_3038_3039_3193_3194_3213_3218_3224_3239_3253_3255_3255_3256_3256_3257_3308_3313_3327_3332_3337_3337_3341_3422_3446_3458_3487_3487_
106,1,梅,N,1,0,1,,
106,3,接待,Vt,24,38,62,144_204_210_280_510_546_546_554_555_555_563_568_577_710_720_748_888_896_924_932_1020_1211_1496_,2002_2036_2229_2295_2359_2359_2359_2359_2438_2440_2508_2517_2519_2549_2550_2554_2555_2609_2609_2609_2609_2782_2816_2818_2882_2924_3032_3032_3033_3033_3049_3049_3226_3297_3397_3402_3407_
106,3,10月,N,9,24,33,287_334_641_732_807_1011_1218_1337_,2040_2081_2083_2359_2508_2573_2675_2677_2815_2898_3014_3029_3038_3039_3115_3129_3130_3158_3257_3274_3293_3419_3454_
106,3,20日,N,9,9,18,611_620_788_949_1054_1343_1489_1492_,2475_2530_2680_2747_2765_3165_3345_3446_
106,3,童,N,21,14,35,298_306_335_341_526_535_565_566_574_575_889_890_897_898_917_957_1057_1059_1211_1375_,2222_2360_2361_2416_2595_2651_2654_2756_3055_3237_3264_3433_3435_
107,1,幽靜,Vi,4,0,4,148_350_360_,
107,1,散散步,Vi,3,0,3,888_896_,
107,1,森林,N,3,0,3,111_1371_,
107,3,湖,N,6,10,16,145_165_170_273_948_,2166_2166_2305_2308_2941_2941_2975_2975_3163_
107,1,山傍水,N,1,0,1,,
108,3,自然,ADV,12,12,24,114_227_229_275_710_720_1073_1080_1369_1439_1444_,2102_2229_2516_2517_2518_2519_2742_3115_3194_3194_3418_
108,3,停車場,N,24,35,59,109_162_163_167_168_198_286_424_439_439_439_641_728_732_1104_1224_1226_1243_1247_1254_1328_1450_1499_,2131_2133_2180_2198_2198_2360_2361_2438_2439_2440_2561_2562_2589_2589_2589_2626_2748_2748_2857_2858_2934_3040_3063_3123_3132_3142_3203_3310_3352_3354_3392_3394_3487_3487_
108,3,五星級,N,48,38,86,108_111_187_197_281_286_381_384_391_424_479_488_517_519_645_651_670_671_686_691_714_724_804_869_877_1000_1088_1097_1167_1168_1169_1170_1172_1173_1174_1175_1176_1177_1179_1180_1359_1364_1397_1399_1406_1473_1500_,2072_2089_2107_2114_2116_2117_2119_2225_2226_2318_2319_2360_2360_2361_2361_2571_2596_2596_2597_2597_2623_2637_2638_2775_3132_3133_3142_3142_3166_3191_3345_3345_3352_3352_3354_3354_3372_
108,3,你們,N,6,89,95,417_1319_1319_1324_1324_,2083_2089_2231_2231_2232_2252_2252_2253_2253_2287_2287_2288_2288_2295_2322_2359_2359_2445_2445_2445_2446_2446_2446_2475_2494_2495_2517_2519_2531_2561_2562_2598_2616_2630_2746_2798_2800_2803_2812_2824_2824_2824_2824_2824_2824_2824_2824_2824_2826_2826_2826_2826_2826_2826_2826_2826_2826_2838_2842_2843_2864_2869_2945_3103_3103_3141_3232_3232_3246_3246_3291_3292_3352_3354_3367_3367_3367_3368_3368_3368_3379_3397_3433_3433_3433_3435_3435_3435_
108,3,狀況,N,2,14,16,1498_,2259_2471_2609_2641_2645_2651_2654_2713_2872_3038_3039_3205_3294_
109,1,鳥叫,N,1,0,1,,
109,3,寶貴,Vi,17,36,53,157_186_196_213_213_217_428_437_443_515_592_601_743_1028_1169_1176_,2136_2140_2258_2259_2305_2308_2322_2406_2406_2408_2408_2417_2417_2575_2671_2744_2753_2759_2840_2857_2858_3163_3168_3169_3253_3431_3431_3432_3432_3448_3448_3453_3453_3458_3458_
109,3,超,Vt,16,18,34,213_521_530_714_724_737_919_991_994_999_1056_1087_1124_1131_1350_,2006_2239_2255_2257_2444_2925_3025_3027_3029_3040_3105_3119_3124_3294_3418_3418_3460_
109,1,從容,Vi,1,0,1,,
109,1,走完,Vt,1,0,1,,
109,3,期待,Vt,30,20,50,435_436_437_438_439_440_441_443_516_1028_1029_1030_1031_1150_1157_1167_1168_1169_1170_1172_1173_1174_1175_1176_1177_1179_1180_1319_1324_,2225_2226_2280_2575_2590_2608_2753_2816_2818_2840_2857_2858_3024_3026_3146_3371_3431_3432_3483_
109,1,路線圖,N,2,0,2,113_,
109,3,布草,N,3,4,7,1481_1488_,2253_2258_2259_
109,3,相關,Vi,9,18,27,116_743_983_1030_1081_1319_1324_1450_,2037_2108_2108_2258_2258_2259_2259_2445_2446_2549_2550_2671_2860_2947_3049_3055_3427_
109,3,更換,Vt,9,16,25,269_477_486_707_717_753_1294_1298_,2280_2419_2419_2432_2435_2517_2519_2565_2651_2654_2807_2815_2928_3168_3169_
109,1,電器,N,4,0,4,418_1104_1266_,
109,3,專門,Vi,20,9,29,184_194_248_258_439_482_482_491_491_550_559_634_710_720_756_758_783_814_912_,2334_2635_2671_2731_2761_2762_2946_3117_
109,3,意見,N,41,64,105,109_116_157_160_162_167_213_213_213_217_217_248_258_316_320_417_428_443_515_522_531_592_601_628_707_717_743_982_982_982_982_1028_1029_1029_1032_1139_1169_1171_1176_1178_,2037_2089_2108_2258_2259_2305_2305_2305_2308_2308_2308_2322_2322_2406_2406_2408_2408_2417_2417_2445_2446_2475_2553_2553_2575_2671_2671_2672_2718_2721_2737_2744_2746_2753_2754_2759_2840_2857_2858_2881_3049_3168_3169_3180_3231_3253_3253_3253_3288_3288_3371_3383_3384_3431_3431_3431_3432_3432_3432_3448_3448_3453_3453_
109,1,紅珠山,N,1,0,1,,
109,3,山,N,11,12,23,145_172_273_342_352_1061_1423_1423_1462_1467_,2297_2300_2432_2435_2930_2932_3035_3086_3086_3149_3162_
109,3,誠懇,Vi,2,7,9,1054_,2779_2815_2881_3054_3163_3231_
109,3,寬大,Vi,3,1,4,1398_1407_,
109,3,建,Vt,9,3,12,239_249_595_604_902_1104_1220_1222_,2917_3460_
109,1,寬闊,Vi,3,0,3,885_893_,
109,3,談不上,Vt,3,6,9,497_698_,2788_2813_2871_2883_3160_
109,1,翠色,N,1,0,1,,
109,3,摸上去,Vi,1,1,2,,
109,3,床墊,N,2,15,17,961_,2135_2343_2586_2829_2909_2910_3022_3023_3137_3171_3173_3332_3451_3456_
109,1,蟲鳴,N,1,0,1,,
109,1,橋路,N,1,0,1,,
109,3,明顯,Vi,17,36,53,172_182_192_275_522_531_546_546_555_555_761_788_1138_1145_1399_1472_,2108_2149_2207_2258_2259_2406_2408_2425_2428_2535_2587_2651_2651_2654_2654_2742_2773_2776_2864_3024_3025_3026_3027_3055_3071_3076_3111_3139_3147_3194_3246_3246_3253_3297_3360_
109,3,攜,Vt,16,33,49,110_315_449_457_649_655_888_896_1149_1156_1237_1238_1436_1477_1484_,2193_2195_2277_2280_2360_2361_2376_2473_2547_2568_2569_2571_2625_2707_2708_2732_2827_2830_2852_2908_2917_2921_3107_3266_3270_3272_3282_3339_3340_3366_3422_3475_
109,3,提高,Vt,17,21,38,294_302_335_437_515_517_628_650_656_938_985_1194_1211_1213_1237_1426_,2037_2037_2072_2273_2305_2308_2322_2359_2359_2608_2609_2609_2609_2857_2858_2888_2951_2977_3074_3146_
109,3,總結,Vt,3,7,10,876_884_,3389_3390_3433_3435_3448_3453_
109,3,美味,N,1,3,4,,2253_2861_
109,1,分棟,N,1,0,1,,
109,3,部門,N,6,21,27,116_1030_1319_1324_1450_,2070_2070_2108_2258_2258_2259_2259_2359_2363_2445_2446_2582_2589_2671_2671_2924_3055_3371_3433_3435_
109,3,應,ADV,8,16,24,401_703_705_1124_1131_1148_1328_,2227_2342_2467_2468_2498_2498_2634_2718_2721_2759_2986_3133_3243_3258_3388_
109,3,光臨,Vt,23,22,45,157_316_435_436_437_438_439_440_441_443_516_1028_1029_1031_1032_1054_1150_1157_1309_1313_1469_1470_,2226_2258_2259_2305_2308_2322_2359_2452_2475_2589_2590_2840_3024_3026_3146_3146_3231_3371_3431_3432_3483_
109,3,山景房,N,2,1,3,113_,
109,3,3星,N,16,36,52,339_339_409_409_566_575_746_771_775_901_1029_1082_1369_1463_1468_,2055_2089_2129_2144_2145_2243_2254_2256_2266_2281_2282_2291_2541_2572_2723_2824_2826_2873_2923_2942_2972_3042_3073_3078_3085_3165_3289_3289_3290_3290_3331_3343_3369_3370_3463_
109,3,7月,N,58,39,97,182_183_186_186_192_193_196_196_213_217_242_246_252_256_437_438_439_440_441_515_516_551_560_568_577_592_601_628_669_714_715_724_725_743_891_899_901_902_1057_1081_1145_1169_1169_1170_1171_1172_1173_1176_1176_1177_1178_1179_1180_1199_1474_1480_1487_,2005_2057_2122_2126_2252_2253_2386_2412_2590_2609_2609_2621_2630_2700_2701_2702_2737_2753_2753_2759_2765_2857_2858_2862_2909_2910_3044_3048_3049_3071_3119_3124_3146_3184_3184_3288_3288_3446_
109,1,落地窗,N,4,0,4,407_888_896_,
109,1,硬邦邦,Vi,1,0,1,,
109,3,山水,N,5,1,6,546_548_555_557_,
109,3,行政房,N,12,8,20,710_720_887_895_923_925_931_933_1097_1099_1498_,2465_2491_2596_2597_2698_3111_3111_
109,3,住店,N,10,21,31,115_163_168_183_193_701_714_724_1051_,2264_2273_2759_2759_2775_2816_2818_3099_3103_3243_3243_3243_3243_3243_3243_3282_3392_3394_3462_3462_
109,1,山景,N,4,0,4,109_172_670_,
109,3,交給,Vt,1,2,3,,3435_
109,1,清新,Vi,5,0,5,280_738_822_837_,
109,3,吃飽,Vi,2,4,6,1114_,2714_3225_3305_
109,1,成色,N,1,0,1,,
109,1,心曠神怡,Vi,1,0,1,,
109,3,程,N,18,30,48,110_315_449_457_649_655_888_896_1149_1152_1156_1159_1237_1238_1436_1477_1484_,2111_2189_2193_2195_2277_2280_2376_2473_2547_2568_2569_2571_2707_2708_2732_2827_2830_2852_2908_2917_3270_3272_3282_3315_3339_3340_3366_3422_3475_
109,1,精緻,Vi,6,0,6,341_407_1044_1124_1131_,
109,3,顏色,N,4,17,21,910_1007_1059_,2247_2359_2380_2388_2392_2543_2717_2720_2854_2986_3108_3109_3114_3333_3409_3409_
109,1,灰撲撲,Vi,1,0,1,,
110,3,事,N,15,75,90,153_153_238_238_521_530_568_568_577_577_670_741_1061_1423_,2037_2072_2081_2083_2084_2085_2095_2097_2108_2139_2143_2159_2252_2252_2253_2253_2314_2317_2359_2360_2361_2549_2549_2549_2550_2550_2550_2559_2615_2680_2690_2690_2690_2707_2708_2742_2761_2762_2769_2770_2771_2771_2803_2924_2924_2924_2924_2933_3001_3083_3184_3254_3257_3291_3292_3294_3296_3296_3319_3358_3373_3374_3415_3433_3433_3433_3435_3435_3435_3448_3453_3473_3480_3482_
110,1,流量,N,1,0,1,,
110,3,溫泉,N,15,22,37,111_113_113_113_114_115_116_116_389_390_391_392_392_503_,2769_2769_2769_2770_2770_2770_2770_3243_3243_3243_3243_3243_3243_3243_3246_3246_3246_3246_3246_3246_3246_
110,3,努力,Vi,7,13,20,745_989_992_1030_1124_1131_,2308_2475_2499_2608_2609_2609_2747_2753_3096_3231_3431_3432_
110,1,綠化,Vt,3,0,3,641_1114_,
110,3,棒,Vi,17,2,19,500_550_559_715_725_782_872_880_1028_1070_1077_1088_1114_1375_1376_1496_,2910_
111,1,圓滿,Vi,1,0,1,,
111,3,蠻,ADV,32,5,37,157_164_169_214_307_311_374_396_520_526_529_535_649_655_675_814_820_842_917_1082_1088_1089_1105_1186_1192_1199_1211_1257_1352_1428_1472_,2253_2626_3041_3137_
111,1,內陸,N,1,0,1,,
111,3,城市,N,21,27,48,111_164_169_276_447_455_630_644_658_901_1020_1208_1211_1211_1211_1211_1213_1213_1214_1436_,2036_2057_2175_2247_2322_2377_2378_2464_2464_2466_2466_2549_2549_2550_2550_2561_2562_2609_2680_3065_3067_3110_3151_3319_3479_3481_
111,1,紛紛,ADV,1,0,1,,
111,3,熱騰騰,Vi,2,1,3,1062_,
111,3,水準,N,15,21,36,229_277_316_549_558_675_811_1125_1132_1173_1180_1350_1426_1471_,2072_2258_2259_2332_2457_2506_2507_2531_2603_2605_2647_2922_2976_2977_3222_3245_3321_3322_3359_3397_
111,1,翠湖,N,1,0,1,,
111,3,過程,N,2,8,10,1340_,2244_2245_2535_2731_2767_3319_3421_
111,3,反覆,ADV,1,6,7,,2531_2972_3083_3103_3443_
111,3,享受,Vt,13,17,30,112_116_211_211_228_259_261_435_785_1101_1105_1249_,2360_2361_2516_2518_2547_2731_2768_2976_2996_3038_3038_3039_3039_3072_3146_3360_
111,3,十分,ADV,23,30,53,147_394_550_559_743_922_930_944_982_1085_1171_1178_1212_1243_1247_1281_1288_1319_1324_1359_1364_1495_,2137_2141_2155_2161_2162_2164_2363_2391_2531_2539_2705_2706_2732_2732_2732_2862_2862_2901_3132_3146_3205_3273_3281_3295_3327_3345_3357_3433_3435_
111,1,沿海,N,3,0,3,644_1213_,
111,1,細雨,N,1,0,1,,
111,1,置身,Vt,1,0,1,,
111,1,誘惑力,N,1,0,1,,
111,1,面向,Vt,3,0,3,350_360_,
111,3,湯,N,1,3,4,,2531_2976_
111,3,淡季,N,8,5,13,216_364_369_630_1091_1195_1198_,2549_2550_2945_3099_
111,1,池,N,2,0,2,1104_,
111,3,低於,Vt,1,5,6,,2634_2759_3448_3453_
111,1,影響力,N,1,0,1,,
111,1,督促,Vt,1,0,1,,
112,3,額外,A,3,1,4,1124_1131_,
112,3,起來,Vi,4,16,20,218_1304_1307_,2272_2326_2342_2756_2799_2809_2861_2862_2867_2953_2972_3020_3146_3304_3470_
112,3,總的來說,ADV,50,7,57,118_126_155_174_244_254_276_391_413_433_517_522_531_566_569_570_575_578_579_586_596_605_632_814_828_830_846_905_923_931_939_945_945_999_1002_1040_1091_1091_1235_1241_1245_1319_1324_1350_1418_1426_1454_1478_1485_,2773_3042_3132_3201_3267_3445_
112,3,通,Vi,4,10,14,388_675_1135_,2793_2972_3195_3253_3253_3253_3281_3319_3379_
112,3,逛,Vt,6,5,11,154_871_875_879_883_,2179_3319_3433_3435_
112,1,車場,N,1,0,1,,
112,1,即可,ADV,7,0,7,394_540_801_820_1151_1158_,
112,3,停滿,Vt,1,2,3,,3394_
112,3,疑問,N,1,5,6,,2872_3371_3431_3432_
112,3,早飯,N,14,17,31,185_195_211_364_369_540_710_720_750_1015_1088_1243_1247_,2232_2291_2291_2291_2445_2446_2596_2597_2958_3092_3119_3124_3156_3184_3308_3360_
112,3,汗,N,7,9,16,886_889_894_897_1028_1087_,2898_2946_3254_3254_3433_3435_3495_3497_
112,3,算了,Vi,2,26,28,213_,2272_2360_2361_2528_2531_2746_2861_2861_2968_2995_3055_3079_3139_3150_3253_3253_3255_3256_3289_3290_3313_3397_3437_3478_3487_
112,3,預訂,Vt,29,71,100,152_203_209_341_410_434_434_434_434_482_491_568_568_577_577_592_601_662_662_795_798_870_878_983_1095_1293_1393_1402_,2006_2037_2138_2189_2211_2244_2245_2291_2291_2324_2325_2360_2361_2363_2418_2454_2455_2467_2468_2503_2532_2533_2547_2554_2555_2636_2671_2714_2743_2752_2776_2806_2815_2882_2917_2919_2921_2941_2968_3013_3013_3013_3032_3032_3032_3033_3033_3033_3049_3063_3103_3146_3146_3146_3163_3239_3265_3329_3364_3364_3371_3389_3389_3389_3390_3390_3390_3413_3421_3443_
112,3,總台,N,8,47,55,186_196_220_481_591_591_1020_,2035_2047_2225_2226_2269_2269_2269_2359_2457_2530_2579_2608_2639_2639_2739_2739_2744_2757_2758_2864_2864_2889_2889_2890_2890_2907_2946_2946_2946_2961_2963_2987_2987_3049_3049_3196_3207_3213_3213_3218_3218_3319_3329_3329_3434_3436_
113,3,交通車,N,1,1,2,,
113,1,欣賞,Vt,12,0,12,163_168_245_255_553_553_562_562_710_720_948_,
113,3,館,N,1,1,2,,
113,3,設有,Vt,3,5,8,520_529_,3026_3111_3383_3384_
113,3,正好,ADV,19,11,30,402_551_560_582_583_708_718_771_775_778_820_1007_1007_1018_1135_1138_1249_1254_,2057_2124_2626_2637_2638_2702_2746_2861_2953_3132_
113,1,小車,N,1,0,1,,
113,1,會館,N,2,0,2,113_,
113,3,雨,N,7,7,14,714_724_888_888_896_896_,2436_3392_3392_3394_3394_3467_
113,1,紅珠湖,N,1,0,1,,
113,3,尊敬,Vt,16,21,37,116_186_196_316_982_1028_1029_1030_1309_1313_1319_1324_1450_1469_1470_,2177_2258_2259_2305_2308_2359_2447_2589_2590_2671_2672_2737_2759_2857_2858_3024_3026_3146_3231_3288_
113,3,4月,N,11,28,39,321_425_426_427_428_773_777_923_931_1202_,2045_2360_2361_2457_2484_2623_2624_2671_2672_2731_2831_2832_2842_2843_2945_2956_2957_3024_3026_3180_3203_3231_3371_3423_3424_3448_3453_
113,3,接送,Vt,7,4,11,217_217_835_835_942_1256_,2812_2813_3118_
113,3,美景,N,3,1,4,948_948_,
113,1,沿途,N,5,0,5,163_168_582_583_,
113,3,剛剛,ADV,10,13,23,287_670_838_886_894_910_990_993_1236_,2387_2802_2903_2905_2946_2987_3038_3039_3163_3171_3173_3397_
114,1,頤尚,N,1,0,1,,
114,3,度假型,N,1,1,2,,
114,3,香港,N,111,12,123,281_670_783_783_786_787_789_792_792_806_807_808_812_815_815_818_818_818_819_822_822_822_822_826_832_836_837_842_845_846_847_849_849_850_854_857_863_866_870_872_876_878_880_884_885_886_886_886_886_886_887_887_887_888_888_889_889_889_889_891_893_894_894_894_894_894_895_895_895_896_896_897_897_897_897_899_901_901_901_901_902_902_907_907_907_910_910_915_918_921_922_923_923_925_930_931_931_933_935_939_940_942_1270_1273_1311_1311_1315_1315_1316_1321_,2151_2151_2153_2159_2162_2162_2162_2385_2445_2446_2648_
114,3,南京,N,5,8,13,122_130_1473_1497_,2360_2360_2361_2361_2362_3110_3110_
114,3,已,ADV,38,72,110,116_163_168_213_412_546_555_568_577_610_618_619_627_663_707_717_743_793_796_801_849_887_895_982_982_1031_1032_1032_1171_1171_1178_1178_1249_1309_1313_1423_1451_,2037_2037_2047_2062_2108_2108_2196_2258_2258_2259_2259_2284_2363_2469_2469_2483_2483_2494_2495_2535_2544_2551_2571_2575_2575_2582_2582_2671_2671_2714_2747_2753_2775_2794_2845_2857_2858_2869_2873_2923_2923_2996_3015_3034_3073_3111_3114_3118_3146_3184_3185_3185_3226_3331_3331_3352_3354_3364_3371_3383_3384_3418_3422_3433_3433_3433_3435_3435_3435_3448_3453_
114,3,一點,ADV,33,38,71,213_239_249_320_374_546_555_585_590_629_670_729_773_777_846_846_847_847_857_866_887_895_935_976_1038_1045_1084_1149_1156_1350_1377_1428_,2108_2201_2231_2333_2334_2354_2355_2479_2534_2670_2717_2718_2720_2721_2815_2838_2869_2869_2877_2878_2949_2980_3055_3103_3156_3246_3274_3288_3327_3331_3333_3418_3418_3443_3448_3453_3466_
114,3,戶外,N,1,3,4,,2102_2110_
114,1,湯山,N,1,0,1,,
115,3,一再,ADV,4,3,7,115_281_1114_,2534_3308_
115,1,父女,N,1,0,1,,
115,3,打折,Vi,4,5,9,648_654_1201_,2102_2569_2956_2957_
115,3,雙,A,20,18,38,115_115_290_434_434_499_521_522_524_530_531_533_540_570_579_1124_1131_1294_1298_,2008_2205_2247_2360_2361_2434_2434_2621_2731_2752_2752_3213_3218_3329_3329_3329_3472_
115,3,要求,Vt,46,157,203,149_185_195_276_328_333_342_352_417_434_434_434_434_481_512_516_546_555_700_828_835_835_841_857_866_870_876_878_884_1020_1057_1057_1070_1077_1088_1091_1101_1114_1169_1169_1176_1176_1259_1437_1498_,2023_2037_2047_2048_2071_2089_2139_2143_2149_2155_2158_2159_2162_2191_2232_2258_2259_2272_2284_2290_2294_2312_2315_2333_2334_2360_2361_2363_2363_2363_2384_2384_2445_2445_2446_2446_2454_2455_2457_2483_2483_2516_2517_2518_2519_2547_2551_2554_2555_2561_2562_2616_2640_2651_2654_2669_2669_2671_2671_2671_2671_2680_2714_2718_2721_2724_2731_2731_2738_2740_2740_2740_2748_2754_2759_2775_2775_2775_2775_2775_2775_2776_2776_2797_2814_2828_2830_2841_2861_2863_2928_2946_2960_2962_2968_2995_2996_3008_3019_3069_3070_3071_3071_3073_3076_3085_3101_3133_3146_3160_3180_3193_3202_3202_3202_3213_3218_3239_3239_3239_3255_3256_3267_3272_3272_3283_3283_3283_3283_3289_3290_3294_3296_3296_3308_3324_3341_3360_3360_3364_3386_3388_3397_3397_3431_3432_3433_3435_3448_3453_3473_3483_3488_3489_3490_3491_
115,1,申明,Vt,1,0,1,,
115,3,扣,Vt,2,4,6,632_,2104_2968_2968_
115,1,魚池,N,1,0,1,,
115,3,房費,N,2,39,41,173_,2244_2245_2318_2319_2322_2363_2417_2421_2421_2421_2516_2518_2549_2550_2554_2554_2555_2555_2698_2776_2981_2982_3034_3049_3111_3288_3288_3288_3291_3292_3313_3360_3360_3460_3489_3489_3491_3491_
115,3,提前,Vi,19,25,44,185_195_239_249_328_328_333_333_339_397_434_546_555_704_706_795_798_1343_,2041_2095_2097_2138_2229_2232_2309_2342_2342_2364_2483_2531_2557_2740_2769_2770_3044_3048_3098_3118_3265_3364_3415_3416_
115,1,付清,Vt,1,0,1,,
115,3,另外,ADV,8,35,43,185_195_546_555_872_880_1332_,2219_2221_2229_2299_2302_2399_2401_2565_2609_2641_2645_2731_2743_2752_2754_2754_2769_2770_2791_2824_2826_2861_3065_3067_3099_3129_3130_3146_3150_3163_3399_3462_3462_3492_
116,3,酌情,ADV,1,2,3,,3432_
116,1,公平,Vi,1,0,1,,
116,1,三月,N,1,0,1,,
116,3,卻,ADV,33,99,132,162_167_280_281_341_522_531_546_546_546_554_555_555_555_563_674_695_756_756_758_758_819_842_889_897_1045_1061_1091_1115_1362_1371_1430_,2037_2060_2074_2077_2081_2083_2101_2102_2104_2131_2133_2153_2211_2243_2249_2251_2269_2269_2269_2298_2301_2303_2306_2344_2349_2354_2355_2380_2417_2426_2457_2460_2461_2498_2502_2521_2530_2564_2579_2603_2605_2616_2621_2625_2626_2629_2637_2637_2638_2638_2754_2754_2782_2791_2796_2828_2847_2872_2873_2873_2873_2879_2880_2914_2928_3074_3095_3101_3103_3129_3130_3196_3233_3233_3239_3246_3257_3282_3305_3308_3308_3329_3330_3360_3360_3364_3371_3389_3389_3390_3390_3413_3418_3418_3421_3423_3424_3493_
116,3,實際,Vi,11,42,53,276_380_383_672_1054_1057_1319_1324_1481_1488_,2078_2136_2140_2212_2213_2232_2298_2301_2585_2621_2656_2739_2739_2766_2787_2789_2847_2933_2967_2967_2980_3029_3042_3065_3067_3069_3070_3156_3257_3260_3295_3296_3319_3340_3397_3414_3458_3489_3489_3491_3491_
116,3,室,N,9,20,29,229_229_838_847_1026_1154_1161_1249_,2110_2492_2731_2759_2759_2813_2815_2872_2959_2959_3098_3117_3139_3180_3194_3433_3433_3435_3435_
116,3,晚,Vi,34,54,88,152_163_168_173_520_521_529_530_630_707_717_786_835_872_875_880_883_885_893_910_958_967_1082_1100_1100_1113_1121_1130_1137_1430_1443_1448_1455_,2070_2084_2085_2095_2097_2114_2117_2123_2138_2191_2193_2231_2273_2377_2391_2393_2448_2451_2494_2494_2494_2495_2495_2495_2510_2511_2690_2744_2757_2758_2775_2784_2790_2861_2867_2975_3017_3018_3020_3034_3083_3115_3180_3184_3243_3272_3288_3319_3364_3367_3368_3371_3371_
116,3,今後,N,5,10,15,338_515_820_1054_,2190_2530_2535_2608_2609_2702_2759_2799_2921_
116,3,泡,Vt,7,5,12,186_196_231_788_875_883_,3243_3243_3243_3243_
116,1,華貴,Vi,1,0,1,,
116,1,時限,N,1,0,1,,
116,3,相,ADV,3,2,5,176_676_,2486_
116,1,清幽,Vi,1,0,1,,
116,3,欠缺,Vt,5,2,7,753_885_893_1032_,3073_
116,3,西式,A,12,2,14,186_186_196_196_228_424_889_897_982_1427_1437_,3194_
116,3,29日,N,5,12,17,715_725_901_1034_,2008_2122_2902_2904_3168_3169_3231_3448_3448_3453_3453_
116,3,提交,Vt,3,2,5,186_196_,2582_
116,3,情況,N,17,91,108,229_320_408_417_434_597_710_720_743_753_779_968_1169_1176_1292_1497_,2037_2163_2190_2209_2210_2225_2226_2258_2259_2284_2305_2308_2359_2372_2372_2372_2372_2375_2375_2375_2375_2483_2508_2510_2510_2511_2511_2534_2608_2621_2680_2691_2714_2732_2737_2754_2766_2775_2798_2800_2816_2816_2816_2816_2816_2818_2818_2818_2818_2818_2824_2826_2857_2858_2862_2862_2869_2872_2885_2887_2923_2923_2924_2978_3012_3042_3049_3055_3073_3156_3180_3226_3255_3256_3294_3295_3296_3318_3345_3360_3360_3392_3394_3443_3448_3448_3453_3453_3460_3463_
116,3,景色,N,20,3,23,228_241_246_247_251_256_257_374_377_378_379_419_431_670_842_1020_1168_1175_1269_,3145_3417_
117,1,房難,N,2,0,2,125_,
117,3,上海,N,24,40,64,118_119_125_126_127_163_168_253_281_462_802_828_872_880_1020_1051_1054_1203_1211_1442_1442_1447_1447_,2009_2060_2266_2342_2517_2519_2549_2550_2554_2555_2579_2590_2611_2613_2621_2700_2701_2746_2798_2800_2919_3013_3013_3013_3013_3115_3150_3154_3155_3171_3173_3187_3189_3257_3345_3405_3410_3433_3435_
117,3,訂到,Vt,4,2,6,125_704_706_,3237_
117,1,牛氣,N,2,0,2,125_,
118,3,地鐵站,N,32,7,39,126_814_826_839_842_849_886_886_889_889_889_891_894_894_897_897_897_899_903_906_910_913_917_921_921_923_923_931_931_940_1055_,2161_2162_2162_2505_2514_2829_
118,3,開業,Vi,7,7,14,126_240_250_391_517_1020_,2521_2641_2645_2798_2800_3296_
118,3,人性化,Vt,14,6,20,126_347_357_515_515_714_724_964_982_1062_1211_1319_1324_,2981_2982_3132_3391_3393_
118,3,南京路,N,2,2,4,126_,3109_
118,3,可能,ADV,55,88,143,121_126_129_149_172_173_218_227_294_302_334_434_444_452_460_522_531_540_595_604_610_610_611_619_619_620_658_728_768_787_820_857_866_887_888_895_896_910_949_981_982_1005_1091_1105_1115_1207_1213_1236_1337_1348_1366_1418_1437_1453_,2072_2099_2125_2134_2137_2139_2141_2143_2154_2154_2175_2241_2252_2253_2260_2264_2264_2265_2290_2297_2300_2318_2319_2320_2359_2494_2495_2521_2522_2531_2532_2533_2537_2538_2549_2549_2549_2550_2550_2550_2571_2576_2590_2623_2624_2662_2705_2706_2776_2794_2799_2813_2813_2824_2826_2827_2829_2834_2846_2861_2869_2899_2928_2964_2980_3065_3067_3069_3070_3089_3133_3185_3205_3225_3246_3253_3329_3338_3395_3398_3448_3453_3471_3479_3481_3488_3490_
118,3,4星級,N,7,9,16,126_160_160_448_456_1263_,2742_2814_2830_2998_3001_3297_3363_3425_
118,3,檔次,N,25,16,41,126_156_156_180_190_281_342_352_362_367_401_411_413_478_487_749_786_858_867_949_1004_1049_1163_1165_,2211_2211_2314_2317_2854_2861_3054_3065_3067_3096_3110_3319_3320_3361_3362_
118,3,接近,Vt,9,3,12,126_885_889_893_897_1010_1173_1180_,2444_2748_
118,3,也許,ADV,15,18,33,126_281_364_369_396_408_477_486_886_894_973_1005_1130_1137_,2246_2298_2301_2305_2308_2737_2795_2953_2987_3108_3109_3202_3236_3294_3319_3385_3409_
119,3,兒子,N,8,3,11,127_183_193_851_860_1088_1088_,2731_3415_
119,3,高興,Vt,16,5,21,127_186_196_707_710_717_720_912_915_1062_1091_1309_1311_1313_1315_,2005_2578_2869_3397_
119,3,同,ADV,8,4,12,119_127_127_277_289_551_560_,2722_2799_3418_
119,3,心,N,22,17,39,127_186_196_276_630_707_710_717_720_794_797_859_868_886_887_894_895_904_904_978_1212_,2097_2229_2283_2333_2334_2560_2742_2790_2797_3047_3051_3104_3288_3388_3434_3436_
119,3,轉角,N,2,1,3,127_,
119,3,出於,Vt,3,6,9,127_630_,2684_2687_2748_2748_3364_
119,3,攔,Vt,2,4,6,127_,2595_3231_3231_
119,3,冷漠,Vi,4,6,10,127_1319_1324_,2359_2385_2544_2809_3282_
119,3,品質,N,6,10,16,127_663_1031_1173_1180_,2037_2062_2678_2960_2962_3103_3257_3385_3458_
119,1,訂房台,N,2,0,2,127_,
119,3,對待,Vt,4,2,6,127_1490_1493_,3296_
119,3,同樣,Vi,6,26,32,127_290_813_1419_1419_,2012_2012_2163_2494_2495_2509_2612_2613_2647_2691_2703_2797_2799_2840_2841_2841_3132_3283_3345_3364_3364_3466_3489_3491_3493_
119,3,出租車,N,18,46,64,127_270_288_520_529_658_658_677_745_818_818_847_1151_1158_1437_1463_1468_,2153_2159_2167_2206_2360_2361_2492_2493_2595_2595_2695_2700_2701_2740_2744_2815_2838_2852_2867_2973_3059_3074_3137_3159_3159_3159_3163_3163_3175_3176_3182_3183_3196_3252_3255_3255_3255_3255_3256_3256_3256_3256_3272_3414_3466_
119,3,玩,Vt,19,14,33,127_142_186_196_465_773_777_783_851_860_887_895_921_1057_1057_1237_1491_1494_,2483_2483_2541_2639_2883_2923_2924_2933_2934_2945_2975_3254_3319_
119,3,外賓,N,2,4,6,127_,2070_2731_3101_
119,1,外國人,N,3,0,3,127_663_,
119,3,回頭,ADV,2,1,3,127_,
120,3,花費,Vt,2,4,6,128_,2245_2414_2566_
120,1,擁堵,N,2,0,2,128_,
120,3,進出,Vt,8,3,11,128_507_650_656_837_1241_1245_,2576_3296_
121,3,備用,Vi,2,5,7,129_,2616_3170_3172_3470_
121,3,電腦,N,42,48,90,129_150_204_210_219_219_226_226_226_231_231_231_231_540_540_540_540_540_540_541_547_550_551_553_554_556_559_560_562_563_658_658_750_1011_1020_1219_1221_1249_1249_1309_1313_,2209_2210_2232_2232_2280_2280_2287_2288_2298_2301_2425_2425_2428_2428_2554_2555_2598_2606_2608_2616_2616_2616_2649_2651_2654_2705_2706_2828_2848_2924_2931_2968_2968_3083_3086_3118_3146_3174_3177_3177_3274_3282_3308_3431_3431_3432_3432_
121,1,飛利浦,N,2,0,2,129_,
121,3,非,ADV,12,16,28,129_172_320_320_592_593_601_602_707_717_811_,2141_2239_2534_2561_2562_2791_3074_3074_3084_3146_3184_3243_3243_3296_3458_
121,3,液晶,N,23,2,25,129_150_154_494_541_550_559_669_750_754_818_822_874_875_882_883_972_974_1007_1249_1309_1313_,2721_
121,3,直接,Vi,32,64,96,129_335_429_434_434_445_453_516_707_710_714_717_720_724_891_899_923_924_924_931_932_932_963_1145_1201_1243_1247_1269_1316_1321_1427_,2106_2149_2151_2220_2222_2231_2272_2277_2290_2360_2361_2390_2445_2446_2483_2510_2511_2521_2523_2547_2551_2691_2750_2824_2826_2835_2836_2914_2925_2933_2933_2933_2946_2947_2958_2987_3029_3032_3032_3033_3033_3076_3099_3133_3150_3239_3267_3289_3290_3298_3301_3319_3319_3347_3347_3364_3433_3433_3435_3435_3443_3470_3486_
121,3,彩電,N,3,1,4,129_1366_,
122,3,不便,Vi,15,23,38,130_324_837_889_889_897_897_901_987_1041_1124_1131_1169_1176_,2153_2177_2190_2299_2302_2312_2315_2406_2408_2432_2435_2447_2531_2717_2720_2747_2840_2872_2918_3160_3185_3318_
122,3,午餐,N,5,4,9,130_186_196_1425_,2640_3184_3319_
122,3,中餐,N,8,8,16,130_325_330_522_531_540_1326_,2057_2616_2662_2964_3194_3360_3475_
122,3,名氣,N,4,2,6,130_618_627_,3124_
122,1,上選,A,2,0,2,130_,
122,3,步行街,N,9,1,10,130_171_521_530_980_1092_1171_1178_,
123,3,吸引人,Vi,7,1,8,131_269_572_581_730_1038_,
124,3,套房,N,30,50,80,132_401_427_427_427_433_433_599_599_608_608_672_675_755_757_809_834_835_915_990_993_1217_1227_1229_1234_1250_1353_1469_1470_,2037_2051_2054_2252_2253_2342_2454_2455_2621_2621_2652_2655_2718_2721_2750_2750_2750_2754_2761_2761_2762_2762_2903_2905_2954_2997_3103_3174_3174_3174_3239_3345_3345_3345_3345_3345_3345_3345_3363_3363_3372_3372_3372_3379_3413_3433_3433_3435_3435_
124,3,過夜,Vi,6,5,11,132_1141_1143_1443_1448_,2360_2361_2361_2934_
124,3,舒適,Vi,44,8,52,132_230_242_242_252_252_264_265_294_302_464_524_533_641_678_681_682_686_691_710_720_740_804_872_880_891_899_943_974_981_982_998_1063_1127_1134_1185_1191_1211_1350_1397_1406_1419_1473_,2746_2753_3239_3294_3345_3498_3500_
133,3,弄,Vt,4,13,17,713_723_1253_,2284_2318_2319_2549_2550_2589_2608_2680_2861_2922_3014_3324_
133,1,必,ADV,3,0,3,172_769_,
133,3,求,Vt,2,6,8,907_,2740_2803_2967_3115_3443_
133,1,花色,N,1,0,1,,
133,3,21日,N,3,9,12,1088_1203_,2534_2680_2680_2680_2680_2889_2890_3115_
133,3,答,Vt,2,16,18,390_,2753_3170_3170_3172_3172_3246_3246_3397_3431_3432_3433_3433_3435_3435_3470_
133,1,25樓,N,2,0,2,669_,
135,1,金華,N,8,0,8,138_139_140_140_142_142_151_,
135,3,直,Vi,8,3,11,422_546_555_772_776_1359_1364_,2309_3307_
136,3,補上,Vt,2,2,4,137_,3424_
136,3,現在,N,38,74,112,137_229_244_254_272_272_275_298_306_408_419_434_477_486_517_518_630_743_830_838_921_1020_1062_1088_1114_1135_1195_1197_1198_1200_1371_1378_1399_1462_1467_1469_1470_,2043_2045_2081_2083_2099_2123_2177_2195_2241_2260_2276_2305_2308_2312_2315_2320_2360_2360_2360_2361_2361_2361_2436_2439_2475_2475_2494_2495_2549_2550_2575_2582_2611_2659_2702_2744_2775_2814_2824_2826_2838_2852_2863_2925_2945_2999_3049_3072_3142_3152_3158_3190_3205_3253_3296_3367_3368_3371_3371_3382_3397_3431_3432_3433_3433_3433_3435_3435_3435_3458_3458_3488_3490_
136,3,月,N,8,26,34,138_139_336_427_630_1082_1209_,2141_2229_2260_2386_2421_2445_2445_2446_2446_2452_2612_2641_2645_2707_2708_2731_2791_2802_2834_2846_3104_3187_3189_3190_3296_
136,3,去年,N,2,5,7,461_,2201_2995_2995_3471_
137,3,手機,N,7,11,18,279_320_434_460_1020_1232_,2097_2211_2211_2391_2775_3110_3150_3385_3434_3436_
137,3,立即,ADV,8,7,15,316_707_707_717_717_1319_1324_,2680_2882_3159_3448_3453_3470_
137,3,聯繫到,Vt,1,1,2,,
137,3,哈哈,ADV,21,5,26,186_196_282_282_283_283_366_371_788_794_797_962_977_977_977_977_977_1257_1316_1321_,2322_2815_3319_3466_
137,3,小小,Vi,3,5,8,364_369_,2730_2771_2946_3418_
137,3,常客,N,1,4,5,,2298_2301_2301_
137,3,電池,N,1,1,2,,
138,3,左右,N,2,6,8,139_,2163_2166_2769_2770_3061_
138,3,關係,N,12,27,39,139_281_610_619_714_724_1028_1029_1030_1081_1135_,2137_2139_2141_2143_2273_2276_2294_2295_2372_2375_2549_2550_2613_3104_3185_3233_3345_3345_3433_3433_3433_3433_3435_3435_3435_3435_
141,1,老牌,Vi,3,0,3,1061_1329_,
141,1,感覺得到,Vt,1,0,1,,
142,3,彆扭,Vi,2,1,3,783_,
142,3,不值,Vi,9,23,32,287_379_759_830_1124_1130_1131_1137_,2123_2365_2434_2717_2718_2720_2721_2764_2773_2777_2848_2907_2959_2988_3029_3055_3222_3320_3363_3365_3423_3424_
142,3,春節,N,5,9,14,177_787_1451_1451_,2322_2543_2631_3202_3243_3253_3369_3370_
142,1,通病,N,1,0,1,,
142,3,國貿,N,7,3,10,286_287_316_450_458_1020_,2924_3437_
142,3,住宿,Vi,9,11,20,401_677_713_723_890_898_1251_1423_,2232_2360_2361_2608_2642_2646_2740_2742_3448_3453_
144,3,愛理不理,Vi,1,5,6,,2296_2553_3083_3150_
144,3,房子,N,11,12,23,448_456_713_723_830_1003_1201_1201_1328_1423_,2703_2740_2740_2803_2885_2887_2945_2946_3187_3189_3443_
144,3,難找,Vt,5,6,11,834_891_899_1261_,2444_3214_3219_3402_3407_
144,1,帶過去,Vi,1,0,1,,
144,3,跟前,N,1,1,2,,
145,3,菜,N,12,27,39,145_187_197_952_953_1005_1005_1081_1425_1425_1425_,2332_2411_2662_2742_2742_2742_2742_2742_2742_2756_2756_2793_2830_2908_2958_2976_3032_3033_3098_3184_3253_3318_3333_3347_3347_3380_
145,1,遠眺,Vt,3,0,3,391_393_,
145,3,班次,N,4,1,5,857_866_983_,
145,3,餐,N,21,17,38,184_194_237_399_514_522_531_710_720_739_948_948_1067_1074_1149_1156_1182_1188_1212_1212_,2127_2255_2257_2272_2594_2834_2834_2926_2926_3195_3195_3231_3333_3333_3360_3360_
145,3,鹹,Vi,1,1,2,,
145,1,湖景房,N,1,0,1,,
145,1,太湖,N,4,0,4,148_163_168_,
145,3,水,N,32,119,151,145_161_166_186_186_196_196_218_272_272_273_374_379_630_630_813_871_879_995_996_1026_1034_1091_1092_1266_1356_1361_1367_1398_1407_1409_,2095_2096_2097_2101_2102_2106_2106_2186_2196_2206_2235_2236_2258_2259_2272_2289_2365_2382_2391_2414_2432_2435_2450_2450_2453_2453_2459_2487_2488_2509_2517_2517_2519_2519_2522_2544_2553_2553_2578_2647_2730_2730_2730_2753_2767_2780_2784_2824_2826_2828_2845_2864_2864_2864_2873_2882_2882_2928_2928_2946_2946_2946_3014_3019_3022_3023_3038_3039_3076_3103_3103_3107_3111_3114_3159_3161_3161_3239_3242_3249_3266_3304_3327_3333_3358_3369_3370_3376_3378_3389_3390_3397_3397_3397_3425_3433_3433_3433_3433_3433_3433_3433_3433_3433_3434_3435_3435_3435_3435_3435_3435_3435_3435_3435_3436_3451_3456_3463_
145,3,清靜,Vi,1,3,4,,3434_3436_
145,3,服務費,N,4,13,17,670_670_670_,2257_2421_2421_2650_2653_2688_2972_3255_3255_3256_3256_3360_
145,1,湖州,N,12,0,12,148_163_163_164_164_164_168_168_169_169_169_,
145,3,水壺,N,3,14,17,382_385_,2139_2143_2143_2387_2553_2585_2845_3071_3073_3073_3103_3280_3295_
146,3,山莊,N,1,3,4,,2984_3347_
146,3,涼,Vi,2,6,8,1423_,2344_2349_2525_2958_3331_
147,3,真是,ADV,30,67,97,242_252_287_470_474_481_582_583_636_638_707_707_707_710_717_717_717_720_738_889_891_897_899_1041_1212_1311_1315_1326_1369_,2112_2128_2163_2220_2222_2273_2387_2426_2450_2453_2454_2455_2457_2502_2517_2519_2528_2549_2550_2552_2556_2569_2603_2605_2609_2625_2731_2787_2789_2828_2836_2842_2843_2861_2866_2923_2923_2923_3009_3010_3038_3039_3096_3107_3132_3138_3163_3182_3182_3183_3183_3186_3188_3204_3214_3219_3237_3243_3331_3345_3392_3394_3433_3433_3435_3435_
148,1,河鮮,N,2,0,2,148_,
148,3,周,N,3,4,7,521_530_,2554_2555_3398_
148,3,停,Vt,11,14,25,162_167_424_707_710_717_720_787_1026_1087_,2360_2361_2573_2748_2748_2812_2934_3142_3233_3392_3394_3487_3487_
148,1,厭,Vt,1,0,1,,
148,3,部,N,3,5,8,233_417_,2609_2771_2771_3466_
148,3,價廉,Vi,1,1,2,,
148,1,有名,Vi,4,0,4,394_599_608_,
148,3,銷售,Vt,1,5,6,,2771_2834_3227_3227_
148,1,城市人,N,1,0,1,,
148,1,路況,N,1,0,1,,
148,1,船菜,N,1,0,1,,
148,1,駕車,Vi,5,0,5,424_728_732_1333_,
148,3,約,ADV,4,10,14,813_847_1254_,2424_2483_2813_2828_3073_3074_3163_3171_3173_
148,3,新鮮,Vi,5,3,8,148_846_856_865_,3187_3189_
148,3,出門,Vi,41,28,69,231_248_258_316_320_418_629_657_701_708_718_752_754_783_844_854_863_885_888_889_891_893_896_897_899_902_915_923_923_931_931_983_1017_1028_1054_1232_1232_1428_1431_1473_,2153_2162_2232_2272_2360_2361_2436_2636_2695_2828_2838_2861_2939_2940_3040_3069_3070_3071_3163_3253_3419_3433_3433_3433_3435_3435_3435_
149,3,慘不忍睹,Vi,1,5,6,,2315_2528_2627_3156_
149,3,出行,Vi,25,13,38,286_288_461_567_576_648_654_848_886_886_890_894_894_898_919_964_1011_1142_1144_1194_1208_1296_1300_1430_,2284_2322_2539_2698_2810_2811_2916_3019_3022_3023_3137_3148_
149,3,你,N,76,295,371,185_186_187_195_196_197_231_341_341_409_521_530_540_548_557_584_593_593_593_602_602_602_610_619_628_631_631_670_707_707_711_711_717_717_721_721_729_738_786_799_830_830_856_865_871_879_886_887_889_894_895_897_907_917_943_943_949_1016_1029_1112_1120_1169_1176_1201_1250_1270_1273_1319_1319_1324_1324_1430_1450_1450_1500_,2031_2043_2045_2081_2081_2081_2081_2081_2081_2081_2081_2081_2083_2083_2083_2083_2083_2083_2083_2083_2083_2090_2095_2097_2104_2124_2126_2126_2126_2136_2139_2140_2143_2159_2164_2164_2195_2206_2206_2229_2229_2231_2231_2231_2231_2232_2232_2232_2247_2248_2250_2272_2272_2276_2287_2287_2288_2288_2290_2312_2313_2315_2316_2318_2318_2319_2319_2322_2342_2392_2417_2445_2446_2447_2450_2452_2453_2492_2509_2516_2516_2518_2518_2523_2528_2547_2549_2549_2549_2549_2550_2550_2550_2550_2566_2566_2566_2575_2579_2584_2584_2595_2595_2608_2608_2611_2651_2651_2651_2651_2651_2654_2654_2654_2654_2654_2671_2671_2691_2698_2698_2718_2718_2718_2721_2721_2721_2731_2738_2745_2745_2746_2746_2746_2746_2746_2753_2771_2776_2809_2812_2838_2846_2848_2851_2861_2861_2884_2886_2976_2976_2988_2988_2988_2997_3015_3022_3023_3025_3027_3037_3038_3038_3038_3038_3038_3039_3039_3039_3039_3039_3040_3040_3040_3054_3054_3054_3058_3071_3076_3076_3076_3076_3095_3103_3107_3118_3133_3133_3133_3152_3184_3184_3187_3187_3187_3189_3189_3189_3225_3225_3241_3241_3244_3244_3246_3246_3246_3246_3246_3247_3247_3247_3247_3276_3278_3279_3282_3289_3289_3289_3289_3289_3289_3290_3290_3290_3290_3290_3290_3291_3292_3295_3295_3306_3307_3313_3313_3316_3331_3331_3331_3331_3333_3333_3333_3360_3367_3368_3385_3385_3391_3391_3393_3393_3397_3405_3405_3409_3409_3409_3409_3409_3410_3410_3412_3427_3427_3433_3433_3433_3433_3433_3435_3435_3435_3435_3435_3443_3445_3448_3448_3448_3448_3453_3453_3453_3453_3458_3488_3488_3490_3490_3493_
149,1,面臨,Vt,2,0,2,754_,
149,3,風景,N,28,10,38,175_179_185_189_195_281_348_364_369_669_670_708_718_738_782_785_809_820_834_843_946_1012_1014_1015_1049_1311_1315_,2045_2155_2376_2500_2501_2629_2742_2933_3372_
149,1,河,N,6,0,6,154_820_822_1296_1300_,
149,3,說得過去,Vi,4,1,5,433_1173_1180_,
149,3,縣城,N,1,5,6,,3038_3039_3154_3155_
150,3,夏天,N,5,1,6,229_351_361_1054_,
150,3,好在,ADV,8,16,24,422_546_555_588_782_846_1091_,2616_2647_2675_2677_2748_2806_2841_2983_2984_3095_3110_3110_3289_3290_3319_
150,3,經濟型,N,4,11,15,842_1186_1192_,2116_2119_2284_2606_2719_2722_2744_3099_3115_3202_
150,3,味,N,3,11,14,1476_1483_,2202_2405_2407_2517_2519_2588_2601_3380_3450_3455_
150,1,屏,N,1,0,1,,
150,3,配,Vt,8,3,11,1002_1007_1149_1156_1211_1253_1253_,2899_3162_
150,3,隔音,A,52,102,154,157_172_176_239_241_246_247_249_251_256_257_393_408_417_434_507_546_555_584_657_662_700_761_831_935_957_970_971_978_1015_1022_1042_1054_1068_1075_1112_1120_1181_1187_1212_1219_1221_1254_1295_1299_1332_1352_1356_1361_1421_1456_,2006_2044_2076_2077_2116_2119_2126_2151_2166_2188_2207_2213_2239_2246_2292_2296_2305_2308_2325_2326_2367_2418_2445_2446_2470_2484_2489_2492_2541_2557_2575_2611_2671_2704_2718_2721_2740_2747_2772_2791_2829_2839_2845_2862_2869_2908_2909_2910_2912_2925_2926_2927_2931_2969_2990_2992_2996_3006_3037_3041_3058_3099_3107_3117_3119_3124_3152_3153_3205_3214_3219_3231_3233_3257_3260_3262_3263_3278_3278_3284_3285_3318_3318_3319_3327_3331_3333_3341_3341_3402_3407_3418_3428_3431_3432_3443_3463_3464_3485_3487_3493_
150,3,擠,Vi,6,3,9,211_245_255_648_654_,2483_2639_
150,3,浙江,N,1,2,3,,2758_
150,3,潮氣,N,1,1,2,,
150,3,屬於,Vt,15,10,25,158_287_413_642_858_867_876_884_904_1010_1092_1297_1301_1436_,2169_2359_2417_2492_2634_2951_3055_3345_3396_
150,1,成熟型,N,1,0,1,,
151,3,聲,N,4,5,9,163_168_1019_,2207_2861_2946_3418_
151,3,敬業,Vi,6,1,7,709_719_917_948_1019_,
151,3,掉,Vt,2,23,25,177_,2193_2204_2228_2505_2616_2631_2707_2708_2753_2756_2823_2825_2888_2925_2925_2976_3076_3103_3174_3246_3288_3463_
151,1,照相機線,N,1,0,1,,
151,1,遞到,Vt,1,0,1,,
152,3,趕,Vt,5,20,25,321_379_816_1145_,2186_2798_2800_3084_3101_3118_3184_3193_3231_3281_3291_3291_3292_3292_3337_3360_3433_3435_3462_
152,3,花,Vt,23,41,64,204_210_227_227_290_374_392_422_520_521_529_530_615_624_968_1057_1086_1097_1114_1378_1495_1495_,2161_2162_2162_2162_2252_2253_2372_2375_2399_2401_2516_2518_2534_2534_2596_2597_2611_2615_2626_2698_2797_2797_2834_2838_2850_2881_2934_2946_2967_3002_3037_3159_3185_3246_3253_3333_3340_3413_3417_3458_
152,1,衢州,N,3,0,3,154_158_,
152,3,主意,N,1,1,2,,
152,3,改,Vt,2,6,8,174_,2404_2556_2671_3013_3257_
152,1,刻意,ADV,1,0,1,,
152,3,睡,Vi,18,70,88,218_223_229_245_255_340_565_574_636_638_707_717_847_847_872_880_1348_,2050_2053_2059_2059_2084_2085_2090_2090_2122_2126_2136_2140_2159_2276_2304_2307_2367_2372_2375_2384_2483_2540_2699_2742_2748_2767_2772_2857_2858_2862_2884_2886_2909_2910_2953_2955_3049_3063_3118_3137_3184_3195_3223_3231_3242_3327_3327_3341_3418_3431_3431_3431_3431_3431_3431_3432_3432_3432_3432_3432_3432_3433_3433_3435_3435_3443_3467_3473_3485_
152,3,天房費,N,2,9,11,1054_,2293_2447_2554_2554_2555_2555_2876_3049_
152,3,凌晨,N,8,18,26,153_220_732_771_775_1061_1366_,2162_2333_2334_2342_2372_2375_2425_2428_2908_2996_3049_3071_3159_3270_3413_3470_3473_
153,1,驚擾,Vt,1,0,1,,
153,3,使,Vt,6,16,22,316_634_982_1031_1114_,2097_2305_2308_2530_2535_2535_2536_2576_2702_2746_2756_2857_2858_2946_3319_
153,3,次日,N,3,3,6,1367_1367_,2097_3413_
153,3,尚,ADV,3,2,5,960_1367_,2492_
153,3,區區,ADV,1,1,2,,
153,3,夜,N,8,32,40,546_555_677_707_717_876_884_,2337_2372_2375_2406_2408_2510_2511_2532_2533_2611_2740_2740_2793_2861_2873_2924_3009_3010_3072_3159_3233_3236_3257_3262_3263_3265_3270_3413_3448_3453_3483_
153,3,未,ADV,11,39,50,326_331_334_628_657_743_802_995_996_1061_,2059_2139_2143_2208_2305_2308_2322_2391_2417_2508_2532_2533_2671_2731_2739_2750_2873_2882_2970_2976_2977_2996_3083_3086_3105_3160_3170_3172_3226_3297_3316_3341_3388_3388_3388_3417_3489_3491_
153,3,房卡,N,3,21,24,518_1430_,2005_2047_2126_2174_2284_2582_2582_2582_2784_2873_2873_3083_3083_3150_3150_3254_3254_3254_3296_3473_
153,3,詢問,Vt,11,30,41,203_209_335_434_736_759_814_1057_1062_1431_,2134_2134_2229_2269_2309_2671_2680_2731_2731_2793_3032_3033_3083_3083_3115_3133_3241_3253_3257_3308_3308_3308_3360_3360_3360_3433_3435_3470_3470_
153,1,美夢,N,2,0,2,982_,
153,3,欠,Vt,3,17,20,516_641_,2085_2134_2314_2317_2383_2460_2461_2642_2646_2649_2867_2958_3083_3115_3152_3471_
153,3,早晨,N,1,22,23,,2083_2126_2126_2191_2450_2453_2527_2603_2605_2791_2799_2864_2897_2978_2987_3049_3118_3146_3242_3341_3341_
153,3,眠,Vi,1,3,4,,2533_3072_
153,3,為何,ADV,3,7,10,938_1383_,2857_2858_2869_2968_2968_3195_
154,3,窗口,N,5,2,7,872_880_919_1232_,3067_
154,3,住到,Vt,6,8,14,181_191_939_1115_1500_,2885_2887_3111_3184_3320_3344_3463_
154,3,看出去,Vi,4,1,5,870_878_919_,
155,1,住住看,Vt,1,0,1,,
155,3,行李員,N,8,2,10,631_710_720_944_944_944_1095_,3388_
155,3,主動,Vi,50,24,74,182_182_186_192_192_196_242_242_252_252_298_306_320_320_321_341_407_470_474_477_486_520_529_551_560_631_709_710_719_720_748_801_843_873_881_889_897_964_982_982_1088_1103_1201_1207_1359_1364_1430_1437_1500_,2388_2450_2450_2453_2453_2544_2748_2835_3038_3039_3055_3133_3184_3225_3225_3231_3231_3233_3283_3289_3290_3306_3337_
155,3,登記,Vt,11,29,40,276_437_710_714_720_724_960_1019_1062_1095_,2134_2144_2145_2229_2359_2454_2455_2483_2502_2516_2516_2516_2516_2518_2518_2518_2518_2609_2615_2724_2724_2746_2784_2828_3083_3289_3290_3465_
155,3,操作,Vt,1,4,5,,2388_2690_3115_
155,1,泊,Vi,1,0,1,,
155,3,貴賓,N,8,15,23,316_707_717_982_982_1126_1133_,2077_2078_2168_2177_2178_2322_2731_2936_2937_3009_3010_3345_3488_3490_
155,3,沒想到,ADV,9,20,29,186_196_870_878_958_1197_1200_1232_,2243_2391_2561_2562_2740_2740_2742_2742_2815_2861_2883_3047_3051_3231_3237_3308_3413_3418_3472_
156,1,相配,Vi,2,0,2,1091_,
156,3,樓上,N,13,17,30,584_738_771_775_857_866_872_875_880_883_1211_1211_,2035_2166_2272_2272_2392_2406_2408_2611_2953_3032_3033_3103_3232_3289_3290_3341_
157,3,明確,Vi,1,2,3,,3254_
157,3,形象,N,4,7,11,242_252_320_,2359_2363_2671_2671_3065_3067_
157,1,建造,Vt,1,0,1,,
157,1,不久,N,2,0,2,1418_,
157,3,歉意,N,10,39,49,246_256_516_568_577_743_1114_1169_1176_,2126_2177_2258_2259_2305_2308_2322_2322_2359_2432_2435_2447_2483_2589_2590_2616_2731_2744_2747_2759_2761_2761_2762_2762_2857_2858_2862_3146_3146_3163_3231_3253_3371_3431_3432_3448_3453_3483_
157,3,允許,Vt,2,7,9,1472_,2081_2083_2131_2133_2232_3345_
157,3,誠摯,Vi,1,8,9,,2744_2747_2857_2858_3024_3026_3163_
157,1,工段,N,1,0,1,,
157,3,噪音,N,16,42,58,338_495_573_657_677_703_705_1091_1337_1469_1469_1469_1470_1470_1470_,2033_2035_2035_2062_2177_2268_2304_2305_2305_2305_2305_2307_2308_2308_2308_2308_2406_2408_2510_2511_2568_2665_2695_2772_2783_2861_2965_2966_2996_2996_3029_3037_3047_3051_3072_3187_3189_3304_3387_3443_3467_
157,1,初期,N,3,0,3,616_625_,
157,3,同時,N,17,31,48,515_516_649_655_750_982_1170_1177_1254_1309_1313_1319_1319_1324_1324_1346_,2003_2005_2037_2037_2084_2085_2126_2180_2284_2333_2334_2359_2447_2494_2495_2535_2582_2608_2759_2759_2861_2862_2908_3163_3163_3205_3231_3327_3341_3462_
157,3,規定,N,7,33,40,699_699_1073_1080_1472_1472_,2081_2083_2231_2244_2245_2454_2454_2455_2455_2549_2550_2554_2554_2555_2555_2594_2761_2762_2798_2800_2869_2972_3009_3009_3010_3010_3038_3039_3049_3049_3115_3487_
157,3,迎接,Vt,1,2,3,,2259_
157,3,12月,N,10,18,28,588_590_1072_1073_1079_1080_1353_1428_1429_,2283_2469_2494_2495_2608_2608_2814_2827_2889_2890_2902_2904_3009_3010_3117_3444_3471_
157,3,28日,N,8,7,15,364_369_800_962_1203_1270_1273_,3024_3026_3448_3448_3453_3453_
157,3,東方,N,5,5,10,157_242_252_819_,2484_2659_2993_2994_
157,3,施工,Vi,5,18,23,157_246_256_672_,2008_2151_2432_2435_2588_2639_2710_2710_2710_2712_2712_2712_2747_2747_2849_3341_3341_
157,1,樓頂,N,4,0,4,1097_1326_1326_,
158,3,被子,N,11,45,56,366_371_451_459_636_638_751_848_1332_1423_,2045_2065_2103_2116_2119_2161_2163_2247_2247_2247_2260_2260_2462_2477_2534_2546_2549_2549_2550_2550_2631_2656_2703_2773_2773_2773_2815_2869_2953_2967_2972_2999_3158_3205_3289_3290_3380_3389_3389_3390_3390_3470_3470_3477_
158,3,出入,Vt,6,9,15,176_904_997_1280_1287_,2582_2714_2748_2854_2883_3296_3296_3400_
158,3,太少,Vi,9,7,16,506_573_635_637_733_1050_1356_1361_,2328_2330_2623_2794_3153_3475_
158,3,干,Vt,1,3,4,,2233_3487_
158,3,打招呼,Vi,11,2,13,182_182_192_192_714_724_1088_1112_1120_1430_,3306_
158,3,濕,Vi,6,6,12,631_793_796_1208_1211_,2319_2553_2787_2789_3472_
158,1,分離,Vt,1,0,1,,
159,3,公園,N,24,5,29,228_582_583_669_752_754_786_804_813_815_815_835_886_886_886_887_890_894_894_894_895_898_1017_,3091_3171_3173_3417_
159,1,府山,N,1,0,1,,
160,3,好些,Vi,3,2,5,1005_1437_,3124_
160,3,聽取,Vt,1,1,2,,
160,3,些,ADV,32,7,39,162_162_167_167_198_218_270_281_342_352_411_569_578_669_756_758_768_814_826_859_868_964_1003_1020_1032_1109_1117_1125_1132_1474_1498_,2634_2841_2895_2946_3206_3458_
160,3,道理,N,6,2,8,388_546_555_762_902_,3315_
160,3,願意,Vt,8,19,27,178_188_442_449_457_584_905_,2231_2272_2376_2498_2551_2596_2597_2680_2746_2779_2967_3002_3037_3107_3184_3187_3189_3243_
161,3,外面,N,36,66,102,166_229_229_242_252_268_281_388_460_518_540_636_638_657_669_876_884_945_1106_1112_1112_1120_1120_1242_1246_1270_1270_1273_1273_1316_1321_1428_1450_1450_1472_,2034_2060_2155_2193_2198_2252_2253_2272_2291_2292_2313_2316_2421_2432_2435_2460_2461_2553_2595_2595_2616_2626_2730_2730_2747_2757_2758_2760_2793_2816_2818_2845_2849_2861_2861_2862_2883_2889_2890_2945_3032_3032_3033_3033_3040_3040_3047_3051_3063_3083_3111_3132_3152_3153_3194_3211_3216_3288_3347_3352_3354_3385_3434_3436_3467_
161,3,高級房,N,5,4,9,166_643_1393_1402_,2739_2822_3097_
161,3,難以,ADV,6,20,26,166_1000_1257_1359_1364_,2244_2245_2335_2608_2608_2616_2740_2790_2931_2972_3030_3047_3051_3170_3172_3174_3175_3176_3233_
161,3,游泳池,N,21,10,31,161_166_166_183_193_508_707_713_717_723_851_860_921_1088_1106_1154_1161_1204_1215_1343_,2517_2519_2731_2731_2813_2939_2940_3059_3231_
161,3,理,Vt,3,4,7,166_1081_,3241_3307_3475_
162,3,起,Vt,2,7,9,167_,2528_2746_2775_3184_3194_3418_
162,3,緣故,N,9,3,12,167_334_434_522_531_650_656_902_,2265_2737_
162,3,浴缸,N,19,28,47,167_186_196_248_253_258_289_660_687_692_745_957_1239_1253_1271_1271_1274_1274_,2062_2139_2143_2204_2271_2382_2394_2419_2419_2421_2487_2488_2508_2522_2730_2730_2931_3083_3111_3111_3112_3204_3319_3319_3363_3379_3415_
162,3,仍,ADV,10,10,20,167_225_324_820_902_1082_1125_1132_1451_,2322_2671_2731_2791_2996_3049_3083_3083_3364_
162,3,可否,ADV,2,1,3,167_,
162,1,熄燈,Vi,3,0,3,167_980_,
162,3,看來,ADV,17,11,28,167_310_314_429_546_555_629_630_1013_1082_1098_1239_1408_1413_1423_1428_,2517_2517_2519_2519_2815_2869_3110_3281_3373_3374_
162,3,車庫,N,6,4,10,167_445_445_453_453_,3204_3205_3205_
162,1,如是,Vi,4,0,4,167_856_865_,
162,1,百葉窗,N,2,0,2,167_,
162,3,原來,ADV,26,47,73,167_241_241_251_251_538_687_692_710_710_720_720_771_775_802_887_887_887_895_895_895_1296_1300_1309_1313_,2101_2102_2125_2139_2143_2269_2272_2272_2272_2298_2301_2309_2309_2360_2361_2483_2565_2669_2730_2731_2731_2732_2775_2775_2841_2881_2946_2946_2953_2958_2959_2976_2976_2988_3079_3103_3103_3103_3103_3159_3233_3318_3319_3327_3327_3327_
162,3,複雜,Vi,3,5,8,167_392_,2927_3087_3431_3432_
162,3,面,N,3,9,12,167_1052_,2041_2383_2528_2609_2945_3150_3239_3357_
162,1,大窗,N,4,0,4,162_167_167_,
162,3,地下,N,4,2,6,162_167_167_,3205_
162,3,作用,N,4,2,6,167_220_1326_,3194_
162,3,訪客,N,2,2,4,167_,3446_
162,1,老伯,N,2,0,2,167_,
162,3,時隔,Vt,3,2,5,167_1236_,2942_
162,3,負責,Vt,7,13,20,167_215_238_316_377_799_,2671_2924_3001_3107_3170_3172_3254_3340_3345_3462_3495_3497_
162,1,房訂,Vt,2,0,2,167_,
162,1,傳真機,N,4,0,4,167_226_1249_,
162,3,牆,N,10,30,40,162_167_167_745_970_1007_1049_1057_1473_,2086_2126_2126_2144_2145_2272_2286_2381_2416_2492_2515_2521_2610_2730_2750_2790_2791_2945_2945_3076_3089_3205_3214_3219_3276_3278_3318_3319_3409_
162,1,加裝,Vt,2,0,2,167_,
162,3,實用,Vi,8,1,9,163_167_168_784_842_970_1253_,
162,3,管,Vt,8,14,22,167_217_320_320_670_960_1256_,2549_2549_2549_2550_2550_2550_2572_2680_2703_2865_3210_3215_3414_
162,3,漂亮,Vi,35,9,44,163_167_168_171_176_242_242_242_252_252_252_373_408_476_485_524_533_669_886_889_894_897_919_928_936_956_979_1049_1049_1088_1091_1113_1121_1269_,2672_2682_2685_2740_2797_3099_3391_3393_
163,1,黃昏,N,2,0,2,168_,
163,3,一定,ADV,45,63,108,168_177_217_227_321_321_351_361_377_482_491_521_524_530_533_540_554_563_599_608_856_865_885_893_910_919_928_936_1028_1054_1055_1088_1169_1176_1232_1253_1326_1378_1394_1403_1408_1413_1423_1499_,2025_2061_2081_2083_2162_2169_2232_2252_2252_2253_2253_2258_2259_2264_2322_2370_2373_2445_2446_2483_2483_2530_2573_2630_2637_2638_2651_2654_2715_2716_2718_2719_2721_2722_2740_2747_2752_2769_2770_2846_2933_2946_2967_3074_3098_3185_3185_3193_3210_3215_3246_3267_3279_3281_3283_3341_3341_3383_3384_3448_3453_3483_
163,3,高速,Vi,5,8,13,168_320_543_1202_,2231_2360_2361_3012_3069_3070_3259_
163,3,大小,N,16,10,26,168_260_262_448_456_851_853_860_862_888_896_957_1005_1250_1353_,2284_2623_2817_2819_2840_3352_3354_3392_3394_
163,3,國際,N,23,34,57,164_168_169_222_229_391_437_610_619_663_666_675_751_751_842_846_1020_1020_1020_1020_1040_1088_,2071_2095_2095_2095_2095_2097_2097_2097_2097_2287_2288_2391_2426_2426_2503_2514_2561_2562_2828_2925_3001_3001_3011_3013_3015_3159_3159_3220_3221_3288_3443_3489_3491_
163,1,日程,N,2,0,2,168_,
163,1,打烊,Vi,2,0,2,168_,
163,3,賣,Vt,11,11,22,165_168_170_540_663_856_865_917_1238_1450_,2069_2139_2143_2244_2245_2272_3288_3294_3345_3421_
163,1,兼顧,Vt,2,0,2,168_,
163,3,得多,ADV,5,4,9,168_310_314_751_,2703_3194_3417_
163,1,但願,Vt,2,0,2,168_,
163,3,暗暗,ADV,2,2,4,168_,2090_
163,1,燈熄,Vt,2,0,2,168_,
163,3,有所,Vt,24,8,32,168_242_252_281_294_302_310_314_599_608_610_619_647_653_940_954_982_983_1193_1254_1272_1275_1371_,2674_2684_2687_2750_2889_2890_3320_
163,3,上下,N,4,7,11,168_1490_1493_,2946_3083_3119_3124_3259_3360_
163,3,忠實,Vi,2,3,5,168_,3345_3345_
163,3,酒吧,N,8,6,14,168_660_663_785_848_921_1147_,2162_2162_2162_2802_3345_
163,3,不比,Vt,2,2,4,168_,2698_
163,1,傍晚,N,5,0,5,168_710_720_1020_,
163,3,大橋,N,6,2,8,163_168_168_1410_1415_,3319_
163,3,拿到,Vt,4,11,15,168_449_457_,2102_2284_2284_2290_2309_2416_2560_2731_2750_2750_
163,3,催,Vt,3,13,16,168_1425_,2464_2466_2534_2747_2754_2807_3291_3291_3292_3292_3360_3360_
163,3,僅,ADV,10,7,17,168_649_655_908_908_908_908_1127_1134_,2388_2740_2750_2967_3058_3204_
163,1,極好,Vi,8,0,8,168_226_710_720_1023_1102_1267_,
163,3,口,N,13,11,24,168_187_197_793_796_910_1016_1020_1031_1031_1356_1361_,2232_2365_2484_2544_3098_3139_3196_3319_3319_3446_
163,3,包,Vt,12,22,34,168_589_639_819_871_871_879_879_1096_1212_1427_,2068_2223_2252_2253_2835_2872_2917_3083_3185_3195_3195_3313_3388_3433_3433_3435_3435_3451_3456_3475_3475_
163,1,駕車族,N,2,0,2,168_,
163,3,淋浴房,N,7,10,17,168_713_723_754_755_757_,2117_2126_2126_2233_2492_2931_2953_3433_3435_
163,3,匆忙,Vi,4,5,9,168_471_475_,2960_2962_3103_3319_
163,1,亮起,Vt,2,0,2,168_,
163,3,是否,ADV,13,27,40,168_217_326_331_363_368_546_555_753_779_1057_1062_,2232_2232_2266_2342_2450_2453_2498_2731_2740_2756_2776_2784_2804_2933_2967_3083_3246_3281_3298_3301_3327_3331_3470_3470_3489_3491_
163,1,停靠,Vt,3,0,3,168_957_,
163,3,入睡,Vi,4,19,23,168_220_1331_,2097_2202_2344_2349_2460_2461_2535_2557_2639_2862_3030_3044_3048_3204_3205_3233_3293_3331_
163,1,相當於,Vt,5,0,5,168_828_1029_1048_,
163,1,店家,N,2,0,2,168_,
163,1,駛過,Vt,2,0,2,168_,
163,3,燈光,N,11,13,24,168_228_522_531_662_874_882_910_1020_1091_,2090_2144_2145_2266_2398_2579_2756_2774_2817_2819_3118_3258_
163,1,比散客,N,2,0,2,168_,
163,3,用戶,N,2,13,15,168_,2364_2623_2960_2962_3076_3083_3107_3170_3172_3357_3488_3490_
163,1,浸染,Vt,2,0,2,168_,
163,3,就餐,Vi,4,15,19,168_518_701_,2133_2445_2445_2445_2446_2446_2446_2594_2615_2652_2655_2873_2882_3083_
163,1,新城區,N,3,0,3,168_422_,
163,3,度假,Vi,19,10,29,168_186_196_316_391_710_710_716_720_720_726_738_851_852_860_861_998_1091_,2376_2746_2775_2775_2775_3246_3246_3272_3418_
163,1,出名,Vi,5,0,5,168_771_775_815_,
163,1,鈴聲,N,2,0,2,168_,
163,1,中西,A,4,0,4,168_1441_1446_,
163,1,眾口,N,2,0,2,168_,
163,3,旅行社,N,3,6,9,168_632_,2851_3488_3489_3490_3491_
163,3,彼伏,N,2,1,3,168_,
163,3,留下,Vt,15,19,34,168_551_560_703_705_707_717_944_1028_1028_1029_1091_1296_1300_,2059_2071_2095_2097_2190_2258_2259_2380_2382_2541_2599_2754_2908_2954_2977_3015_3101_3246_
163,1,近年,N,2,0,2,168_,
163,3,眾多,Vi,4,2,6,168_644_1371_,2609_
163,3,緊,Vi,9,16,25,168_348_713_723_782_908_924_932_,2035_2037_2191_2271_2483_2500_2501_2634_2775_2861_2861_3040_3118_3345_3487_
163,1,微詞,N,2,0,2,168_,
163,3,計劃,Vt,2,7,9,168_,2233_2362_2554_2555_2669_2756_
163,1,日光,N,4,0,4,168_1398_1407_,
163,3,嘗嘗,Vt,3,1,4,168_684_,
163,1,叮噹,ADV,3,0,3,168_792_,
163,1,豆腐乾,N,2,0,2,168_,
164,1,專賣店,N,5,0,5,169_779_875_883_,
164,1,青山綠水,N,2,0,2,169_,
164,1,毛筆,N,2,0,2,169_,
164,1,絲綢,N,2,0,2,169_,
164,3,遊玩,Vi,2,4,6,169_,2714_2933_2933_
164,1,小假,N,2,0,2,169_,
164,1,情趣,N,3,0,3,169_1104_,
164,3,挑選,Vt,2,1,3,169_,
164,3,方式,N,4,13,17,169_857_866_,2252_2253_2309_2609_2902_2904_2925_3001_3146_3294_3433_3435_
164,1,市民,N,2,0,2,169_,
164,3,熱鬧,Vi,21,1,22,165_169_170_272_521_530_550_559_783_818_819_890_898_1113_1121_1171_1178_1228_1230_1345_,
164,1,別有,Vt,2,0,2,169_,
164,1,特產,N,2,0,2,169_,
164,1,領略,Vt,2,0,2,169_,
164,3,假期,N,6,6,12,169_242_252_710_720_,3253_3253_3253_3423_3424_
164,3,1日,N,10,26,36,169_183_193_711_721_885_893_1061_1428_,2204_2322_2386_2447_2464_2466_2547_2582_2616_2675_2677_2815_2816_2816_2818_2818_2902_2904_3047_3051_3119_3124_3205_3383_3384_
164,1,處在,Vt,5,0,5,169_501_1151_1158_,
164,1,常常區,N,2,0,2,169_,
164,1,純,Vi,5,0,5,169_715_725_1367_,
164,1,靜心,Vi,2,0,2,169_,
165,3,總店,N,2,1,3,170_,
165,1,紅旗路,N,2,0,2,170_,
165,3,雙人房,N,6,12,18,170_1030_1030_1316_1321_,2298_2298_2298_2301_2301_2301_2515_2621_2621_2752_2907_
165,1,蓮,N,2,0,2,170_,
165,1,王一品,N,2,0,2,170_,
165,3,絕對,Vi,20,47,67,170_187_197_324_554_563_710_720_858_867_991_991_994_994_1101_1101_1343_1366_1500_,2105_2123_2126_2135_2161_2190_2232_2365_2436_2445_2446_2459_2485_2544_2576_2671_2688_2702_2723_2745_2746_2754_2776_2822_2830_2846_2851_2859_2967_2973_3075_3075_3075_3162_3180_3243_3305_3363_3372_3395_3419_3443_3445_3448_3453_3458_
165,3,筆,N,2,1,3,170_,
165,1,丁香,N,2,0,2,170_,
171,3,發霉,Vi,3,23,26,745_1341_,2020_2039_2039_2041_2041_2061_2093_2126_2126_2190_2321_2324_2367_2541_2743_2748_2782_3030_3326_3351_3397_3443_
171,1,張裕,N,1,0,1,,
171,1,葡萄酒,N,1,0,1,,
171,1,沾水,Vi,1,0,1,,
171,3,音樂,N,5,7,12,660_710_720_767_,2487_2488_2510_2510_2511_2511_
171,3,中央,N,6,26,32,280_338_1040_1088_1348_,2460_2461_2462_2517_2519_2531_2531_2611_2740_2898_2946_2971_2976_3065_3067_3089_3117_3252_3304_3413_3413_3418_3443_3447_3466_
171,1,噴泉,N,3,0,3,738_767_,
171,1,結露,N,1,0,1,,
171,1,風機盤管,N,1,0,1,,
171,3,滑,Vi,3,1,4,443_443_,
171,3,極,ADV,10,89,99,401_521_530_677_1081_1309_1313_1367_1369_,2079_2093_2112_2198_2213_2239_2258_2259_2279_2322_2322_2335_2382_2388_2471_2528_2530_2604_2649_2709_2711_2765_2767_2767_2791_2828_2867_2901_2960_2962_2979_2979_3002_3004_3022_3022_3023_3023_3043_3058_3069_3070_3074_3083_3107_3110_3119_3119_3124_3124_3133_3162_3163_3163_3177_3185_3209_3260_3261_3266_3316_3317_3318_3329_3332_3341_3341_3341_3372_3373_3374_3385_3388_3389_3390_3406_3406_3411_3411_3418_3451_3456_3471_3480_3480_3482_3482_3492_
171,1,保溫,Vi,1,0,1,,
171,1,博物館,N,5,0,5,822_822_1141_1143_,
171,1,煙台山,N,1,0,1,,
171,1,炮台,N,1,0,1,,
172,3,言,Vt,1,10,11,,2284_2314_2317_2824_2826_2976_3226_3296_3327_
172,3,想必,ADV,1,1,2,,
172,3,盡量,ADV,5,8,13,437_982_1005_1088_,2759_2951_3024_3026_3036_3055_3371_
172,3,亮,Vt,2,10,12,1437_,2790_2841_2841_2841_2863_2873_3321_3322_3331_
172,3,不佳,Vi,1,3,4,,2823_2825_
172,3,引發,Vt,1,2,3,,2800_
172,3,嚴,Vi,1,2,3,,3476_
172,3,則,ADV,12,4,16,540_610_619_858_867_885_885_893_893_1295_1299_,2259_2609_3185_
172,3,選,Vt,23,18,41,173_229_248_258_470_474_497_610_619_715_725_856_865_876_884_885_893_910_998_1009_1037_1431_,2238_2343_2484_2517_2519_2775_2949_2967_2967_2975_2975_3098_3161_3175_3176_3405_3410_
172,3,醒,Vi,3,11,14,427_1339_,2375_2767_2953_3289_3290_3418_3418_3418_3425_3470_
172,3,海景房,N,40,14,54,172_183_193_242_242_244_247_252_252_254_257_364_369_672_707_717_780_784_804_805_805_843_885_888_888_888_889_889_893_896_896_896_897_897_916_1088_1089_1425_1429_,2266_2318_2318_2319_2319_2883_2956_2957_3110_3204_3205_3347_3347_
172,1,邊上拉,N,1,0,1,,
172,3,景房,N,3,9,12,273_780_,2767_2767_2930_2932_3086_3086_3086_3086_
172,3,了了,Vi,3,1,4,521_530_,
172,3,響,Vi,10,10,20,186_196_1040_1055_1217_1218_1332_1443_1448_,2410_2505_2609_2631_2647_2932_2971_3278_3385_
172,3,景,N,2,4,6,663_,2457_2714_2976_
172,3,光線,N,1,6,7,,2750_2912_3139_3479_3481_
172,3,所謂,Vt,9,42,51,231_388_433_435_658_1007_1033_1423_,2195_2243_2276_2287_2288_2309_2359_2399_2401_2504_2516_2518_2549_2550_2564_2606_2636_2728_2729_2796_2881_2893_2945_2946_2968_3111_3111_3133_3146_3180_3204_3242_3282_3288_3288_3331_3345_3347_3353_3355_3460_
172,3,呼呼,ADV,1,2,3,,2789_
172,3,燈,N,1,24,25,,2047_2090_2543_2561_2561_2562_2562_2684_2687_2841_2841_3103_3203_3204_3237_3246_3288_3321_3321_3322_3322_3415_3417_
172,3,進來,Vi,3,12,15,1155_1162_,2148_2291_2523_2523_2769_2770_2828_2835_2946_2958_3366_
172,3,窗簾,N,7,12,19,268_281_340_980_1026_1088_,2657_2740_2939_2940_2953_3089_3239_3352_3354_3434_3436_
173,3,收銀,N,1,2,3,,2518_
173,3,該,ADV,9,25,34,211_675_961_1238_1270_1273_1489_1492_,2015_2029_2029_2196_2359_2359_2387_2393_2530_2546_2551_2671_2745_2745_2791_2924_2973_3031_3133_3139_3331_3341_3448_3453_
173,1,塵氣,N,1,0,1,,
173,3,敲門,Vi,6,6,12,912_1155_1162_1169_1176_,2116_2119_2521_2544_2746_
173,3,還要,ADV,8,33,41,213_374_437_740_786_901_1208_,2085_2161_2333_2334_2360_2360_2361_2361_2386_2512_2554_2555_2705_2706_2869_2882_2933_2974_2980_2988_3001_3065_3067_3072_3185_3313_3324_3363_3413_3434_3436_3466_
173,3,吸,Vt,1,1,2,,
173,3,名義,N,3,1,4,1195_1198_,
173,1,點醒,Vt,1,0,1,,
173,3,受,Vt,6,4,10,245_255_1062_1073_1080_,2284_2822_2934_
173,3,叫,Vt,27,113,140,227_280_334_336_379_422_518_521_530_610_619_644_657_670_670_710_720_745_802_814_835_835_1061_1067_1074_1293_,2037_2067_2069_2070_2171_2206_2231_2276_2287_2288_2309_2338_2342_2342_2360_2361_2372_2372_2375_2375_2385_2398_2411_2436_2436_2505_2517_2519_2528_2553_2595_2604_2608_2608_2639_2671_2695_2700_2701_2738_2742_2742_2748_2748_2753_2754_2756_2769_2769_2770_2770_2803_2815_2824_2826_2828_2828_2828_2828_2838_2846_2861_2861_2861_2862_2862_2862_2908_2914_2917_3020_3034_3040_3040_3055_3073_3085_3095_3103_3117_3118_3175_3175_3176_3176_3185_3185_3185_3185_3194_3206_3214_3219_3231_3231_3232_3237_3244_3245_3255_3256_3304_3319_3347_3385_3418_3433_3435_3452_3457_3477_3478_
173,1,困擾,N,1,0,1,,
173,3,她,N,29,134,163,173_242_242_242_242_252_252_252_252_320_320_321_445_453_482_491_521_530_546_546_555_555_649_655_794_794_797_797_,2015_2015_2038_2040_2081_2081_2081_2081_2081_2081_2081_2081_2081_2083_2083_2083_2083_2083_2083_2083_2083_2083_2090_2127_2175_2273_2287_2287_2287_2287_2288_2288_2288_2288_2309_2309_2314_2314_2317_2317_2354_2355_2360_2361_2372_2375_2391_2392_2392_2392_2416_2416_2460_2461_2483_2483_2529_2572_2572_2572_2608_2608_2608_2609_2609_2609_2609_2611_2649_2671_2746_2828_2828_2828_2835_2958_3076_3083_3119_3124_3150_3150_3150_3152_3243_3243_3243_3243_3243_3255_3256_3279_3281_3281_3313_3331_3418_3433_3433_3433_3433_3433_3433_3433_3433_3433_3433_3433_3433_3433_3435_3435_3435_3435_3435_3435_3435_3435_3435_3435_3435_3435_3435_3448_3448_3448_3448_3453_3453_3453_3453_3466_3471_
173,3,難,Vi,9,30,39,481_700_711_721_778_788_870_878_,2050_2053_2053_2058_2116_2119_2153_2211_2322_2444_2493_2598_2630_2717_2720_2828_2847_2863_3030_3103_3334_3360_3365_3376_3378_3434_3436_3458_3470_
173,3,電話費,N,4,2,6,740_1168_1175_,2097_
173,3,吵鬧,Vi,3,14,17,277_966_,2141_2159_2526_2575_2588_2611_2898_3012_3284_3285_3375_3377_3486_
173,3,有時,ADV,8,8,16,379_507_813_813_1005_1150_1157_,2170_2170_2584_2607_3038_3039_3098_
174,3,大大,Vi,7,3,10,242_252_788_902_915_1385_,2135_3098_
174,3,彌補,Vt,4,3,7,889_897_1057_,2299_2302_
174,3,之後,N,4,8,12,174_434_1019_,2289_2425_2428_2609_2609_2775_3174_
174,3,家庭,N,6,10,16,672_707_717_1292_1409_,2703_2731_2731_2731_2731_2815_2881_3274_3275_
174,3,虹口,N,8,1,9,175_175_175_175_176_176_176_,
174,3,愉快,Vi,15,21,36,226_437_439_442_460_611_612_620_621_629_716_726_1451_1497_,2305_2308_2372_2375_2445_2446_2450_2453_2475_2609_2672_2731_2857_2858_2862_3146_3163_3281_3283_3483_
174,1,物超所值,Vi,8,0,8,307_311_923_931_1115_1150_1157_,
174,3,發生,Vt,5,38,43,632_779_779_1337_,2195_2195_2209_2210_2225_2225_2226_2226_2391_2445_2446_2549_2550_2595_2609_2651_2654_2680_2761_2762_2775_2798_2800_2862_2924_3001_3139_3146_3150_3150_3226_3319_3331_3433_3435_3448_3453_
175,3,面海,Vi,2,1,3,175_,
175,1,直面,N,3,0,3,183_193_,
175,1,美中不足,Vi,13,0,13,227_247_257_408_834_1022_1070_1077_1091_1232_1303_1306_,
175,1,紅虹,N,1,0,1,,
175,3,大海,N,17,2,19,183_193_242_242_252_252_350_360_373_374_376_376_713_723_1088_1090_,3132_
175,3,綜合,A,6,5,11,924_932_1356_1361_1399_,2102_2779_2848_3487_
175,3,煙台,N,1,2,3,,3205_
175,3,證明,Vt,2,6,8,1054_,2354_2355_2836_2861_3397_
175,1,口大,N,1,0,1,,
175,1,竹炭,N,1,0,1,,
176,1,落差,N,3,0,3,176_802_,
176,3,年輕人,N,2,2,4,405_,2883_
176,3,常,ADV,7,8,15,835_907_1135_1201_1477_1484_,2606_2629_2750_2781_3327_3327_3341_
176,3,雞,N,1,1,2,,
176,1,居家,N,1,0,1,,
176,3,緊鄰,Vt,3,2,5,924_932_,2575_
176,3,外觀,N,5,17,22,409_762_1384_1384_,2205_2213_2283_2285_2426_2454_2455_2571_2576_2805_2909_2910_2953_3071_3223_3458_
176,1,煙台人,N,1,0,1,,
176,3,爽,Vi,15,29,44,213_286_289_379_788_817_871_876_879_884_990_993_1316_1321_,2108_2161_2299_2299_2302_2302_2333_2334_2522_2549_2550_2609_2754_3079_3083_3083_3119_3119_3124_3124_3149_3400_3401_3433_3433_3435_3435_3471_
176,3,可憐,Vt,5,24,29,847_990_993_1425_,2102_2123_2338_2434_2718_2718_2718_2721_2721_2721_2907_2969_2997_2999_3029_3074_3237_3360_3422_3423_3424_3460_3478_
176,1,大酒點,N,1,0,1,,
176,1,臥房,N,1,0,1,,
176,3,濱海,Vi,1,1,2,,
176,3,對比,N,4,3,7,320_887_895_,3423_3424_
177,1,中取境,N,1,0,1,,
177,1,皮夾,N,1,0,1,,
177,1,來電,Vi,1,0,1,,
177,3,鬧,Vt,7,18,25,247_257_275_278_335_1346_,2208_2299_2299_2302_2302_2680_2740_2776_2996_3052_3053_3163_3319_3369_3370_3376_3378_
177,3,離開,Vt,15,38,53,373_497_520_529_670_858_867_915_1203_1232_1266_1266_1362_1369_,2008_2225_2226_2232_2272_2326_2388_2464_2466_2549_2550_2671_2671_2806_2816_2818_2845_2944_2956_2957_2960_2962_2967_2976_2987_3083_3083_3110_3132_3253_3253_3253_3289_3290_3341_3458_3458_
177,1,完璧,N,1,0,1,,
177,3,小心,Vt,5,15,20,227_701_701_949_,2070_2195_2492_2608_2680_2680_2846_2867_2972_2972_3111_3296_3391_3393_
177,3,歸,Vi,5,3,8,217_1481_1488_1495_,2005_2269_
177,3,照,Vt,2,2,4,276_,3246_
178,3,員工,N,41,46,87,187_188_197_225_321_429_525_534_628_632_707_707_709_710_711_711_714_714_717_717_719_720_721_721_724_724_771_775_801_924_932_974_1061_1098_1129_1136_1169_1176_1436_1495_,2037_2225_2226_2258_2258_2259_2259_2322_2359_2359_2359_2447_2475_2534_2572_2572_2572_2608_2608_2609_2609_2609_2609_2671_2671_2731_2731_2737_2746_2746_2761_2762_2779_3055_3146_3163_3227_3227_3231_3246_3281_3319_3319_3448_3453_
178,3,盡可能,ADV,2,2,4,188_,2226_
179,1,樓頂層,N,2,0,2,189_,
179,3,威海,N,24,3,27,183_185_186_186_187_189_193_195_196_196_197_336_338_338_347_347_357_357_364_369_373_374_377_,3205_3385_
179,3,自駕游,Vi,3,4,7,189_1254_,3185_3423_3424_
180,3,燒烤,Vt,7,6,13,190_341_341_1091_1147_1345_,2946_2965_2966_3197_3199_
180,3,水平,N,34,50,84,181_190_191_217_240_250_335_447_455_501_502_526_535_617_626_662_689_694_699_707_717_842_1021_1140_1153_1160_1194_1204_1213_1215_1309_1313_1437_,2027_2028_2036_2037_2048_2153_2177_2328_2330_2346_2351_2363_2537_2538_2544_2552_2572_2585_2609_2647_2659_2679_2718_2721_2740_2798_2800_2847_2861_2864_2869_2938_2938_2951_2958_2959_2959_3015_3019_3042_3073_3074_3085_3110_3162_3191_3400_3423_3424_
181,3,延,Vt,3,5,8,191_431_,3291_3291_3292_3292_
181,1,住標,N,2,0,2,191_,
182,3,如下,Vt,3,13,16,192_502_,2671_2813_3038_3039_3146_3146_3160_3187_3189_3341_3389_3390_
182,3,大廳,N,19,21,40,192_211_211_287_334_336_439_464_628_629_630_795_798_1244_1248_1430_1450_1450_,2008_2167_2565_2565_2565_2594_3012_3013_3020_3083_3085_3184_3249_3254_3329_3345_3392_3394_3397_3427_
182,1,見面,Vi,2,0,2,192_,
182,3,問好,Vi,7,1,8,192_409_1020_1091_1207_1430_,
182,3,見到,Vt,19,11,30,187_192_197_409_521_530_707_707_714_717_717_724_1033_1088_1098_1167_1174_1239_,2287_2288_2522_2717_2718_2720_2721_3076_3319_3487_
182,3,院子,N,5,1,6,192_1194_1442_1447_,
182,3,海景,N,95,10,105,186_186_192_196_196_239_241_244_245_245_249_251_253_254_255_255_341_341_364_369_374_669_670_674_674_674_710_710_710_710_710_710_710_710_710_710_710_710_711_714_714_715_720_720_720_720_720_720_720_720_720_720_720_720_721_724_724_725_771_775_784_785_802_803_804_804_809_835_839_853_855_856_862_864_865_872_872_880_880_885_885_886_889_891_893_893_894_897_899_917_1085_1089_1091_1425_,2045_2162_2648_2861_3052_3053_3110_3433_3435_
182,3,似乎,ADV,13,6,19,186_192_196_260_262_281_699_1088_1095_1097_1384_1423_,2392_2611_2642_2646_2747_
182,3,標誌,N,5,7,12,192_342_352_847_,2149_2267_3024_3026_3129_3130_
182,3,19日,N,6,7,13,192_242_252_1114_1218_,2368_2369_2530_3038_3039_3296_
182,3,崗位,N,2,2,4,192_,2609_
183,1,高爾夫,N,5,0,5,193_266_268_1232_,
183,3,康樂,A,2,2,4,193_,2746_
183,3,配套,Vi,5,9,14,193_230_985_1058_,2227_2332_2571_2817_2819_3115_3135_3246_
183,1,較少,Vi,2,0,2,193_,
183,1,中意,Vt,4,0,4,193_770_774_,
183,3,保齡球,N,2,4,6,193_,2761_2762_2762_
183,1,練習場,N,2,0,2,193_,
183,3,果然,ADV,9,5,14,193_381_384_711_714_721_724_783_,3038_3039_3056_3397_
183,3,稱,Vt,4,4,8,193_795_798_,2363_3146_3364_
184,3,供,Vt,5,11,16,194_439_1070_1077_,2322_2579_2579_2589_2813_2815_2968_3231_3298_3301_
184,3,點到,Vt,3,4,7,194_1383_,2625_3291_3292_
184,3,並未,ADV,3,3,6,194_632_,2083_2846_
184,3,開車,Vi,9,22,31,194_283_341_350_360_388_1053_1232_,2334_2360_2360_2361_2361_2424_2579_2604_2793_2923_3038_3039_3065_3067_3133_3376_3378_3405_3405_3410_3410_
184,3,訂房,Vi,18,31,49,194_276_408_434_434_434_630_885_893_1057_1127_1134_1169_1176_1195_1198_1266_,2008_2070_2161_2190_2215_2388_2426_2517_2519_2615_2621_2669_2714_2846_2861_2908_3032_3033_3038_3039_3074_3110_3227_3254_3315_3413_3423_3424_3489_3491_
184,1,樓辦,N,2,0,2,194_,
184,3,分別,ADV,6,3,9,194_546_555_1232_1423_,2974_3246_
185,3,齊全,Vi,32,7,39,187_195_197_223_230_286_351_361_374_554_563_588_607_639_681_682_710_720_817_841_842_907_914_923_931_1005_1220_1222_1332_1359_1364_,2568_2974_3214_3219_3345_3371_
185,3,收取,Vt,2,7,9,195_,2417_2486_2882_2981_2982_3260_
185,3,口味,N,10,2,12,195_407_520_529_674_677_681_682_982_,3333_
185,3,司機,N,22,37,59,195_394_707_707_709_710_717_717_719_720_793_796_838_842_842_857_866_888_896_1020_1367_,2099_2104_2104_2167_2231_2231_2231_2492_2493_2587_2604_2604_2604_2604_2700_2701_2740_2772_2795_2848_2889_2890_2933_3022_3023_3059_3089_3100_3182_3183_3196_3196_3254_3319_3319_3319_
185,3,餐飲,N,26,17,43,195_246_253_256_335_546_546_546_555_555_555_662_795_798_1081_1114_1127_1134_1149_1156_1167_1174_1473_1489_1492_,2055_2177_2178_2322_2651_2654_2742_2768_2798_2800_2901_2976_2990_2992_3132_3345_
185,3,滿足,Vt,9,6,15,186_195_196_854_863_1020_1169_1176_,2305_2308_2759_3024_3026_
186,3,聽到,Vt,10,27,37,196_239_249_279_660_707_717_1112_1120_,2272_2304_2305_2307_2308_2391_2489_2759_2772_2791_2791_2824_2826_2862_2875_2912_2978_3040_3153_3224_3341_3341_3418_3443_3476_3493_
186,3,盡力,Vi,4,1,5,196_1359_1364_,
186,1,啟明,N,2,0,2,196_,
186,3,隨便,Vi,6,13,19,196_730_813_841_1371_,2126_2388_2537_2538_2824_2826_2945_3019_3117_3139_3333_3347_
186,3,巧克力,N,9,1,10,196_794_797_799_803_804_813_813_,
186,3,躺,Vi,7,6,13,196_228_851_860_961_1473_,2718_2721_2816_2818_2933_
186,1,漏下,Vi,2,0,2,196_,
186,1,冰過,N,2,0,2,196_,
186,3,留言,N,4,4,8,196_436_982_,2340_2341_2932_
186,3,環保,N,2,7,9,196_,2319_2759_2759_2759_2759_2759_
186,3,浪費,Vt,7,11,18,196_546_555_786_1124_1131_,2777_2857_2858_2945_3213_3218_3316_3458_3480_3482_
186,3,出來,Vi,26,38,64,196_341_348_391_443_550_551_559_560_669_669_738_842_902_902_979_1072_1073_1079_1080_1082_1278_1279_1285_1286_,2037_2161_2161_2162_2162_2162_2179_2343_2372_2375_2384_2483_2483_2521_2541_2544_2549_2550_2746_2746_2794_2863_2928_2958_2973_3038_3039_3103_3103_3246_3254_3289_3290_3319_3321_3322_3379_
186,3,小聲,Vi,3,1,4,196_779_,
186,3,有誤,Vi,2,1,3,196_,
186,1,嬰兒椅,N,2,0,2,196_,
186,3,拿來,Vt,9,6,15,196_710_714_714_720_724_724_1045_,2531_3146_3180_3255_3256_
186,1,櫻桃,N,2,0,2,196_,
186,3,優質,A,11,9,20,196_242_252_438_568_577_628_1030_1309_1313_,2359_2672_2746_2761_2762_3345_3345_3371_
186,1,破壞,Vt,2,0,2,196_,
186,3,勺子,N,2,1,3,196_,
186,3,中式,A,13,3,16,196_279_327_332_334_676_982_1037_1338_1359_1364_1437_,3246_3253_
186,3,漏水,Vi,8,11,19,196_374_771_775_995_996_1409_,2267_2273_2421_2540_2647_2707_2708_2743_2873_3288_
186,1,不愧,ADV,4,0,4,196_841_1257_,
186,3,後,N,7,18,25,196_246_256_611_620_1423_,2081_2083_2083_2232_2450_2453_2530_2606_2606_2616_2631_2746_2888_2932_2971_3386_3386_
186,3,成本,N,4,1,5,196_783_1091_,
186,1,試試看,Vt,6,0,6,196_242_252_520_529_,
186,1,蛋撻,Vt,4,0,4,186_196_196_,
186,3,賓客,N,18,26,44,196_316_982_1028_1028_1029_1029_1030_1030_1031_1061_1170_1177_1309_1309_1313_1313_,2089_2177_2177_2258_2259_2359_2359_2590_2671_2737_2759_2759_2857_2858_3024_3026_3049_3448_3448_3448_3448_3453_3453_3453_3453_
186,1,朝鮮式,N,2,0,2,196_,
186,1,布丁,N,2,0,2,196_,
186,1,提前為,Vt,2,0,2,196_,
186,1,閥,N,2,0,2,196_,
186,3,寶寶,N,26,1,27,186_196_196_710_710_710_710_710_710_710_710_710_710_710_720_720_720_720_720_720_720_720_720_720_720_,
186,1,奶油,N,2,0,2,196_,
186,3,曾,ADV,3,3,6,196_768_,2725_3286_
186,1,待人接物,Vi,2,0,2,196_,
186,1,嚴實,Vi,2,0,2,196_,
186,3,拿,Vt,25,84,109,196_229_290_320_551_554_560_563_635_637_674_675_842_842_889_897_1106_1106_1112_1120_1319_1324_1423_1472_,2126_2126_2126_2127_2148_2162_2162_2186_2206_2220_2222_2225_2226_2232_2232_2249_2251_2388_2411_2419_2587_2587_2594_2594_2609_2615_2651_2654_2680_2746_2746_2756_2769_2770_2796_2809_2861_2862_2869_2958_2988_3038_3039_3049_3052_3053_3083_3105_3105_3133_3139_3184_3184_3186_3188_3204_3213_3218_3231_3233_3268_3274_3288_3289_3289_3290_3290_3298_3301_3376_3378_3397_3425_3433_3433_3435_3435_3458_3471_3475_3487_3495_3497_
186,3,藍天,N,6,3,9,187_187_196_197_197_,2883_2883_
186,3,抱,Vt,8,1,9,196_242_252_281_520_529_751_,
186,1,柿子,N,2,0,2,196_,
186,3,短信,N,4,3,7,196_1020_1062_,2361_2671_
186,3,怕,Vt,6,15,21,196_710_720_1443_1448_,2009_2047_2136_2140_2215_2516_2518_2530_2794_2908_3147_3180_3210_3215_
186,3,日式,A,4,4,8,196_1105_1342_,3245_3246_3246_
186,3,漏,Vi,8,5,13,196_568_568_577_577_738_1409_,2815_2815_3019_3466_
186,3,澡,N,9,20,29,196_630_631_788_872_875_880_883_,2233_2235_2236_2579_2781_2898_2946_2988_3016_3047_3051_3062_3103_3266_3352_3354_3389_3390_3396_
186,1,羊城,N,2,0,2,196_,
186,1,為為,Vi,2,0,2,196_,
186,3,假日,N,2,16,18,196_,2266_2564_2626_2684_2687_2861_2861_2917_2932_3163_3163_3347_3443_3443_3443_
186,3,網友,N,14,10,24,196_641_662_713_723_871_879_901_978_1057_1091_1211_1352_,2190_2231_2908_3206_3413_3431_3432_3448_3453_
186,3,當時,N,14,62,76,186_196_196_665_772_776_870_872_878_880_966_1025_1495_,2081_2083_2083_2134_2252_2252_2253_2253_2273_2273_2287_2287_2288_2288_2359_2372_2375_2387_2412_2454_2455_2572_2616_2616_2637_2637_2638_2638_2642_2646_2690_2703_2718_2721_2733_2740_2746_2754_2767_2815_2861_2942_2968_3049_3049_3049_3158_3163_3227_3288_3308_3341_3341_3360_3371_3388_3388_3421_3431_3432_3454_
186,1,桃子,N,2,0,2,196_,
186,1,晚報,N,4,0,4,186_196_196_,
186,3,驚訝,Vt,5,2,7,196_316_710_720_,2226_
186,3,想法,N,5,2,7,196_520_529_1348_,3246_
186,3,出去,Vi,17,36,53,196_350_360_551_560_607_780_799_799_872_880_886_894_1239_1428_1472_,2232_2269_2326_2483_2517_2519_2547_2595_2604_2640_2769_2770_2802_2816_2816_2818_2818_2824_2826_2873_2925_2926_2975_3008_3040_3049_3083_3083_3281_3319_3347_3433_3435_3477_3487_
186,3,放心,Vt,4,6,10,196_639_1061_,2917_2928_3144_3448_3453_
186,3,廣州,N,6,14,20,196_421_1106_1124_1131_,2266_2426_2426_2718_2721_2731_2731_2775_3154_3155_3347_3418_3471_
186,3,發,Vt,4,20,24,196_239_249_,2208_2229_2380_2521_2637_2638_2690_3032_3033_3281_3281_3281_3289_3290_3296_3375_3377_3458_3458_
186,3,當,Vt,2,4,6,196_,2853_3103_3327_
186,3,11日,N,9,17,26,186_196_196_213_412_977_1029_1203_,2097_2104_2258_2259_2345_2350_2473_2702_2854_2945_3253_3253_3274_3433_3435_3458_
186,3,呵呵,ADV,42,13,55,186_196_196_214_227_232_280_348_373_396_450_458_462_499_521_530_670_828_1047_1054_1057_1067_1074_1095_1114_1114_1124_1124_1131_1131_1163_1165_1169_1176_1378_1378_1479_1479_1486_1486_1496_,2037_2290_2499_2523_2861_2861_2934_2997_3158_3391_3393_3487_
186,3,不過,ADV,8,7,15,186_196_196_342_352_842_970_,2041_2042_2700_2701_3194_3333_
186,1,小漏,N,2,0,2,196_,
186,3,需求,N,7,6,13,196_242_252_592_601_1029_,2759_2759_3024_3026_3345_
186,3,粥,N,13,8,21,196_522_531_546_555_639_710_710_720_720_910_913_,2597_2740_2784_3360_3360_3360_3458_
186,3,嘩嘩,ADV,2,1,3,196_,
186,3,放水,Vi,3,4,7,196_253_,2391_2946_2946_
186,1,嬰兒,N,2,0,2,196_,
187,1,合,Vt,4,0,4,197_346_356_,
187,1,面帶微笑,Vi,5,0,5,197_242_252_910_,
198,1,比星湖大,N,1,0,1,,
198,1,肇慶,N,5,0,5,198_768_769_769_,
198,3,起碼,A,6,9,15,904_1242_1246_1326_1421_,2290_2359_2498_2573_2596_2597_2883_2892_
198,3,搞,Vt,13,33,46,449_457_517_521_530_802_1057_1060_1199_1227_1229_1332_,2196_2269_2312_2315_2318_2319_2527_2527_2532_2532_2533_2533_2540_2587_2639_2715_2716_2744_2851_2851_2862_2864_2968_3141_3202_3223_3240_3282_3330_3448_3453_3472_
198,1,皇潮,N,1,0,1,,
201,1,酒氣,N,2,0,2,207_,
201,3,隨處,ADV,2,2,4,207_,3159_
201,3,可見,ADV,5,7,12,207_1020_1020_1100_,2714_2714_2976_3159_3159_3246_
201,3,污漬,N,2,13,15,207_,2124_2505_2584_2584_2651_2654_3111_3170_3172_3223_3242_3417_
201,1,頗,ADV,4,0,4,207_526_535_,
201,3,髒,Vi,13,115,128,207_374_382_385_947_985_1059_1217_1227_1229_1270_1273_,2059_2108_2108_2114_2117_2128_2130_2132_2137_2139_2141_2143_2144_2144_2145_2145_2161_2211_2219_2221_2241_2247_2271_2312_2315_2318_2319_2344_2349_2378_2380_2388_2388_2394_2450_2453_2464_2466_2480_2517_2519_2541_2543_2549_2550_2558_2573_2573_2573_2649_2649_2714_2740_2748_2753_2760_2854_2872_2883_2883_2896_2908_2912_2945_2967_2971_2975_2979_2986_2995_3060_3061_3076_3104_3112_3123_3152_3168_3169_3177_3195_3201_3206_3211_3211_3216_3216_3231_3231_3242_3246_3266_3289_3290_3293_3318_3319_3358_3358_3386_3391_3393_3409_3417_3433_3435_3450_3451_3452_3455_3456_3457_3466_3477_
201,1,遙,Vi,2,0,2,207_,
201,3,當地,N,18,42,60,207_275_276_394_465_466_913_962_1129_1136_1359_1364_1371_1371_1423_1481_1488_,2054_2103_2131_2131_2133_2133_2195_2266_2400_2402_2517_2519_2565_2565_2742_2750_2795_2816_2818_2824_2826_2861_2881_2881_2945_2959_2959_2964_3032_3033_3074_3132_3132_3136_3320_3385_3385_3463_3463_3489_3491_
201,3,揮之不去,Vi,2,1,3,207_,
201,1,大而無當,Vi,2,0,2,207_,
201,3,商務房,N,10,4,14,207_298_306_1054_1172_1179_1220_1222_1238_,2324_2675_2677_
201,3,華陽,N,4,2,6,201_207_207_,3263_
201,3,考察,Vt,2,9,11,207_,2252_2253_2651_2654_2949_3107_3345_3379_
203,3,套間,N,5,6,11,203_209_209_1201_,2517_2519_3104_3149_3239_
203,3,大房,N,5,1,6,209_554_563_1114_,
203,3,單人,N,16,12,28,209_540_540_546_550_555_559_687_692_924_932_990_993_1294_1298_,2112_2508_2549_2550_2585_2709_2711_2775_2804_3417_3466_
203,3,退,Vi,3,19,22,209_628_,2047_2081_2081_2083_2083_2231_2272_2363_2364_2405_2407_2527_2639_2742_2863_2923_2934_3115_
203,3,湊合,Vt,4,8,12,209_1163_1165_,2525_3191_3289_3290_3319_3488_3490_
204,1,洛陽,N,4,0,4,210_1455_1455_,
204,3,說不過去,Vi,2,3,5,210_,2550_2869_
204,1,石窟,N,3,0,3,210_1454_,
204,1,龍門,N,3,0,3,210_1454_,
211,3,他們,N,79,218,297,227_238_246_256_281_291_299_320_320_320_337_434_434_460_460_481_494_508_644_707_711_711_714_714_715_717_721_721_724_724_725_745_745_771_773_775_777_802_835_835_835_875_883_902_944_944_962_1020_1025_1025_1054_1062_1106_1112_1120_1169_1176_1211_1211_1250_1254_1319_1324_1340_1371_1412_1417_1419_1419_1430_1451_1451_1451_1472_1472_1472_1495_1497_,2030_2031_2039_2041_2071_2084_2085_2126_2134_2134_2134_2134_2135_2155_2206_2229_2231_2231_2231_2231_2231_2231_2244_2245_2252_2253_2264_2271_2271_2276_2276_2287_2288_2354_2355_2376_2400_2400_2402_2402_2416_2452_2497_2497_2517_2517_2519_2519_2534_2534_2549_2550_2595_2595_2616_2616_2621_2637_2637_2637_2637_2638_2638_2638_2638_2642_2646_2650_2653_2703_2710_2710_2710_2712_2712_2712_2724_2731_2731_2731_2731_2746_2746_2773_2798_2800_2803_2803_2824_2824_2824_2824_2826_2826_2826_2826_2842_2842_2843_2843_2846_2846_2846_2846_2846_2846_2862_2862_2862_2867_2889_2890_2902_2904_2914_2933_2945_2946_2956_2957_2964_2968_2973_2993_2994_3040_3043_3049_3052_3053_3074_3079_3083_3099_3103_3142_3170_3172_3184_3184_3184_3185_3185_3194_3194_3196_3205_3213_3218_3225_3225_3226_3226_3227_3232_3242_3243_3245_3246_3246_3246_3247_3253_3254_3254_3254_3255_3256_3274_3289_3289_3290_3290_3295_3296_3306_3316_3319_3323_3327_3329_3331_3337_3342_3361_3362_3383_3384_3409_3409_3409_3421_3433_3433_3433_3433_3433_3433_3433_3435_3435_3435_3435_3435_3435_3435_3445_3458_3458_3458_3478_3478_3487_3487_3487_3488_3490_
211,3,本來,ADV,23,74,97,224_229_321_391_423_431_546_555_701_703_705_876_884_888_896_1082_1259_1319_1324_1421_1477_1484_,2058_2061_2134_2162_2231_2233_2247_2247_2269_2273_2380_2383_2394_2406_2408_2458_2517_2519_2531_2531_2543_2557_2601_2601_2604_2639_2671_2703_2769_2770_2809_2815_2853_2861_2864_2882_2909_2910_2923_2945_2960_2962_2986_3065_3067_3078_3086_3099_3174_3184_3231_3253_3253_3255_3256_3324_3324_3329_3334_3383_3384_3418_3418_3418_3431_3432_3433_3434_3435_3436_3451_3456_3458_
211,3,來不及,Vi,1,3,4,,3007_3459_
212,1,點名,Vi,3,0,3,593_602_,
212,3,周全,Vi,1,1,2,,
213,3,市話,N,3,5,8,1336_1336_,3434_3434_3436_3436_
213,3,最多,ADV,4,19,23,502_912_1472_,2424_2473_2541_2572_2625_2700_2701_2780_2917_2959_3020_3047_3051_3052_3053_3276_3347_3460_
213,3,遇見,Vt,1,4,5,,2852_3105_3267_
213,3,交,Vt,6,24,30,298_306_830_923_931_,2083_2134_2139_2143_2232_2360_2361_2498_2515_2787_2789_2846_2853_2964_3038_3039_3049_3213_3218_3233_3289_3290_3438_
213,3,牌子,N,3,13,16,710_720_,2426_2723_2764_2922_2922_2922_3008_3025_3027_3103_3194_3196_
213,1,礙眼,Vi,1,0,1,,
213,3,領導,N,3,12,15,213_1239_,2608_2609_2680_2857_2858_2999_3049_3146_3184_3231_3360_
213,3,誇張,Vt,3,9,12,636_638_,2371_2374_2374_2576_2715_2716_3363_3418_
213,3,押金,N,14,14,28,298_298_306_306_713_723_912_923_931_1319_1319_1324_1324_,2083_2134_2134_2139_2143_2229_2515_2714_2757_2758_2853_2914_3083_
213,3,不斷,ADV,11,16,27,225_435_515_515_517_1031_1031_1032_1309_1313_,2305_2308_2421_2522_2671_2753_2759_2857_2858_2946_3103_3231_3253_3341_3349_
213,1,裡頭,N,1,0,1,,
213,3,市內,N,3,3,6,269_660_,3099_3163_
213,3,一律,ADV,2,2,4,670_,3073_
213,3,撤,Vt,1,4,5,,2386_2707_2708_
213,3,方,ADV,2,14,16,1367_,2037_2037_2229_2244_2245_2603_2605_2771_3098_3231_3253_3253_3296_
213,3,開通,Vi,3,9,12,213_749_,2097_2738_3170_3170_3172_3172_3434_3436_
213,3,現象,N,3,4,7,374_640_,3074_3433_3435_
213,1,個案,N,1,0,1,,
213,3,比,Vt,10,9,19,231_439_447_455_762_820_935_1211_1473_,2053_2161_2607_2744_2815_2907_3151_3345_
213,3,乾脆,Vi,3,5,8,238_1084_,2281_2282_2457_2740_
213,3,反映,Vt,15,29,44,220_520_529_630_662_684_901_1212_1319_1324_1412_1417_1450_1451_,2035_2036_2055_2106_2225_2226_2258_2259_2391_2445_2446_2510_2511_2517_2519_2587_2608_2609_2621_2703_2798_2800_2862_2946_2946_3280_3281_3414_
213,3,23日,N,4,11,15,443_821_1082_,2083_2261_2263_2283_2450_2453_2609_2609_3423_3424_
213,3,做出,Vt,5,5,10,213_316_1031_1032_,2108_2190_2702_2771_
213,1,批示,Vt,1,0,1,,
213,3,整改,Vt,5,7,12,217_1030_1319_1324_,2005_2445_2446_3049_3431_3432_
213,3,破舊,Vi,2,16,18,1450_,2145_2477_2512_2532_2533_2610_2616_2790_2996_2997_3077_3083_3103_3168_3169_
214,3,牛奶,N,9,6,15,522_531_714_724_1054_1054_1054_1367_,2040_2607_2740_2784_2864_
214,3,鮮花,N,5,2,7,294_302_669_1419_,2383_
214,3,擺放,Vt,3,1,4,294_302_,
214,3,心情,N,10,24,34,434_442_443_802_1090_1211_1343_1471_1497_,2005_2232_2233_2309_2376_2539_2746_2750_2881_2923_2924_2967_3083_3083_3115_3132_3246_3274_3283_3331_3418_3488_3490_
214,1,阿拉,N,1,0,1,,
214,3,體現,Vt,5,2,7,391_434_707_717_,3432_
215,3,網絡,N,22,28,50,215_348_434_434_494_504_629_629_737_749_794_797_972_1036_1202_1237_1309_1309_1313_1313_1450_,2098_2109_2346_2351_2380_2651_2654_2765_2840_2895_2960_2960_2960_2962_2962_2962_3146_3146_3158_3170_3170_3172_3172_3187_3189_3324_3386_
215,3,昆明,N,4,6,10,216_217_1348_,2231_2231_2231_2231_3475_
215,1,經貿,N,2,0,2,216_,
215,3,住下,Vi,2,5,7,1020_,3049_3049_3195_3397_
215,3,下班,Vi,5,7,12,340_958_1272_1275_,2359_2359_2360_2361_3103_3185_
215,3,機,N,1,6,7,,2461_2528_3031_3076_3098_
216,3,雲南,N,1,2,3,,3074_
216,3,豪華房,N,6,18,24,771_775_1309_1313_1472_,2261_2263_2376_2463_2465_2523_2606_2731_2731_2748_2872_3340_3360_3433_3434_3435_3436_
216,3,接機,Vi,14,6,20,631_707_710_710_717_720_720_1082_1083_1201_1208_1211_1343_,2528_2725_2754_2754_3272_
216,1,樂心,N,1,0,1,,
217,3,竭誠,ADV,1,3,4,,2406_2408_
217,3,新裝,N,2,3,5,914_,3383_3384_
217,3,下榻,Vt,4,1,5,517_828_982_,
217,1,設法,Vt,1,0,1,,
217,1,改過來,Vi,1,0,1,,
217,3,支持,Vt,6,8,14,427_875_883_1172_1179_,2526_2623_2759_2824_2826_3072_3083_
217,3,15日,N,4,7,11,628_1208_1451_,2288_2630_2842_2843_3296_3308_
217,1,改水單,N,1,0,1,,
217,3,票,N,3,4,7,921_1062_,3038_3039_3246_
218,1,腰,N,1,0,1,,
218,1,席夢絲,N,1,0,1,,
218,3,海寧,N,1,1,2,,
218,1,酸酸,Vi,1,0,1,,
218,1,塌塌米型,N,1,0,1,,
218,3,可惜,Vi,27,19,46,276_282_283_324_350_360_471_475_566_575_628_630_703_705_732_844_888_896_921_1066_1088_1091_1096_1097_1106_1348_,2225_2226_2232_2309_2344_2349_2370_2373_2412_2434_2761_2762_2780_2787_2789_2822_3205_3426_
219,3,夫妻,N,1,2,3,,2731_
219,3,配有,Vt,8,2,10,540_540_541_550_559_1309_1313_,3296_
219,1,電腦台,N,1,0,1,,
219,3,電腦房,N,1,1,2,,
219,3,連,ADV,4,23,27,1088_1359_1364_,2270_2426_2426_2454_2455_2512_2528_2571_2616_2631_2707_2708_2753_2771_2775_2874_3007_3289_3290_3365_3448_3453_
219,3,情侶,N,2,1,3,738_,
219,1,路段,N,1,0,1,,
219,3,透明,Vi,1,4,5,,3353_3355_3357_
220,3,騷擾,Vt,1,5,6,,2281_2282_3247_3308_
220,3,常常,ADV,1,1,2,,
222,3,參加,Vt,1,3,4,,2253_2543_
222,3,價錢,N,27,23,50,422_430_791_817_835_887_887_889_895_895_897_903_907_935_935_948_1057_1089_1105_1107_1303_1306_1334_1348_1431_1436_,2040_2131_2133_2162_2175_2264_2647_2647_2648_2718_2721_2846_3025_3027_3047_3051_3054_3082_3116_3287_3344_3466_
222,1,展覽會,N,1,0,1,,
222,3,素質,N,10,21,31,246_256_628_842_928_936_989_992_1061_,2140_2174_2174_2229_2273_2273_2383_2475_2604_2867_2879_2880_2895_2954_3011_3115_3163_3179_3227_3335_
222,3,承認,Vt,1,7,8,,2083_2104_2616_2616_3165_3294_
222,3,死,Vi,1,21,22,,2031_2103_2769_2770_2956_2957_2976_2999_3034_3049_3112_3144_3190_3289_3290_3293_3307_3421_3434_3436_
222,1,偏低,Vi,1,0,1,,
223,3,覺,N,1,9,10,,2159_2650_2653_2699_2742_3040_3223_3467_
223,3,熱水器,N,2,7,9,628_,2435_3073_3084_3187_3189_3386_
223,3,屬,Vt,4,5,9,707_717_1215_,2561_2562_3118_3443_
223,3,標間,N,2,9,11,842_,2344_2349_2483_2483_2483_2483_2742_3245_
223,3,軟硬,Vi,1,1,2,,
224,1,藏獨,N,1,0,1,,
224,1,索菲特,N,8,0,8,224_230_476_482_485_491_1115_,
224,3,事件,N,1,13,14,,2428_2494_2495_2609_2616_2616_2761_2761_2762_2762_3001_3146_
225,3,見,Vt,7,66,73,320_872_880_980_1205_1430_,2086_2139_2143_2206_2229_2232_2232_2239_2297_2300_2313_2316_2391_2392_2411_2414_2416_2445_2446_2450_2450_2452_2453_2453_2480_2486_2523_2525_2526_2573_2587_2592_2651_2651_2654_2654_2705_2706_2731_2757_2758_2863_2873_2879_2880_2924_2946_3071_3076_3083_3140_3204_3260_3306_3306_3308_3341_3425_3433_3434_3435_3436_3443_3459_3471_
225,3,認為,Vt,9,19,28,228_450_458_812_1108_1116_1203_1500_,2202_2367_2400_2402_2473_2494_2495_2535_2621_2718_2721_2816_2818_2946_3001_3083_3255_3256_
225,1,足可,ADV,1,0,1,,
225,3,完善,Vi,4,4,8,420_435_783_,2308_2671_3055_
225,1,實力,N,1,0,1,,
225,3,集團,N,1,10,11,,2231_2231_2305_2308_2613_2680_2834_3345_3345_
225,1,雄厚,Vi,1,0,1,,
225,3,機關,N,1,3,4,,2483_3007_
226,3,會展,N,5,3,8,227_227_808_921_,3405_3410_
226,3,文件,N,1,3,4,,3010_3281_
226,3,難題,N,1,1,2,,
226,1,多功能,Vi,1,0,1,,
226,3,堵車,Vi,2,2,4,270_,3475_
226,1,使用費,N,1,0,1,,
226,1,不必,ADV,1,0,1,,
226,3,工程師,N,2,3,5,939_,2654_3260_
226,3,排除,Vt,1,2,3,,3294_
227,3,下去,Vi,7,2,9,669_835_889_889_897_897_,3161_
227,1,附加,Vt,1,0,1,,
227,3,通風,Vi,6,17,23,803_876_876_884_884_,2102_2109_2116_2119_2126_2289_2517_2519_2530_2683_2686_2983_2984_3443_3480_3482_
227,3,鄭州,N,14,2,16,230_283_284_284_285_286_286_287_503_1234_1236_1238_1455_,2613_
227,1,下沉,Vi,1,0,1,,
227,3,出租,Vt,3,9,12,837_949_,2134_2411_2595_2625_2772_2899_3175_3176_
227,3,倍,N,5,7,12,290_808_887_895_,2497_2564_2595_2612_3388_3413_
227,3,黑,Vi,6,30,36,495_949_1258_1442_1447_,2048_2059_2198_2247_2272_2549_2550_2600_2616_2671_2690_2705_2706_2738_2744_2760_2760_2897_2961_2963_2975_2997_3131_3137_3185_3223_3253_3310_3459_
227,1,金水路,N,1,0,1,,
227,3,專車,N,3,1,4,835_835_,
227,3,打到,Vt,6,10,16,227_363_368_674_674_,2457_2549_2550_2750_3117_3253_3253_3253_3386_
227,3,在乎,Vt,1,6,7,,2297_2300_2776_3007_3360_
227,1,炸煎烤,Vt,1,0,1,,
227,3,無關,Vi,1,1,2,,
227,3,提醒,Vt,17,21,38,386_520_529_546_546_555_555_630_701_807_949_1319_1324_1343_1425_1472_,2072_2264_2291_2294_2391_2521_2534_2724_2761_2762_2806_3001_3058_3144_3272_3352_3354_3397_3470_3470_
227,1,充溢,Vi,1,0,1,,
227,1,烹,Vt,1,0,1,,
227,3,27日,N,5,4,9,551_560_743_1450_,2432_2435_3184_
227,1,參展,Vi,1,0,1,,
227,1,侃價,N,1,0,1,,
227,3,整整,ADV,1,4,5,,3257_3433_3435_
227,3,租,Vt,4,9,13,227_427_1353_,2565_2993_2994_3106_3187_3189_3253_3254_
228,1,鬧中,N,1,0,1,,
228,1,輝映,Vi,1,0,1,,
228,3,象,N,10,19,29,228_347_357_616_625_1270_1273_1430_1496_,2267_2281_2282_2362_2397_2500_2501_2584_2587_2599_2671_2830_2993_2994_3305_3383_3384_3471_
228,1,取去,Vt,1,0,1,,
228,3,睡著,Vi,4,11,15,408_889_897_,2175_2704_2862_2908_2946_3001_3431_3431_3432_3432_
228,1,去處,N,2,0,2,814_,
228,3,星星,N,2,2,4,1437_,2946_
228,1,幕頂,N,1,0,1,,
228,1,河畔,N,1,0,1,,
228,1,小資,N,3,0,3,334_837_,
228,1,靜,Vi,4,0,4,275_904_1086_,
228,3,派,Vt,3,4,7,710_720_,2862_3253_3360_
228,3,時尚,N,6,3,9,230_1244_1248_1399_1419_,2313_2316_
228,1,夜色,N,1,0,1,,
228,1,浪漫,Vi,1,0,1,,
228,1,野外餐,N,1,0,1,,
228,3,嘿嘿,ADV,5,1,6,891_899_1211_1232_,
229,3,溫度,N,7,18,25,573_636_638_677_891_899_,2059_2343_2759_2759_2759_2759_2773_2815_2949_2959_3009_3010_3022_3023_3180_3196_3327_
229,1,內在,N,1,0,1,,
229,3,上升,Vi,1,1,2,,
229,1,肯開,Vt,1,0,1,,
229,3,得來,Vi,1,2,3,,3425_
229,3,冬天,N,2,7,9,631_,2985_3073_3283_3304_3434_3436_
229,3,失望,Vi,16,85,101,618_627_628_711_711_716_721_721_726_870_878_939_1053_1054_1472_,2037_2115_2118_2175_2175_2195_2195_2247_2284_2289_2384_2388_2391_2418_2426_2454_2455_2479_2494_2495_2516_2518_2521_2525_2535_2558_2572_2616_2616_2616_2625_2647_2648_2719_2722_2731_2731_2735_2736_2742_2744_2761_2762_2791_2808_2824_2826_2874_2883_2932_2942_2968_2978_2978_2986_2997_3000_3040_3047_3051_3052_3053_3056_3056_3080_3096_3101_3102_3253_3255_3256_3271_3272_3279_3283_3319_3345_3357_3383_3384_3433_3435_3452_3457_
229,1,除此之外,ADV,1,0,1,,
229,3,風扇,N,2,1,3,1091_,
229,3,怎麼,ADV,19,110,129,388_471_475_614_623_672_699_887_895_902_1016_1034_1057_1061_1082_1423_1438_1472_,2036_2037_2038_2040_2072_2081_2083_2090_2090_2125_2144_2145_2149_2163_2175_2197_2199_2234_2243_2249_2251_2291_2312_2315_2321_2338_2344_2349_2360_2361_2419_2425_2428_2516_2518_2521_2541_2549_2550_2558_2568_2679_2707_2708_2731_2742_2745_2754_2769_2770_2771_2773_2795_2816_2818_2824_2824_2824_2826_2826_2826_2828_2835_2837_2841_2846_2851_2902_2904_2925_2961_2963_2989_2991_3038_3039_3057_3115_3119_3124_3141_3159_3184_3184_3196_3205_3205_3213_3218_3242_3286_3331_3363_3363_3376_3378_3425_3431_3431_3432_3432_3433_3433_3435_3435_3458_3458_3458_3466_
229,3,天氣,N,8,15,23,377_550_559_1211_1270_1273_1423_,2104_2344_2349_2525_2956_2957_2998_3032_3033_3091_3158_3434_3436_3470_
229,1,室溫,N,1,0,1,,
229,3,方法,N,1,4,5,,2208_2223_3288_
229,3,答案,N,1,4,5,,2287_2288_2946_
230,1,友善,Vi,4,0,4,641_1228_1230_,
231,1,接上去,Vi,1,0,1,,
231,3,明白,Vt,5,16,21,592_601_636_638_,2037_2244_2245_2376_2549_2550_3146_3327_3388_3431_3432_3433_3433_3435_3435_
231,3,酒吧街,N,1,1,2,,
231,1,鍵盤,N,3,0,3,540_750_,
231,1,後海,N,1,0,1,,
231,3,壞,Vt,5,70,75,460_802_826_1240_,2023_2044_2060_2126_2128_2136_2140_2149_2159_2161_2162_2167_2171_2180_2192_2322_2565_2574_2662_2684_2687_2709_2711_2740_2753_2757_2758_2775_2854_2861_2865_2914_2914_2917_2923_2969_2986_3001_3001_3063_3095_3103_3119_3124_3132_3246_3253_3260_3296_3300_3303_3321_3321_3322_3322_3325_3351_3353_3355_3386_3388_3389_3390_3413_3433_3433_3435_3435_3465_
231,3,考慮到,Vt,13,4,17,328_333_686_691_710_720_816_820_1211_1311_1315_1423_,2494_2495_2522_
231,3,吹風機,N,3,3,6,910_1007_,3034_3264_
231,1,主機,N,1,0,1,,
231,1,顯示器,N,2,0,2,750_,
233,3,遺憾,Vt,12,6,18,516_521_530_738_795_798_888_896_959_1049_1237_,2283_2494_2495_2702_3202_
233,3,缺少,Vt,6,6,12,499_589_754_851_860_,2250_2332_2388_3403_3408_
235,3,笑臉,N,10,5,15,279_379_630_890_898_976_1098_1309_1313_,2334_3347_3480_3482_
235,3,之前,N,6,13,19,242_252_540_887_895_,2684_2687_2690_2740_2797_2889_2890_3000_3231_3253_3360_3371_
235,1,萬怡,N,1,0,1,,
235,1,金卡,N,5,0,5,259_259_261_261_,
235,1,鼓勵,Vt,1,0,1,,
235,3,會員,N,12,11,23,259_261_481_753_779_959_1319_1319_1324_1324_1495_,2535_2695_2717_2717_2720_2720_2754_2869_2921_3397_
235,3,進步,Vi,2,2,4,965_,2308_
235,3,相比,Vi,9,13,22,287_391_522_531_662_753_1020_1431_,2060_2342_2409_2410_2540_2564_2703_2731_3110_3112_3326_3344_
235,1,萬豪,N,9,0,9,236_259_261_610_619_1015_1153_1160_,
235,3,作為,Vt,20,25,45,245_255_259_261_315_392_424_714_724_755_757_869_877_887_895_1091_1433_1435_1473_,2252_2253_2498_2571_2572_2647_2746_2746_2753_2754_2759_2798_2800_2830_3049_3102_3139_3159_3220_3221_3246_3327_3489_3491_
235,1,無錫,N,1,0,1,,
236,3,旗下,N,2,1,3,841_,
237,1,保養,Vt,1,0,1,,
237,3,地道,Vi,7,3,10,281_715_725_782_1016_1326_,2131_2133_
238,3,作風,N,1,3,4,,2620_3043_
238,3,銀行,N,9,13,22,238_238_546_546_555_555_1081_1251_,2149_2229_2229_3001_3001_3001_3255_3255_3256_3256_3257_3269_
238,3,入住率,N,3,4,7,743_753_,2705_2706_2967_
238,1,民生,N,1,0,1,,
238,3,下午,N,21,43,64,263_364_369_521_530_630_630_709_710_719_720_738_771_775_923_931_939_1095_1428_1455_,2047_2104_2104_2231_2284_2290_2295_2353_2359_2483_2531_2582_2680_2680_2680_2680_2700_2701_2705_2706_2731_2776_2873_2946_2958_2961_2963_3013_3040_3129_3130_3185_3253_3253_3255_3256_3338_3360_3418_3433_3435_3462_
238,1,萬,ADV,1,0,1,,
238,3,預,ADV,4,17,21,391_411_674_,2015_2072_2189_2229_2229_2284_2287_2288_2295_2534_3038_3039_3147_3330_3330_3337_
238,1,隨意,Vi,1,0,1,,
238,1,麗,Vi,1,0,1,,
238,3,簡直,ADV,7,93,100,388_641_785_980_1257_1425_,2020_2020_2055_2057_2058_2074_2099_2099_2134_2159_2179_2229_2267_2284_2304_2305_2307_2308_2339_2343_2343_2370_2373_2417_2417_2483_2497_2502_2504_2513_2515_2516_2518_2527_2540_2554_2555_2569_2592_2596_2596_2597_2597_2648_2671_2691_2725_2726_2727_2728_2729_2750_2824_2826_2851_2872_2879_2879_2880_2880_2883_2889_2890_2915_2921_2956_2957_2975_3038_3038_3039_3039_3084_3102_3102_3115_3150_3174_3184_3187_3189_3205_3222_3233_3315_3333_3344_3405_3410_3427_3434_3436_
238,3,職業,N,2,5,7,1423_,2225_2226_3226_3335_
238,3,信用卡,N,10,41,51,377_391_612_621_756_758_921_923_931_,2104_2149_2149_2151_2151_2189_2215_2229_2284_2284_2295_2412_2567_2609_2691_2731_2731_2731_2794_2921_2956_2957_3001_3001_3001_3002_3038_3039_3069_3070_3150_3255_3255_3256_3256_3295_3488_3489_3490_3491_
238,3,回答,Vt,5,42,47,279_279_938_1057_,2083_2095_2097_2170_2229_2312_2315_2342_2372_2375_2454_2454_2455_2455_2483_2483_2522_2609_2691_2816_2818_2872_2889_2890_2968_3032_3032_3033_3033_3108_3109_3115_3115_3196_3202_3243_3281_3327_3327_3397_3465_
238,3,道德,N,1,3,4,,2226_3226_
238,3,授權,Vt,3,18,21,391_411_,2015_2072_2189_2229_2229_2295_2534_3001_3001_3001_3002_3038_3039_3147_3330_3330_3337_
238,3,取消,Vt,8,42,50,238_391_410_662_710_720_921_,2015_2104_2104_2241_2345_2350_2363_2391_2403_2458_2467_2468_2494_2494_2495_2495_2573_2616_2690_2690_2798_2800_2838_2838_2838_2956_2956_2957_2957_2987_3011_3038_3039_3203_3204_3282_3316_3327_3367_3368_3386_
238,3,有沒有,ADV,4,25,29,238_434_439_,2532_2533_2534_2534_2549_2550_2594_2759_2782_2838_2919_3013_3076_3085_3107_3289_3290_3376_3378_3416_3431_3432_3478_3478_
238,3,氣人,Vi,1,2,3,,3253_
238,3,事情,N,6,54,60,819_889_897_1169_1176_,2163_2195_2195_2225_2225_2226_2226_2252_2252_2253_2253_2260_2267_2391_2504_2549_2549_2550_2550_2567_2609_2609_2609_2671_2680_2680_2690_2690_2698_2746_2746_2769_2770_2775_2791_2796_2828_2889_2890_2956_2957_2970_3044_3048_3076_3150_3177_3184_3253_3260_3295_3446_3458_
238,3,不配,ADV,1,2,3,,2838_
238,3,接到,Vt,6,12,18,661_710_720_870_878_,2611_2671_2671_2889_2890_3098_3205_3294_3296_3329_3380_
239,1,侯車,N,2,0,2,249_,
239,3,佳,Vi,13,3,16,245_249_255_284_527_536_802_1023_1081_1267_1327_1500_,2845_3225_
239,1,適量,Vi,2,0,2,249_,
239,1,最愛,N,2,0,2,249_,
239,1,專線,N,4,0,4,249_857_866_,
239,1,電視塔,N,2,0,2,249_,
239,3,肯定,Vt,15,37,52,249_287_309_313_470_474_481_782_891_899_1082_1232_1319_1324_,2049_2052_2260_2318_2319_2527_2529_2540_2558_2641_2645_2648_2671_2808_2816_2818_2885_2887_2919_2933_3049_3076_3113_3187_3189_3222_3253_3293_3383_3384_3417_3418_3433_3435_3467_3467_
239,1,發車,Vi,2,0,2,249_,
239,1,棧橋,N,21,0,21,239_242_244_245_246_247_248_249_249_252_254_255_256_257_258_669_710_710_720_720_,
239,3,站點,N,2,2,4,249_,2163_
239,1,北九水,N,2,0,2,249_,
239,3,運氣,N,6,3,9,249_674_809_889_897_,3187_3189_
239,3,取用,Vt,2,2,4,249_,3301_
239,1,景象,N,2,0,2,249_,
239,3,裝潢,N,12,2,14,249_700_811_844_886_894_964_1006_1251_1479_1486_,2417_
239,3,早起,Vi,3,1,4,249_983_,
239,3,卡片,N,6,1,7,249_520_520_529_529_,
239,1,20世紀,N,2,0,2,249_,
239,3,車程,N,10,4,14,249_465_543_801_801_801_1106_1251_1378_,2308_3041_3163_
239,3,保持,Vt,4,2,6,249_1244_1248_,3345_
239,3,日出,Vi,5,2,7,249_364_369_1421_,2326_
239,3,馬路,N,24,51,75,249_338_341_341_418_418_495_521_530_697_921_957_966_1124_1131_1243_1247_1295_1299_1356_1359_1361_1364_,2035_2101_2102_2299_2302_2535_2575_2634_2671_2699_2740_2772_2875_2908_2908_2967_3016_3038_3039_3040_3040_3040_3047_3051_3088_3092_3098_3106_3152_3186_3188_3192_3195_3231_3242_3283_3310_3331_3360_3392_3394_3431_3431_3432_3432_3443_3443_3444_3475_3483_
239,3,科勒,N,3,1,4,249_974_,
240,3,依舊,ADV,4,3,7,250_322_749_,2687_2946_
240,3,青島,N,51,6,57,242_242_242_245_247_248_250_252_252_252_255_257_258_594_597_599_603_608_644_644_707_707_710_710_710_710_710_711_714_714_714_714_715_716_717_717_720_720_720_720_720_721_724_724_724_724_725_726_771_775_,2104_2105_2861_2867_3385_
240,3,過去,N,18,29,47,250_388_424_552_561_710_720_847_902_1005_1009_1065_1232_1250_1251_1304_1307_,2425_2428_2463_2465_2549_2550_2556_2606_2656_2698_2748_2753_2806_2831_2832_2907_2976_3011_3013_3013_3231_3253_3264_3296_3337_3337_3495_3497_
240,1,．１０年,N,2,0,2,250_,
240,1,略顯,Vi,4,0,4,250_386_748_,
241,1,廣泛,Vi,2,0,2,251_,
241,1,豎,Vt,2,0,2,251_,
241,3,眼睛,N,4,11,15,242_251_252_,2090_2363_2445_2446_2946_3103_3115_3115_3431_3432_
241,3,側,N,6,3,9,251_351_361_674_1020_,2609_2861_
241,3,實地,ADV,2,4,6,251_,2054_3107_3379_
241,3,冷淡,Vi,4,12,16,251_422_1088_,2005_2084_2085_2471_2508_2547_2764_2950_3034_3056_3101_
241,1,選海天,N,2,0,2,251_,
241,3,協程,N,6,7,13,251_599_608_1495_1495_,2517_2517_2519_2519_2519_2883_
241,3,3樓,N,12,5,17,251_408_408_520_529_870_871_871_878_879_879_,3098_3110_3113_3347_
241,3,效果,N,23,35,58,251_417_546_555_584_970_1022_1068_1075_1181_1183_1187_1189_1219_1221_1254_1295_1299_1332_1352_1375_1421_,2104_2106_2116_2119_2151_2207_2239_2292_2325_2557_2647_2703_2740_2759_2791_2791_2816_2818_2888_2912_2926_2969_3037_3041_3058_3099_3119_3124_3260_3341_3341_3428_3431_3432_
242,3,窗台,N,3,3,6,252_822_,3083_3207_
242,3,喧鬧,Vi,3,1,4,252_783_,
242,1,名不虛傳,Vi,4,0,4,252_714_724_,
242,1,謝,Vt,2,0,2,252_,
242,1,濛濛細雨,N,2,0,2,252_,
242,3,望去,Vi,2,2,4,252_,2636_
242,3,迎面,ADV,3,1,4,252_910_,
242,1,典雅,Vi,3,0,3,252_407_,
242,1,近在咫尺,Vi,2,0,2,252_,
242,3,看過,Vt,5,6,11,252_952_953_1423_,2609_3043_3117_3373_3374_
242,1,真切,Vi,2,0,2,252_,
242,1,高高,Vi,3,0,3,252_787_,
242,3,從事,Vt,2,1,3,252_,
242,1,帶給,Vt,2,0,2,252_,
242,1,端莊,Vi,2,0,2,252_,
242,1,倪萍,N,4,0,4,242_252_252_,
242,3,名人,N,8,1,9,242_242_242_252_252_252_252_,
242,3,女性,N,6,3,9,242_252_252_482_491_,3213_3218_
242,1,舉手投足,N,2,0,2,252_,
242,1,都市,N,2,0,2,252_,
242,3,心態,N,3,1,4,252_281_,
242,1,和煦,Vi,2,0,2,252_,
242,1,特質,N,2,0,2,252_,
242,1,大方,Vi,7,0,7,252_711_721_1462_1467_1473_,
242,3,四樓,N,5,7,12,252_328_333_663_,3213_3218_3480_3480_3482_3482_
242,3,規範,N,4,4,8,252_428_1054_,2310_2311_2987_
242,3,女孩,N,5,3,8,252_710_720_835_,3391_3393_
242,1,來自,Vt,2,0,2,252_,
242,1,泛海,N,8,0,8,242_242_242_252_252_252_252_,
242,1,風采,N,2,0,2,252_,
242,1,春暖花開,Vi,2,0,2,252_,
242,1,雨傘,N,2,0,2,252_,
242,1,體會到物,N,2,0,2,252_,
242,1,一望無際,Vi,3,0,3,252_1090_,
242,1,海風,N,5,0,5,252_711_721_1087_,
242,3,航空,N,4,1,5,252_735_1455_,
242,1,年青,Vi,2,0,2,252_,
242,1,享受到,Vt,4,0,4,252_923_931_,
242,1,花花草草,N,2,0,2,252_,
242,3,認識,Vt,4,8,12,252_793_796_,2149_2149_2174_2452_2731_2976_3089_
242,3,急,Vi,11,11,22,242_252_252_546_546_546_555_555_555_1061_,2530_2838_2970_3084_3101_3146_3193_3288_3331_3462_
242,1,過廳,N,2,0,2,252_,
242,3,美好,Vi,5,5,10,252_1028_1029_1032_,2590_2753_2754_2794_
242,3,瞭解,Vt,5,6,11,252_427_1142_1144_,2613_2761_2762_2949_3253_
242,1,放眼,Vt,2,0,2,252_,
242,3,佈置,Vt,10,2,12,252_325_330_334_545_910_972_1050_1257_,3499_
242,1,潔淨,Vi,7,0,7,252_260_262_641_1141_1143_,
242,1,氣韻,N,2,0,2,252_,
242,3,眼光,N,2,1,3,252_,
242,3,關上,Vt,2,11,13,252_,2252_2253_2304_2307_2742_2953_3321_3322_3434_3436_
242,3,傳統,N,4,1,5,252_316_801_,
242,3,推開,Vt,4,1,5,252_1304_1307_,
242,3,充滿,Vt,2,4,6,252_,2725_2780_2947_
242,3,言語,N,2,3,5,252_,2350_3226_
242,3,明亮,Vi,5,1,6,252_464_874_882_,
242,1,青春版,N,2,0,2,252_,
242,3,困難,N,3,7,10,252_662_,2363_2540_2589_2590_2753_3149_
242,1,糧,N,2,0,2,252_,
242,1,和藹,Vi,2,0,2,252_,
242,1,大使,N,2,0,2,252_,
242,1,優秀,Vi,2,0,2,252_,
242,3,來到,Vt,5,6,11,252_1060_1211_1437_,2372_2375_2647_3232_3447_
242,3,面對,Vt,14,4,18,252_672_732_763_769_820_1020_1145_1168_1175_1269_1410_1415_,2776_3132_3150_
242,1,吹來,Vi,2,0,2,252_,
244,3,看見,Vt,11,19,30,254_393_407_872_880_902_1232_1232_1336_1437_,2112_2153_2269_2270_2382_2411_2714_2785_2869_2872_2872_2898_3076_3177_3187_3189_3234_3388_
244,3,重新,ADV,18,19,37,254_281_428_477_486_838_876_884_1203_1254_1267_1430_1469_1470_1472_1489_1492_,2037_2072_2086_2249_2251_2305_2308_2445_2446_2517_2519_2814_2895_2922_2946_3055_3118_3281_
244,3,記得,Vt,11,9,20,254_565_574_856_865_1061_1067_1074_1211_1423_,2005_2015_2225_2226_2252_2253_3352_3354_
245,1,簡餐,N,2,0,2,255_,
245,1,熱狗,N,2,0,2,255_,
245,1,三明治,N,2,0,2,255_,
245,3,份量,N,4,2,6,255_835_1057_,2133_
245,1,怡人,Vi,2,0,2,255_,
245,3,樓道,N,6,14,20,255_392_410_825_1005_,2153_2169_2324_2683_2686_2753_2772_2898_2915_3237_3239_3448_3453_
245,3,房門,N,4,25,29,255_600_609_,2252_2253_2289_2418_2532_2533_2674_2746_2873_2923_2923_2987_3239_3318_3341_3389_3390_3405_3410_3433_3433_3435_3435_3443_
245,3,添加,Vt,2,1,3,255_,
245,1,非住,N,2,0,2,255_,
245,3,咖啡,N,6,8,14,255_819_1054_1054_1499_,2349_2418_2450_2453_3315_3431_3432_
245,1,人群,N,2,0,2,255_,
246,3,工人,N,2,2,4,256_,2861_
246,3,差一點,ADV,4,2,6,256_675_1239_,3453_
246,3,果盤,N,9,7,16,256_341_365_370_1057_1083_1272_1275_,2338_2338_2671_2671_2776_3315_
246,3,地板,N,6,22,28,256_443_443_872_880_,2299_2299_2302_2302_2718_2721_2786_2788_2928_2987_3012_3111_3205_3223_3288_3313_3341_3380_3409_3434_3436_
246,3,停止,Vt,2,2,4,256_,2712_
246,3,字,N,7,44,51,256_298_306_949_1028_1028_,2006_2038_2040_2074_2074_2074_2109_2208_2264_2333_2334_2469_2481_2481_2481_2482_2482_2482_2527_2531_2561_2562_2577_2790_2846_2846_2929_2929_3036_3122_3127_3129_3130_3184_3196_3208_3226_3247_3307_3351_3397_3420_3477_
246,3,靠,Vt,6,11,17,256_348_669_742_1234_,2376_2615_2776_2809_3040_3084_3289_3290_3397_3462_
246,3,維護,Vt,6,5,11,256_484_493_801_1236_,2267_2475_2949_3098_
246,1,優美,Vi,6,0,6,256_274_982_1462_1467_,
246,1,山東,N,2,0,2,256_,
246,3,22日,N,6,11,17,256_641_983_1038_1203_,2252_2253_2406_2408_2590_3049_3158_3184_3239_3371_
246,1,某天,N,2,0,2,256_,
246,3,交涉,Vt,3,33,36,256_753_,2284_2312_2315_2391_2531_2531_2547_2554_2555_2606_2674_2743_2776_2824_2826_2907_2961_2963_3165_3245_3274_3282_3341_3364_3389_3390_3421_3423_3424_3433_3435_3478_
246,3,磨,Vt,2,2,4,256_,2953_
247,3,設置,Vt,3,15,18,257_515_,2629_2950_3024_3026_3059_3170_3172_3323_3488_3488_3488_3490_3490_3490_
247,1,鄰居,N,4,0,4,257_1042_1042_,
247,3,沙灘,N,10,5,15,257_855_856_859_864_865_868_1088_1430_,2861_3347_3347_3360_
247,3,隔,Vt,2,10,12,257_,2144_2145_2162_2269_2510_2511_3132_3205_3333_
247,1,體貼,Vt,4,0,4,257_347_357_,
247,3,慘,Vi,3,2,5,257_700_,3083_
247,3,零食,N,3,1,4,257_820_,
247,3,夜間,N,7,6,13,257_342_352_677_707_717_,2446_2671_2747_2908_3159_
248,1,問對,Vt,2,0,2,258_,
248,3,獨立,Vi,3,2,5,258_1057_,3163_
248,1,五四,N,3,0,3,258_669_,
248,1,房床,N,2,0,2,258_,
248,3,真,ADV,39,88,127,258_279_290_342_350_352_360_374_374_379_379_379_416_592_601_630_762_837_872_880_889_897_916_922_930_1020_1088_1095_1112_1120_1202_1237_1249_1359_1359_1364_1364_1472_,2015_2029_2042_2043_2045_2050_2053_2055_2065_2081_2083_2125_2134_2162_2162_2165_2181_2190_2211_2243_2249_2251_2264_2360_2361_2362_2392_2419_2438_2440_2457_2521_2527_2528_2560_2616_2631_2649_2717_2720_2731_2748_2782_2816_2818_2846_2928_2928_2936_2937_2961_2963_2964_3038_3039_3049_3071_3101_3105_3112_3117_3194_3195_3205_3232_3239_3253_3262_3263_3279_3282_3298_3301_3345_3352_3354_3358_3363_3396_3426_3431_3432_3454_3463_3478_3495_3497_
248,3,淋浴,Vi,10,39,49,258_289_335_379_573_1026_1239_1304_1307_,2006_2014_2116_2119_2434_2500_2501_2508_2517_2519_2547_2569_2649_2823_2825_3007_3038_3039_3095_3111_3111_3114_3117_3205_3239_3288_3352_3354_3369_3370_3376_3378_3391_3393_3413_3463_3466_3472_
253,3,清理,Vt,6,3,9,417_417_520_529_1251_,2949_3483_
253,1,漂浮,Vi,1,0,1,,
253,3,頭髮,N,4,10,14,253_326_331_,2394_2600_2717_2718_2720_2721_2951_3062_3062_
253,3,噁心,Vi,1,30,31,,2041_2058_2215_2258_2259_2382_2394_2419_2454_2455_2528_2553_2669_2791_2791_2946_3119_3124_3140_3150_3150_3207_3207_3207_3207_3231_3231_3298_3301_
253,3,達到,Vt,7,12,19,287_753_771_775_1239_1437_,2579_2671_2690_2847_2873_3129_3129_3130_3130_3142_3283_
253,3,瑕疵,N,1,1,2,,
259,3,充分,Vi,3,1,4,261_1211_,
259,3,待遇,N,4,6,10,261_714_724_,2770_2775_3103_3146_3253_
260,1,摩登,Vi,2,0,2,262_,
260,3,款,N,4,3,7,262_342_352_,2731_3327_
266,1,忍忍,Vi,1,0,1,,
266,3,或許,ADV,6,1,7,279_887_895_902_1211_,
268,3,拉開,Vt,3,2,5,281_1026_,3436_
268,1,球場,N,1,0,1,,
268,3,下雨,Vi,3,4,7,1319_1324_,2436_2815_2953_
269,3,電視機,N,12,12,24,286_670_801_822_870_878_885_893_1293_1293_1377_,2057_2069_2070_2146_2146_2211_2528_2585_3103_3222_3333_
269,3,破,Vt,5,36,41,870_878_1021_1293_,2127_2139_2143_2215_2272_2283_2321_2322_2322_2383_2411_2541_2616_2705_2706_2851_2945_2993_2994_3029_3141_3156_3159_3207_3207_3234_3239_3274_3274_3289_3289_3290_3290_3446_3477_
270,1,清涼寺,N,1,0,1,,
270,3,用不了,ADV,2,2,4,1114_,2765_
270,1,城區,N,5,0,5,789_792_1108_1116_,
270,3,愛,Vt,3,9,12,714_724_,2210_2642_2646_2782_3227_3360_3465_3487_
270,1,路窄愛,N,1,0,1,,
270,1,文廟,N,2,0,2,272_,
271,3,豐盛,Vi,9,2,11,324_552_561_924_932_949_1020_1042_,3398_
271,3,坐車,Vi,3,2,5,1124_1131_,3040_
271,1,泉州,N,11,0,11,292_292_293_295_297_300_300_301_303_305_,
271,3,到處,ADV,3,24,27,630_1098_,2124_2124_2181_2264_2530_2584_2744_2746_2889_2890_2914_2945_2976_3038_3039_3074_3104_3207_3266_3479_3479_3481_3481_
271,1,中旅,N,1,0,1,,
271,3,兜,N,2,3,5,271_,2889_2890_
271,3,站到,Vt,1,1,2,,
271,1,中心站,N,1,0,1,,
271,3,耽誤,Vt,5,8,13,397_546_555_1367_,2140_2231_2372_2375_2680_3159_3341_
271,3,接客,Vi,2,1,3,1104_,
271,3,車站,N,18,8,26,386_392_677_677_787_789_790_887_890_895_898_962_1151_1158_1359_1364_1386_,2411_2648_2717_2720_2933_3013_3013_
272,3,瓶裝,A,2,1,3,1098_,
272,3,古色古香,Vi,1,1,2,,
272,1,點路,N,1,0,1,,
272,3,建築,N,5,10,15,482_491_1141_1143_,2089_2731_2861_3241_3246_3246_3345_3371_3409_
272,1,銅,N,1,0,1,,
272,3,汽車站,N,9,9,18,278_363_368_1194_1266_1337_1433_1435_,2272_2313_2316_2610_3013_3137_3185_3252_
272,3,週末,N,4,8,12,322_710_720_,2761_2762_2775_3019_3265_3281_3387_
272,1,關帝廟,N,1,0,1,,
272,1,閩南,N,1,0,1,,
272,3,無,Vt,18,73,91,379_394_394_412_434_443_546_546_546_555_555_555_628_628_710_720_779_,2041_2120_2121_2239_2240_2267_2284_2284_2313_2316_2338_2342_2383_2463_2463_2463_2463_2463_2463_2465_2465_2465_2465_2465_2465_2483_2508_2520_2521_2609_2613_2640_2651_2654_2746_2750_2784_2813_2845_2861_2862_2873_2873_2873_2889_2890_2923_2928_2945_2996_2996_3065_3067_3077_3103_3165_3231_3237_3252_3252_3267_3269_3269_3280_3296_3296_3297_3308_3333_3364_3422_3462_
272,1,清真寺,N,1,0,1,,
272,1,佛寺,N,1,0,1,,
272,3,平時,N,7,7,14,433_807_808_808_887_895_,2634_2872_3103_3213_3218_3445_
272,3,出錢,Vi,1,1,2,,
273,1,遲鈍,Vi,1,0,1,,
273,1,大觀園,N,1,0,1,,
273,1,花園式,N,5,0,5,328_333_1111_1119_,
273,3,真實,Vi,1,3,4,,3278_3296_
273,3,反應,Vt,8,22,30,589_630_630_701_743_962_1057_,2134_2139_2143_2258_2259_2372_2375_2557_2671_2835_3076_3184_3257_3413_3448_3448_3451_3453_3453_3456_3470_
274,3,月份,N,5,2,7,521_530_843_1018_,3236_
275,1,優越性,N,2,0,2,275_,
275,3,破敗,Vi,1,1,2,,
275,1,替代,Vt,1,0,1,,
275,3,優越,Vi,7,1,8,442_630_659_892_900_1344_,
275,1,背山面湖,N,1,0,1,,
275,1,天然,A,1,0,1,,
275,3,歷史,N,6,4,10,1141_1143_1326_1326_1378_,2399_2401_2742_
275,3,曾經,ADV,4,8,12,477_486_1437_,2183_2426_2452_2546_2815_2976_2997_
275,1,以往,N,1,0,1,,
275,1,日常,A,2,0,2,1005_,
275,3,捨得,Vt,1,1,2,,
275,3,質素,N,5,1,6,610_610_619_619_,
275,1,輝煌,Vi,1,0,1,,
276,3,著想,Vi,6,3,9,515_995_996_1480_1487_,3431_3432_
276,1,步高門,N,1,0,1,,
276,3,照片,N,1,7,8,,2945_2953_2967_2998_3274_3275_
276,1,好客,Vi,1,0,1,,
276,3,給予,Vt,12,8,20,335_435_982_982_982_1031_1031_1309_1313_1423_1497_,2361_2623_2624_2747_3049_3202_3345_
276,1,中午飯,N,1,0,1,,
276,3,理念,N,5,3,8,714_724_1028_1029_,2747_2759_
276,3,即,ADV,5,10,15,438_885_893_949_,2097_2363_2363_2388_2406_2408_2882_3139_3253_
276,3,遇,Vt,2,1,3,1436_,
276,3,漂流,Vi,1,3,4,,3163_3163_
276,3,導遊,N,2,2,4,1436_,2566_
276,3,鬧中取靜,Vi,10,1,11,280_828_915_1014_1070_1077_1113_1121_1218_,
276,1,月亮,N,1,0,1,,
276,1,山腳,N,4,0,4,391_837_1061_,
276,1,龍河,N,1,0,1,,
276,1,遺失,Vi,2,0,2,1025_,
276,1,街頭處,N,1,0,1,,
276,3,陽朔,N,6,2,8,276_278_278_281_281_,2933_
276,1,樸實,Vi,3,0,3,628_1211_,
276,3,開心,Vi,6,6,12,443_674_1311_1315_1437_,2843_3158_3246_3308_3327_
277,3,抱怨,Vt,3,7,10,699_832_,2259_2273_2857_2858_2967_3254_
277,3,霉味,N,6,56,62,342_342_352_352_1038_,2014_2020_2049_2052_2111_2124_2166_2190_2224_2289_2323_2342_2356_2421_2425_2428_2517_2519_2534_2682_2683_2684_2685_2686_2687_2714_2725_2740_2744_2748_2780_2815_2828_2828_2852_2857_2857_2858_2858_2928_3020_3030_3069_3070_3083_3344_3363_3383_3384_3395_3406_3411_3414_3446_3477_
277,3,西街,N,1,3,4,,2714_3332_
277,3,不符,Vt,6,14,20,290_660_738_811_1452_,2158_2213_2671_2750_2795_2797_2978_3245_3295_3296_3325_3489_3491_
277,3,街頭,N,2,4,6,278_,2551_3083_3366_
277,1,旅伴,N,2,0,2,1436_,
278,3,畢竟,ADV,7,8,15,391_790_842_1020_1211_1211_,2309_2360_2361_2386_2771_3103_3319_
278,1,重取靜,Vi,1,0,1,,
278,3,亮點,N,1,4,5,,2731_2881_2882_
278,3,達,Vt,8,29,37,287_386_480_489_501_551_560_,2071_2161_2186_2204_2432_2435_2445_2446_2506_2507_2574_2585_2637_2638_2709_2711_2830_2836_2936_2937_2959_3166_3352_3354_3360_3380_3489_3491_
278,1,橋,N,4,0,4,983_1441_1446_,
279,1,突出,Vi,3,0,3,595_604_,
279,3,有待,Vt,9,9,18,410_506_938_985_1194_1213_1237_1426_,2072_2084_2085_2500_2501_2888_2977_3074_
279,1,庭院,N,5,0,5,1109_1117_1441_1446_,
279,3,借,Vt,3,5,8,1048_1371_,2134_2745_2773_3327_
279,1,英式,A,2,0,2,846_,
279,3,充電器,N,3,1,4,1114_1114_,
279,1,接線板,N,1,0,1,,
279,3,插頭,N,5,2,7,875_883_1266_1266_,3073_
280,3,誰,N,1,29,30,,2162_2197_2232_2239_2273_2359_2381_2398_2411_2544_2554_2555_2746_2847_2861_2865_2958_3074_3193_3232_3305_3319_3331_3433_3435_3446_3472_3478_
280,1,臉皮,N,1,0,1,,
280,3,厚,Vi,3,1,4,366_371_,
280,1,勝,Vi,3,0,3,522_531_,
280,1,優雅,Vi,8,0,8,324_326_331_510_1043_1104_1367_,
280,1,離住,Vt,1,0,1,,
280,3,手忙腳亂,Vi,1,1,2,,
280,3,手動,A,1,5,6,,3170_3170_3172_3172_
280,3,排隊,Vi,3,6,9,617_626_,2544_2835_2869_2919_3243_
280,3,窄,Vi,1,5,6,,2679_2756_3040_3319_
281,3,臺,N,2,6,8,960_,2252_2252_2253_2253_2253_
281,3,跑到,Vt,2,2,4,912_,3103_
281,3,挑剔,Vt,3,1,4,1391_1400_,
281,3,特地,ADV,5,1,6,710_720_1129_1136_,
281,1,發電機,N,1,0,1,,
281,3,南方,N,4,1,5,1211_1423_1423_,
281,3,城,N,5,4,9,813_814_1111_1119_,3074_3086_3086_
281,3,招待所,N,10,87,97,381_384_387_1021_1201_1201_1293_1296_1300_,2027_2042_2050_2053_2058_2059_2099_2099_2126_2127_2136_2140_2154_2154_2193_2232_2232_2240_2281_2282_2313_2316_2335_2346_2351_2362_2388_2411_2436_2457_2474_2483_2504_2515_2523_2526_2556_2569_2573_2599_2619_2620_2627_2658_2671_2671_2679_2786_2788_2828_2859_2889_2890_2929_2932_2951_2959_2965_2966_2975_2988_3013_3014_3025_3027_3034_3069_3070_3114_3115_3141_3154_3155_3160_3179_3222_3233_3234_3235_3272_3275_3276_3415_3418_3451_3456_
281,3,培訓,Vt,4,3,7,316_391_410_,2609_2753_
281,3,惡劣,Vi,1,38,39,,2015_2155_2169_2223_2297_2300_2345_2350_2416_2486_2494_2495_2539_2608_2608_2754_2849_2871_2881_2900_3115_3226_3342_3361_3362_3373_3374_3413_3423_3424_3433_3435_3450_3451_3455_3456_3458_
281,3,電力,N,1,3,4,,2606_2987_
281,3,屋,N,7,18,25,906_980_990_993_1418_1418_,2116_2119_2232_2304_2307_2561_2562_2899_3099_3369_3370_3419_3443_3443_3443_3452_3457_
281,3,顧客,N,13,26,39,364_369_417_434_714_714_724_724_960_1480_1487_1497_,2197_2201_2322_2553_2590_2671_2671_2731_2731_2742_2745_2759_2759_3043_3054_3118_3146_3319_3446_3448_3448_3448_3453_3453_3453_
281,3,親切感,N,1,1,2,,
281,1,發電,Vi,1,0,1,,
281,3,降,Vt,2,1,3,423_,
281,3,雪,N,1,1,2,,
281,3,沙發,N,6,12,18,396_669_742_906_1499_,2613_2709_2709_2711_2711_2718_2721_2750_2750_2841_3103_
281,3,上帝,N,3,6,9,434_1497_,2608_2659_2742_3361_3362_
281,3,暖,Vi,1,5,6,,2815_2944_3202_3202_
281,3,過於,ADV,4,8,12,417_949_1140_,2679_2714_2921_2981_2982_3466_3473_
281,3,調試,Vt,2,4,6,1018_,3146_3146_3158_
281,3,感覺到,Vt,8,3,11,341_716_726_961_1054_1481_1488_,2954_3163_
281,3,理解,Vt,3,14,17,699_1091_,2322_2335_2386_2594_2879_2880_2924_3103_3132_3132_3159_3174_3363_
281,1,禮儀,N,1,0,1,,
281,3,停電,Vi,1,10,11,,2565_2616_2616_2616_2616_3001_3001_3100_3232_
281,3,旅店,N,1,2,3,,3336_
281,1,平心而論,Vi,2,0,2,641_,
281,3,經過,Vt,6,26,32,424_835_1437_1469_1470_,2108_2360_2361_2392_2417_2483_2651_2654_2775_2836_3013_3047_3051_3083_3093_3147_3296_3318_3329_3423_3424_3433_3435_3450_3455_
281,3,衡量,Vt,2,2,4,1039_,3435_
281,3,風機,N,1,1,2,,
281,1,樂,N,1,0,1,,
281,3,概念,N,1,1,2,,
281,3,取暖,Vi,1,1,2,,
281,3,寒磣,Vi,2,1,3,584_,
281,1,提出來,Vt,1,0,1,,
281,3,緊張,Vi,7,10,17,377_435_592_601_662_800_,2495_2794_3185_3371_3388_3388_3388_3489_3491_
281,3,老式,A,2,3,5,1267_,2411_3324_
281,1,比擬,Vt,1,0,1,,
281,1,西方,N,1,0,1,,
282,3,試,Vt,4,12,16,323_856_865_,2606_2802_2802_2824_2826_2938_2972_3170_3172_3339_3470_
282,3,滿分,N,3,1,4,842_1098_,
282,3,摸,Vt,1,4,5,,2562_3289_3290_
282,3,按,Vt,15,11,26,379_1020_1167_1168_1169_1170_1172_1173_1174_1175_1176_1177_1179_1180_,2226_2272_2551_2565_2565_2671_3049_3115_3146_3161_
283,3,好好,Vi,2,15,17,435_,2247_2309_2367_2483_2579_2745_2809_2923_2923_3044_3048_3140_3246_3253_
284,1,住裕達,N,1,0,1,,
284,3,算好,Vt,4,6,10,503_511_997_,2054_2484_2975_3255_3256_
285,3,老公,N,6,4,10,787_888_896_1088_1088_,2718_2721_2881_
286,3,國慶,N,1,3,4,,3029_3274_
286,3,西南,N,1,2,3,,3490_
286,3,對不起,Vt,5,17,22,618_627_802_1019_,2319_2549_2550_2609_2609_2611_2744_2746_3020_3101_3181_3214_3219_3403_3408_3409_
286,1,組成,Vt,1,0,1,,
286,3,河南,N,2,9,11,286_,2936_2936_2936_2937_2937_2937_3479_3481_
286,3,老土,Vi,1,2,3,,2762_
287,1,裕,N,1,0,1,,
287,3,記,Vt,3,6,9,913_1328_,2511_2616_2616_2967_3327_
287,3,想到,Vt,5,12,17,381_384_958_1350_,2041_2072_2231_2469_2561_2562_2824_2826_3255_3256_3397_
287,3,吸引力,N,1,4,5,,2855_2856_3011_
287,3,贈送,Vt,14,11,25,341_345_355_568_577_710_710_720_720_1062_1419_1479_1486_,2177_2502_2671_2968_3038_3038_3038_3039_3039_3039_
287,1,大清,Vi,1,0,1,,
287,1,小冊子,N,1,0,1,,
287,3,8日,N,6,12,18,592_601_1150_1157_1437_,2225_2226_2753_2840_2923_3014_3029_3065_3067_3129_3130_
288,3,市政府,N,6,2,8,339_980_1017_1296_1300_,2167_
288,3,罷工,Vi,1,1,2,,
288,3,商業區,N,8,5,13,747_786_822_980_991_994_1100_,2092_2705_2706_2809_
289,3,壞掉,Vi,2,3,5,939_,3119_3124_
289,1,落水,Vi,1,0,1,,
289,3,修,Vt,2,24,26,914_,2171_2360_2361_2662_2705_2706_2756_2917_2986_3038_3038_3039_3039_3084_3119_3124_3186_3188_3246_3415_3433_3435_3466_
289,3,積極,Vi,1,5,6,,2259_2907_2924_3296_
289,3,滴,Vt,2,8,10,408_,2425_2425_2428_2428_2428_3433_3435_
289,3,分到,Vt,2,4,6,630_,2083_2836_2836_
289,3,米,N,1,1,2,,
290,3,實,Vi,3,1,4,1215_1423_,
290,3,翻,Vt,3,1,4,1311_1315_,
290,3,箱子,N,1,9,10,,2206_2206_2338_2528_3244_3447_3480_3482_
291,3,調整,Vt,5,11,16,299_1031_1171_1178_,2363_2857_2858_3038_3039_3055_3065_3067_3146_3294_
291,1,新翼樓,N,2,0,2,299_,
292,3,其實,ADV,34,44,78,293_300_301_427_546_555_584_630_644_664_714_724_780_804_842_842_842_843_847_857_866_887_889_891_895_897_899_907_1201_1378_1437_1490_1493_,2008_2012_2186_2258_2259_2261_2261_2263_2263_2322_2332_2354_2355_2514_2621_2669_2718_2721_2771_2794_2816_2818_2824_2826_2841_2872_2872_2933_3038_3039_3054_3088_3141_3142_3205_3213_3218_3227_3294_3295_3371_3388_3427_
292,3,攜程定,Vt,4,5,9,293_300_301_,3088_3246_3312_3344_
292,1,悅華,N,14,0,14,292_292_292_293_293_293_300_300_300_300_301_301_301_,
293,3,比不過,Vt,2,1,3,301_,
293,3,講究,Vt,5,2,7,301_1088_1481_1488_,3140_
293,1,泉酒,N,4,0,4,295_301_303_,
294,3,清爽,Vi,6,4,10,302_663_1085_1439_1444_,2534_2647_2791_
295,3,同行,Vi,2,9,11,303_,2596_2597_2683_2686_2836_2974_3101_3146_
295,3,國外,N,2,9,11,303_,2009_2057_2551_2598_2621_2690_2798_2800_
295,1,水仙花,N,2,0,2,303_,
295,1,清香,Vi,2,0,2,303_,
295,1,同感,N,2,0,2,303_,
295,3,稱讚,Vt,3,3,6,303_1335_,2671_2775_
297,3,客運,N,9,2,11,305_391_1242_1243_1246_1247_1491_1494_,3118_
297,3,優,Vi,2,1,3,305_,
297,1,站坐,Vi,2,0,2,305_,
297,3,大約,ADV,10,12,22,305_418_582_583_710_720_815_856_865_,2057_2232_2680_2769_2770_2946_2946_3041_3049_3074_3180_
297,3,先生,N,6,5,11,305_1203_1203_1497_1500_,2411_2530_2530_2702_
298,1,輸,Vt,2,0,2,306_,
298,1,東暉樓,N,2,0,2,306_,
298,3,卡,N,8,35,43,306_648_654_889_897_1328_1473_,2015_2037_2047_2089_2095_2095_2097_2097_2149_2149_2149_2186_2197_2211_2229_2368_2369_2390_2391_2544_2609_2609_2751_2767_2873_2958_3257_3257_3327_3433_3433_3435_3435_3465_
298,3,錯,Vi,5,24,29,306_424_821_1450_,2135_2186_2309_2360_2361_2517_2519_2625_2707_2708_2757_2758_2852_2964_3186_3188_3231_3409_3448_3453_3478_3488_3490_
298,1,主管,N,9,0,9,298_306_306_714_724_912_1495_1500_,
298,3,簽,Vt,2,13,15,306_,2269_2278_2284_2284_2393_2739_2803_2846_2846_2869_3361_3362_
298,3,密碼,N,4,2,6,306_540_540_,3490_
298,1,舒心,Vi,2,0,2,306_,
307,3,合理,Vi,33,20,53,311_318_433_445_453_470_474_544_546_555_663_715_725_819_969_1082_1107_1204_1214_1257_1311_1315_1337_1356_1359_1361_1364_1398_1399_1407_1481_1488_,2195_2244_2245_2258_2259_2421_2623_2734_2734_2950_3059_3107_3132_3163_3255_3256_3295_3333_3486_
308,3,存在,Vi,5,6,11,312_427_546_555_,2428_2769_2770_3098_3118_
308,3,安全,Vi,7,16,23,312_828_830_904_1343_1383_,2324_2492_2576_2585_2616_2651_2654_2931_3083_3084_3084_3132_3310_3448_3453_
308,3,安慶,N,6,4,10,312_326_328_331_333_,2035_2877_2878_
308,3,滿,ADV,18,13,31,308_308_312_312_312_684_746_746_746_873_881_888_896_1039_1086_1311_1315_,2145_2284_2289_2980_3005_3073_3161_3214_3214_3219_3219_3304_
308,3,上鎖,Vi,2,4,6,312_,2585_2669_2742_
308,3,開啟,Vt,2,1,3,312_,
308,3,2樓,N,4,3,7,312_1081_1338_,2770_3098_
309,1,雅,Vi,2,0,2,313_,
310,3,人民幣,N,6,3,9,314_790_903_923_931_,3296_3345_
310,1,安徽,N,3,0,3,314_662_,
310,3,江蘇,N,2,1,3,314_,
310,3,物,N,15,1,16,314_599_608_610_619_647_653_954_983_1193_1254_1272_1275_1371_,
310,3,人民,N,5,3,8,314_395_828_1371_,3074_3372_
315,3,公道,Vi,3,5,8,923_931_,2965_2966_2975_3253_
315,3,地處,Vt,10,7,17,789_991_994_1005_1171_1178_1208_1329_1419_,2308_2483_3112_3163_3267_3483_
316,1,熱水袋,N,1,0,1,,
316,3,太太,N,4,2,6,316_316_1472_,3458_
316,3,不如,Vt,12,37,49,316_552_561_1005_1072_1073_1079_1080_1399_1489_1492_,2050_2053_2115_2118_2283_2417_2419_2436_2442_2450_2453_2517_2519_2616_2679_2700_2701_2707_2708_2809_2824_2826_2828_2874_2879_2880_2899_2906_2923_3025_3027_3141_3233_3239_3276_3415_
316,1,課,N,1,0,1,,
316,1,幸福,Vi,2,0,2,1423_,
316,3,前者,N,2,2,4,316_,2259_
316,3,送來,Vt,29,9,38,550_559_628_628_674_707_707_707_710_710_710_714_714_717_717_717_720_720_720_724_724_1049_1057_1062_1208_1272_1275_1495_,2391_2738_3055_3083_3160_3196_3360_3386_
316,3,後者,N,2,2,4,316_,2259_
316,3,家人,N,5,6,11,836_852_861_1057_,2446_2483_2530_2629_2869_
316,1,胃,N,4,0,4,334_714_724_,
316,3,例,N,1,1,2,,
316,1,權限,N,1,0,1,,
316,1,值班員,N,1,0,1,,
316,1,勵,N,1,0,1,,
316,1,三晉,N,2,0,2,316_,
316,3,一早,ADV,4,10,14,320_321_1212_,2367_2790_2923_3233_3255_3256_3288_3319_3447_
316,3,問候,Vt,8,2,10,521_530_710_720_783_1477_1484_,2756_
316,3,身體,N,8,1,9,887_895_901_982_1028_1029_1030_,
316,3,回復,Vt,3,14,17,1319_1324_,2099_2360_2360_2361_2361_2391_2417_2608_2671_3063_3146_3433_3435_
316,1,榮幸,Vi,2,0,2,982_,
316,1,揣,Vt,1,0,1,,
316,3,接,Vt,9,24,33,335_631_634_707_710_717_720_1083_,2333_2334_2359_2419_2464_2466_2483_2604_2606_2671_2746_2862_2889_2890_2902_2904_2919_2933_3100_3118_3433_3435_3443_
316,1,倍感,Vt,1,0,1,,
316,3,暑假,N,3,1,4,887_895_,
316,1,胃病,N,3,0,3,714_724_,
316,1,健康,Vi,5,0,5,982_1028_1029_1030_,
316,3,夜裡,N,2,10,12,1042_,2095_2097_2164_2175_2272_2324_2861_3001_3132_
316,3,13日,N,3,12,15,434_1031_,2475_2575_2609_2794_2798_2800_3269_3308_3308_3308_3483_
316,1,生動,Vi,1,0,1,,
316,3,順利,Vi,14,3,17,434_436_437_439_442_443_779_923_931_982_1028_1029_1030_,2754_3049_
316,1,犯,Vt,1,0,1,,
316,3,過來,Vi,6,40,46,320_320_906_1106_1114_,2037_2037_2134_2188_2231_2287_2288_2445_2445_2446_2446_2517_2519_2604_2604_2690_2690_2691_2691_2691_2739_2742_2746_2753_2775_2961_2963_3133_3170_3172_3237_3255_3256_3360_3360_3397_3419_3433_3435_
316,3,太原,N,14,3,17,317_321_321_444_445_447_450_451_452_453_455_458_459_,2852_3279_
316,1,閤家,N,1,0,1,,
316,1,今日,N,1,0,1,,
316,1,胃藥,N,1,0,1,,
316,3,祝,Vt,12,2,14,434_436_437_439_442_443_982_1028_1029_1030_1451_,2843_
317,3,花樣,N,2,2,4,983_,2330_
317,1,口感,N,2,0,2,335_,
320,1,垃圾箱,N,1,0,1,,
320,3,衣服,N,20,18,38,320_551_560_701_794_795_797_798_946_1061_1112_1120_1139_1237_1238_1270_1273_1481_1488_,2134_2134_2235_2236_2335_2512_2806_2806_2806_3056_3184_3231_3253_3289_3290_3352_3354_
320,3,垃圾,N,2,21,23,320_,2239_2481_2482_2490_2565_2600_2849_2863_2867_2874_2879_2880_3013_3015_3275_3275_3296_3345_3361_3362_
320,3,有損,Vt,1,1,2,,
320,3,落,Vi,3,1,4,1086_1086_,
320,3,大廈,N,21,12,33,320_320_320_437_494_495_498_835_912_986_1057_1057_1057_1057_1061_1062_1062_1141_1143_1215_,2434_2454_2454_2454_2455_2455_2455_2624_2802_2828_3493_
320,3,合作,Vi,1,19,20,,2095_2097_2124_2137_2141_2345_2350_2363_2613_2782_2852_2852_3083_3146_3345_3371_3373_3374_
320,3,停車費,N,2,7,9,388_,2208_2208_3038_3039_3065_3067_
320,3,倒,ADV,6,21,27,548_557_842_1124_1131_,2097_2219_2221_2264_2360_2361_2537_2538_2855_2856_2945_2945_2946_3085_3146_3295_3310_3391_3393_3422_
320,1,扔掉,Vt,1,0,1,,
320,3,走人,Vi,1,13,14,,2223_2244_2245_2284_2295_2680_2740_2846_3239_3462_3471_3487_
320,3,拿走,Vt,2,9,11,1430_,2220_2222_2225_2226_2914_3074_3495_3497_
320,3,地址,N,5,15,20,870_878_1330_1333_,2426_2480_2525_2861_2861_3065_3067_3170_3170_3170_3172_3172_3172_3360_
320,3,回去,Vi,6,15,21,784_889_897_1112_1120_,2453_2730_2967_2995_3013_3052_3053_3193_3231_3281_3304_3360_3367_3368_
320,3,扔,Vt,1,12,13,,2163_2272_2450_2453_2615_2769_2770_2861_3295_3495_3497_
320,3,幫忙,Vt,14,26,40,339_546_555_566_566_575_575_794_797_842_973_1018_1106_,2206_2220_2220_2220_2222_2222_2222_2231_2232_2390_2529_2544_2587_2739_2756_2816_2816_2818_2818_2869_3020_3146_3185_3233_3341_
320,3,來電話,Vi,1,1,2,,
320,1,認了,Vi,1,0,1,,
320,3,寄回來,Vt,1,7,8,,2902_2902_2904_2904_3052_3053_
320,3,那兒,N,5,6,11,600_609_805_1209_,2116_2119_3004_3480_3482_
320,3,臨走,ADV,2,2,4,1431_,2826_
320,3,生氣,Vi,1,8,9,,2836_2868_3071_3083_3232_3281_3418_
320,3,結果,ADV,34,169,203,320_363_368_460_546_546_546_546_555_555_555_555_674_674_701_710_710_710_720_720_720_738_802_887_889_895_897_902_1025_1106_1348_1425_1430_,2009_2009_2009_2012_2012_2057_2065_2077_2089_2106_2112_2112_2135_2161_2167_2225_2226_2252_2252_2253_2253_2273_2290_2342_2372_2375_2391_2436_2483_2490_2509_2517_2519_2527_2527_2527_2527_2531_2532_2533_2534_2536_2544_2549_2549_2549_2550_2550_2550_2566_2566_2596_2597_2603_2603_2604_2605_2605_2616_2616_2669_2703_2748_2754_2754_2776_2791_2809_2809_2812_2822_2836_2861_2861_2871_2908_2917_2917_2921_2945_2961_2963_3000_3013_3040_3052_3052_3053_3053_3095_3110_3117_3163_3174_3184_3184_3184_3210_3210_3210_3210_3210_3215_3215_3215_3215_3215_3227_3227_3227_3231_3233_3234_3243_3253_3253_3253_3253_3253_3253_3255_3256_3260_3280_3281_3281_3282_3288_3291_3292_3296_3319_3333_3334_3341_3360_3360_3360_3360_3360_3360_3386_3389_3390_3392_3392_3394_3394_3396_3397_3397_3397_3405_3410_3417_3418_3418_3418_3418_3431_3432_3434_3436_3458_3459_3459_3470_3472_
320,3,留,Vt,8,12,20,341_674_710_720_886_894_1002_,2416_2416_2609_2609_2659_2731_2745_2824_2826_3203_3276_
320,1,眼力,N,1,0,1,,
320,3,保安,N,3,26,29,386_746_,2397_2438_2440_2464_2466_2530_2530_2651_2654_2748_2857_2858_2907_3001_3001_3038_3039_3231_3376_3378_3388_3392_3394_3448_3453_
320,3,剔除,Vt,1,1,2,,
320,3,氣憤,Vi,2,30,32,736_,2104_2195_2220_2222_2229_2252_2253_2438_2440_2516_2518_2530_2531_2690_2700_2700_2701_2701_2732_2761_2762_2872_2956_2957_3101_3184_3345_3352_3354_
320,1,聊上,Vt,1,0,1,,
321,3,丟,Vt,3,2,5,1061_1232_,3319_
321,1,工號,N,1,0,1,,
321,3,班機,N,1,3,4,,2375_3272_
321,3,黑車,N,2,4,6,702_,2595_2595_3244_
321,3,查詢,Vt,1,3,4,,2815_3296_
321,1,郵局,N,1,0,1,,
321,1,崔,N,2,0,2,321_,
321,3,回家,Vi,12,9,21,335_710_710_710_720_720_720_793_796_835_999_,2333_2334_2360_2361_2754_2934_2934_3345_
321,3,寄,Vt,2,2,4,1106_,2640_
321,3,當面,ADV,2,5,7,982_,3146_3170_3172_3231_
321,3,難得,Vi,6,4,10,707_707_717_717_1033_,2746_3434_3436_
321,3,核實,Vi,3,2,5,1319_1324_,2869_
321,1,手機號,N,1,0,1,,
321,1,掏錢,Vi,1,0,1,,
321,3,精神,N,1,5,6,,2544_2824_2826_3276_
321,1,項鏈,N,1,0,1,,
322,3,調,N,5,6,11,794_797_891_899_,2874_3142_3296_3376_3378_
322,1,緊促,Vi,1,0,1,,
322,3,促銷價,N,1,1,2,,
323,3,牽強,Vi,1,4,5,,2597_2847_3146_
323,1,歌舞,N,1,0,1,,
323,3,感受,Vt,11,15,26,388_738_769_804_923_931_1029_1032_1271_1274_,2231_2475_2551_2651_2652_2654_2655_2731_2828_3103_3132_3278_3288_3319_
323,1,朝鮮,N,3,0,3,323_1020_,
323,3,料理,N,1,2,3,,2813_
323,3,的確,ADV,12,20,32,640_662_714_724_811_902_990_993_1005_1014_1088_,2175_2314_2317_2609_2769_2770_2807_2847_2852_2933_2997_3119_3124_3324_3480_3482_3487_3495_3497_
323,3,稱作,Vt,1,1,2,,
323,3,下面,N,15,15,30,412_551_560_669_710_720_771_775_785_901_942_1011_1219_1221_,2445_2446_2584_2707_2708_3038_3038_3039_3039_3098_3152_3196_3443_3470_
324,3,道路,N,2,1,3,902_,
324,3,瀋陽,N,5,4,9,586_589_590_1017_,2391_2956_2957_
324,1,不移,Vi,1,0,1,,
324,3,軟件,N,13,11,24,445_453_502_628_842_918_1032_1102_1170_1177_1469_1470_,2070_2229_2252_2253_2388_2636_2836_2873_3367_3368_
324,3,堅定,Vt,1,1,2,,
324,3,成,Vt,8,19,27,790_849_903_923_931_1092_1428_,2073_2104_2147_2200_2232_2252_2253_2325_2400_2402_2582_2675_2677_2744_2773_3249_3319_3332_
324,1,單行線,N,1,0,1,,
325,3,接著,ADV,3,8,11,330_434_,2041_2208_2612_2691_3184_3255_3256_
325,3,為主,Vi,5,7,12,330_334_1437_1437_,2308_2544_2976_3076_3265_3345_
326,1,床面,N,2,0,2,331_,
326,1,異物,N,2,0,2,331_,
326,3,檢查,Vt,3,10,13,331_802_,2253_2391_2498_2671_2815_2873_3446_3478_3478_
326,1,殘留,Vt,2,0,2,331_,
327,3,奇怪,Vt,11,23,34,332_379_481_674_701_901_921_1021_1112_1120_,2183_2360_2361_2450_2450_2453_2453_2516_2518_2528_2625_2731_2838_2976_3111_3205_3232_3254_3313_3319_3319_3359_
328,3,號稱,Vt,6,24,30,333_698_889_897_1028_,2045_2095_2097_2232_2232_2232_2516_2518_2609_2705_2706_2854_2917_3069_3070_3110_3110_3156_3196_3283_3397_3433_3435_
328,3,據說,ADV,26,18,44,333_345_355_446_454_484_493_572_581_594_603_699_754_771_775_783_794_797_888_896_917_1250_1366_1433_1435_,2036_2061_2103_2171_2209_2210_2386_2521_2572_2767_2841_2914_2938_3069_3070_3146_3366_
328,1,迎賓樓,N,4,0,4,333_713_723_,
328,3,計較,Vt,5,2,7,333_886_894_905_,3049_
328,3,訂好,Vt,2,2,4,333_,3415_
328,1,佔地,Vt,2,0,2,333_,
334,3,咱,N,4,1,5,886_894_1207_,
334,3,黃金,N,1,4,5,,2554_2555_2934_
334,3,附樓,N,4,4,8,1038_1439_1444_,2040_3210_3215_
334,1,情調,N,2,0,2,814_,
334,1,展鴻樓,N,1,0,1,,
334,1,賞心悅目,Vi,1,0,1,,
334,1,周剛,N,1,0,1,,
334,3,試試,Vt,9,3,12,446_454_669_751_1204_1208_1211_1250_,2319_2908_
335,3,形容,Vt,2,12,14,779_,2083_2312_2315_2475_2569_2569_2684_2687_3247_3331_3347_
335,1,沒得說,Vi,10,0,10,335_336_707_710_717_720_923_931_946_,
335,1,漂白劑,N,1,0,1,,
335,3,停水,N,2,2,4,1239_,2508_
335,3,走上,Vt,1,1,2,,
335,1,比鄰,Vt,1,0,1,,
335,3,尷尬,Vi,2,6,8,749_,2259_2309_3352_3354_3357_
335,3,亟待,Vt,1,1,2,,
335,3,管道,N,4,8,12,876_884_1337_,2579_2956_2957_3448_3448_3453_3453_
335,3,龍頭,N,6,20,26,374_910_1253_1356_1361_,2267_2272_2508_2508_2569_2814_2824_2826_2854_2986_3095_3352_3354_3433_3433_3433_3435_3435_3435_
335,3,水龍頭,N,5,29,34,630_771_775_1332_,2037_2059_2061_2204_2271_2272_2500_2501_2517_2519_2815_2917_2947_3029_3117_3298_3301_3433_3433_3433_3433_3434_3435_3435_3435_3435_3436_3463_
335,3,中間,N,5,8,13,649_655_1026_1054_,2390_2419_2756_2933_3071_3132_3319_
335,3,完美,Vi,6,4,10,703_705_1182_1188_1498_,2706_2718_2721_
336,3,進門,N,1,9,10,,2126_2272_2414_2454_2455_2582_2636_2934_
336,3,女,N,4,14,18,546_555_957_,2029_2081_2081_2083_2083_2134_2287_2288_2572_2608_2608_3071_3360_
337,3,迎賓,N,2,6,8,804_,2391_2769_2770_2816_2818_
338,3,臨街,N,6,2,8,338_338_986_1418_1431_,2747_
338,3,上車,Vi,4,4,8,842_963_983_,2231_3098_3254_
339,1,臨海,N,1,0,1,,
339,3,預留,Vt,1,3,4,,2174_2908_
339,3,車位,N,3,3,6,339_341_,3132_3132_
339,3,手,N,10,20,30,639_710_711_720_721_889_897_1481_1488_,2232_2419_2445_2446_2452_2572_2609_2754_2754_2769_2770_3280_3288_3289_3290_3295_3321_3322_3385_
339,3,碰,Vt,1,12,13,,2428_3213_3218_3288_3289_3289_3290_3290_3310_3360_3463_
340,3,卡拉,N,1,5,6,,2327_2329_2908_3071_
340,3,商店,N,2,2,4,431_,3015_
340,3,拉,Vt,7,20,27,379_807_891_899_1319_1324_,2127_2167_2295_2344_2349_2521_2521_2742_2855_2856_2867_2976_3110_3352_3354_3360_3360_3360_3447_
340,3,餐館,N,11,5,16,374_410_792_802_820_856_865_889_897_1427_,3022_3023_3333_3385_
341,1,差些,ADV,1,0,1,,
341,1,韓式,N,3,0,3,349_359_,
341,3,穿過,Vt,2,3,5,903_,2734_3360_
341,3,疑惑,Vi,1,2,3,,3076_
341,3,外表,N,4,5,9,544_554_563_,2161_2260_3243_3347_
341,3,換到,Vt,3,11,14,481_817_,2247_2356_2483_2684_2687_2740_2908_2925_3257_3467_
341,1,木炭,N,1,0,1,,
341,3,記住,Vt,3,2,5,521_530_,3435_
341,3,出乎意料,Vi,2,1,3,1423_,
341,1,李朝,N,1,0,1,,
341,1,著名,Vi,1,0,1,,
342,3,路,N,21,28,49,348_352_431_649_655_661_701_702_787_842_902_944_1168_1175_1261_1261_1433_1435_1436_1437_,2139_2143_2151_2272_2360_2361_2547_2584_2795_2883_2976_3047_3051_3065_3067_3100_3103_3108_3109_3186_3188_3213_3218_3307_3418_3431_3432_
342,3,朝向,Vt,4,1,5,352_401_1040_,
342,1,掉下,Vt,2,0,2,352_,
342,1,後山,N,6,0,6,342_352_352_1459_1464_,
342,3,小孩子,N,3,1,4,352_802_,
342,1,危險,Vi,4,0,4,342_352_352_,
342,1,圍,Vt,3,0,3,352_1087_,
342,1,西北,N,5,0,5,342_352_352_1211_,
342,3,協議價,N,2,1,3,352_,
342,3,散步,Vi,9,1,10,352_521_530_607_738_782_783_979_,
342,3,懸崖,N,2,1,3,352_,
342,3,網評,N,2,1,3,352_,
342,3,擋,Vt,2,1,3,352_,
342,3,標房,N,7,24,31,352_519_670_674_674_1252_,2065_2162_2284_2312_2315_2463_2465_2946_2974_2974_2974_3034_3222_3222_3232_3232_3345_3389_3389_3390_3390_3433_3435_
342,1,玩耍,Vi,2,0,2,352_,
342,1,行走,Vi,2,0,2,352_,
342,3,加上,Vt,5,5,10,352_610_619_1020_,2932_3289_3290_3475_
344,1,地角,N,2,0,2,354_,
345,1,拍攝,Vt,2,0,2,355_,
345,1,攝影,N,3,0,3,355_639_,
345,1,董事長,N,2,0,2,355_,
345,1,書籍,N,2,0,2,355_,
345,3,擺,Vt,6,4,10,355_889_897_1491_1494_,2353_2945_3422_
345,1,著作,N,2,0,2,355_,
345,1,合慶,N,10,0,10,347_347_351_351_355_357_357_361_361_,
345,1,編寫,Vt,2,0,2,355_,
346,3,堪稱,Vt,2,2,4,356_,2562_
346,1,裝備,N,2,0,2,356_,
346,3,先進,Vi,5,1,6,346_356_356_1250_,
346,3,商務單,N,6,2,8,351_356_361_1060_1139_,2819_
346,1,少有,Vi,4,0,4,356_929_937_,
346,1,慶,Vt,2,0,2,356_,
347,3,從來,ADV,2,23,25,357_,2287_2288_2360_2361_2425_2428_2445_2446_2592_2611_2680_2739_2861_2961_2963_3038_3039_3071_3132_3255_3256_3306_
347,1,南闖,Vt,2,0,2,357_,
348,3,走出,Vt,4,2,6,855_864_1218_,3354_
348,3,當晚,N,2,15,17,674_,2245_2273_2406_2408_2445_2446_2494_2494_2495_2495_2517_2519_2744_2915_
348,3,路口,N,3,3,6,1141_1143_,2908_3447_
350,1,自駕,Vt,4,0,4,360_388_424_,
351,3,遠處,N,4,1,5,361_828_1020_,
351,1,清澈,Vi,3,0,3,361_1091_,
351,1,小花,N,2,0,2,361_,
351,1,盛開,Vi,2,0,2,361_,
351,3,島,N,4,5,9,361_773_777_,2083_2767_3434_3436_
351,3,走上去,Vi,2,2,4,361_,3410_
351,1,樹,N,2,0,2,361_,
351,3,海水,N,5,3,8,361_669_707_717_,2882_3385_
351,1,小山,N,4,0,4,351_361_361_,
363,1,頭天,N,4,0,4,368_710_720_,
363,1,寒風,N,2,0,2,368_,
363,3,士,N,12,11,23,363_368_368_520_529_728_838_902_917_1112_1120_,2436_2436_2471_2881_2889_2890_3185_3185_3252_3318_
363,3,離,Vt,6,7,13,368_607_813_964_1081_,2615_2656_3012_3205_3479_3481_
363,3,隨時,ADV,8,8,16,368_520_529_677_769_1481_1488_,2090_2595_2761_2762_3318_3431_3432_
363,3,4樓,N,9,3,12,368_707_717_802_1025_1025_1025_1338_,3063_3083_
364,3,真誠,Vi,12,20,32,369_525_534_707_717_982_1309_1313_1319_1324_1419_,2359_2445_2446_2475_2590_2608_2609_2731_2747_2761_2762_2924_3146_3253_3360_3431_3432_3448_3453_
364,1,歸航,Vi,2,0,2,369_,
364,1,打漁,N,2,0,2,369_,
364,1,飛飛,Vi,2,0,2,369_,
364,3,缺乏,Vt,4,6,10,369_613_622_,2809_3032_3033_3246_3388_
364,1,漁港,N,2,0,2,369_,
364,3,不得不,ADV,3,14,17,369_1348_,2534_2725_2740_2740_2753_2816_2818_2861_3371_3389_3390_3392_3394_
364,1,職業化,Vt,2,0,2,369_,
364,1,九月,N,2,0,2,369_,
364,3,客氣,Vi,4,7,11,369_886_894_,2669_2700_2701_2815_3049_3132_
364,3,蒼蠅,N,7,4,11,369_416_1086_1086_1087_1087_,2779_2946_3417_
365,1,07年,N,3,0,3,370_944_,
365,1,大不了,Vi,2,0,2,370_,
365,3,禮品,N,12,5,17,365_370_370_520_529_711_714_721_724_1479_1486_,3038_3039_3039_3055_
366,1,鬆軟,Vi,2,0,2,371_,
373,3,存放,Vt,1,1,2,,
373,1,船票,N,1,0,1,,
373,3,搭,Vt,9,6,15,841_842_849_885_890_893_898_943_,2210_2642_2646_3360_3465_
374,3,地,N,18,32,50,521_530_713_713_723_723_842_844_846_1031_1092_1164_1166_1442_1447_1477_1484_,2233_2395_2421_2483_2565_2589_2679_2731_2828_2864_2976_2976_3019_3047_3051_3083_3142_3145_3203_3204_3231_3289_3290_3304_3345_3391_3392_3393_3394_3417_3487_
374,3,在,Vt,4,6,10,670_732_1115_,2453_2742_3104_3488_3490_
374,1,撐開,Vt,1,0,1,,
374,1,風味,N,3,0,3,1359_1364_,
374,3,住進,Vt,1,9,10,,2518_2814_2828_2861_3195_3329_3358_3458_
374,3,接水,N,1,1,2,,
374,1,市景,N,1,0,1,,
374,3,台灣,N,1,2,3,,3257_
374,3,無意,Vt,2,1,3,461_,
374,3,天花板,N,1,4,5,,2241_3431_3432_
374,3,盆,N,1,1,2,,
374,3,灑,Vt,1,10,11,,2162_2162_2162_2252_2253_2623_2838_3254_3417_
374,3,進去,Vi,6,62,68,628_630_1072_1079_1366_,2039_2041_2043_2045_2090_2269_2290_2338_2387_2549_2550_2576_2606_2718_2721_2753_2769_2770_2796_2824_2826_2846_2866_2909_2910_2923_2923_2956_2957_2987_2995_3012_3055_3059_3076_3085_3095_3098_3182_3183_3187_3189_3196_3207_3210_3215_3232_3289_3290_3318_3324_3347_3369_3370_3376_3376_3378_3378_3452_3457_3478_
375,1,價比,N,3,0,3,642_1147_,
375,1,總體性,N,1,0,1,,
375,3,大潤發,N,1,1,2,,
376,3,差不,N,1,1,2,,
376,3,有夠,ADV,1,2,3,,2132_
376,3,張大,Vt,1,2,3,,3379_
377,1,蔚藍,Vi,1,0,1,,
377,1,業務員,N,1,0,1,,
377,3,傳說,N,6,1,7,379_408_772_776_826_,
377,1,遺忘,Vt,2,0,2,639_,
377,1,盡收眼底,Vi,3,0,3,482_491_,
379,1,新大陸,N,1,0,1,,
379,1,無知,Vi,1,0,1,,
379,3,吸塵器,N,1,2,3,,3076_
379,1,頂樓,N,5,0,5,665_1020_1228_1230_,
379,3,害,Vt,7,15,22,837_871_879_912_1212_1430_,2289_2462_2528_2771_2796_2956_2957_2972_3074_3132_3159_3261_3282_3386_
379,1,抽,Vt,1,0,1,,
379,3,爆,Vi,1,1,2,,
379,3,跳閘,Vi,1,1,2,,
379,1,21樓,N,1,0,1,,
379,3,抹殺,Vt,1,2,3,,2843_
379,3,開關,N,3,4,7,522_531_,3321_3322_3341_
380,1,涼快,Vi,4,0,4,383_872_880_,
381,3,經歷,Vt,2,10,12,384_,2322_2363_2525_2530_2535_2731_2775_2827_3443_
381,1,市委,N,5,0,5,384_980_1141_1143_,
381,1,班子,N,2,0,2,384_,
381,3,開封,N,4,10,14,381_384_384_,2281_2282_2282_3139_3446_3479_3480_3481_3482_
382,3,礦泉水,N,7,11,18,385_395_707_710_717_720_,2240_2386_2387_2573_2584_2812_3032_3033_3397_3477_
382,1,地熱,N,2,0,2,385_,
382,3,老化,Vt,6,11,17,385_731_876_884_1326_,2035_2107_2281_2282_2505_2742_2768_2791_2942_3076_
382,3,用具,N,2,7,9,385_,2434_2492_2528_2651_2654_2980_
386,1,巡邏,Vi,1,0,1,,
386,1,峨眉,N,3,0,3,391_392_,
386,3,關,Vt,2,34,36,660_,2037_2037_2047_2190_2204_2267_2289_2347_2425_2428_2500_2501_2521_2594_2615_2647_2746_2807_2861_3040_3118_3187_3189_3245_3246_3304_3309_3385_3433_3433_3435_3435_3476_
386,3,線路,N,2,1,3,787_,
387,3,恭維,Vt,5,17,22,1010_1087_1088_1091_,2072_2483_2527_2544_2615_2742_2766_2806_2824_2826_2976_3079_3243_3294_3347_3467_
388,1,切身,A,1,0,1,,
388,1,歌,N,1,0,1,,
388,3,說起,Vt,1,1,2,,
388,3,瘋,Vi,1,3,4,,2550_3231_
388,1,美食街,N,3,0,3,599_608_,
390,1,超前,Vt,1,0,1,,
390,1,元旦,N,2,0,2,820_,
390,1,川,N,1,0,1,,
390,1,捏腳,N,1,0,1,,
390,3,強,Vi,4,9,13,504_540_1436_,2564_3115_3162_3182_3183_3431_3432_3463_
390,1,妹子,N,1,0,1,,
390,1,細心,Vi,13,0,13,484_493_522_531_710_720_731_944_1005_1061_1129_1136_,
390,1,泡上,Vt,4,0,4,390_551_560_,
390,1,前住,Vt,1,0,1,,
391,3,讚,Vi,5,3,8,500_788_1228_1230_,3223_3418_
391,1,天頤,N,2,0,2,391_,
391,1,逃過,Vt,1,0,1,,
391,3,多多,ADV,4,6,10,1319_1324_1409_,2083_3009_3010_3246_3465_
391,3,久,Vi,14,34,48,641_793_793_796_796_869_877_902_924_932_1203_1253_1366_,2194_2232_2333_2334_2342_2391_2490_2521_2534_2534_2561_2562_2574_2608_2647_2815_2851_2855_2856_3167_3168_3169_3182_3183_3231_3288_3333_3333_3367_3368_3470_3480_3482_
391,3,表現,Vt,4,2,6,618_627_944_,2654_
391,1,撤銷,Vt,1,0,1,,
391,3,進,Vt,17,86,103,481_548_557_629_677_714_714_724_724_990_993_1020_1062_1411_1416_1425_,2037_2047_2058_2059_2135_2139_2143_2147_2186_2231_2244_2245_2272_2312_2315_2324_2340_2341_2342_2360_2360_2361_2361_2384_2390_2492_2492_2492_2505_2516_2517_2518_2519_2531_2531_2561_2562_2579_2606_2631_2714_2718_2721_2731_2740_2790_2798_2800_2809_2828_2872_2907_2928_2934_2961_2963_3047_3051_3065_3067_3083_3083_3083_3085_3114_3146_3186_3186_3188_3188_3195_3195_3196_3232_3253_3309_3332_3344_3344_3369_3370_3382_3386_3478_3478_
391,1,冰天雪地,Vi,1,0,1,,
391,1,基本功,N,1,0,1,,
391,1,中規中矩,Vi,5,0,5,424_553_562_957_,
391,1,拉門,N,1,0,1,,
391,1,宴會廳,N,2,0,2,1018_,
391,3,嫌,Vt,3,3,6,872_880_,3076_3159_
391,3,如此,Vi,12,25,37,546_555_630_674_714_724_845_915_1203_1257_1500_,2035_2174_2175_2243_2247_2344_2349_2528_2571_2698_2731_2889_2890_2928_2996_3049_3087_3107_3115_3115_3423_3424_3433_3435_
391,3,旁,N,5,7,12,610_619_847_1007_,2103_2124_2967_3401_3405_3410_
391,3,馬上,ADV,31,39,70,521_530_610_619_628_630_707_710_710_710_711_714_717_720_720_720_721_724_743_835_887_895_1066_1155_1162_1240_1272_1275_1398_1407_,2372_2375_2383_2398_2464_2466_2504_2517_2519_2724_2747_2748_2775_2775_2775_2815_2873_2925_2934_2946_2976_3038_3039_3073_3083_3098_3132_3142_3253_3347_3431_3431_3432_3432_3433_3433_3435_3435_
391,1,山大,N,1,0,1,,
391,3,成功,Vi,2,4,6,1061_,2128_2852_3146_
391,1,做成,Vt,3,0,3,1124_1131_,
391,3,沖,Vt,6,12,18,550_559_713_723_1367_,2345_2350_2733_2740_3353_3355_3428_3433_3435_3451_3456_
391,1,峨眉山,N,4,0,4,391_391_391_,
391,1,情侶檔,N,1,0,1,,
391,1,熱水澡,N,1,0,1,,
392,1,報國寺,N,1,0,1,,
392,1,迷宮,N,1,0,1,,
392,1,人性價,N,1,0,1,,
392,1,瑜珈,N,1,0,1,,
393,1,開穿,Vt,1,0,1,,
393,3,江,N,12,8,20,393_394_395_424_427_431_433_1020_1264_1304_1307_,2178_2636_2822_2997_3007_3132_3132_
393,1,大佛,N,2,0,2,396_,
394,3,召開,Vt,1,6,7,,2608_2609_2857_2858_3308_
394,1,特色菜,N,1,0,1,,
394,3,大型,N,5,2,7,642_1070_1077_1250_,2908_
394,1,豆腐,N,2,0,2,1042_,
394,3,吃到,Vt,2,5,7,1457_,2769_2770_2908_2923_
394,3,會議,N,6,16,22,568_577_830_1005_1088_,2494_2495_2609_2776_2857_2858_2960_2962_3005_3007_3040_3044_3048_3246_3265_
394,1,西壩,N,1,0,1,,
394,3,魚,N,4,7,11,1113_1121_1367_,2770_2798_2800_2945_2946_3323_
394,1,三江魚,N,1,0,1,,
395,1,敲詐,Vt,1,0,1,,
395,3,價,N,4,12,16,888_896_1020_,2390_2595_2864_2988_3197_3199_3364_3372_3414_3423_3424_
395,1,問問,Vt,1,0,1,,
395,3,桶裝,A,1,2,3,,2096_
395,1,成就,N,2,0,2,1329_,
395,1,換小,Vt,1,0,1,,
395,1,當心,Vt,1,0,1,,
395,1,樂山,N,1,0,1,,
396,3,剝落,Vi,1,5,6,,2359_2790_2824_2826_
396,1,天文,N,1,0,1,,
396,3,油漆,N,1,2,3,,2444_
396,3,木頭,N,1,4,5,,2037_3451_3456_
396,1,望遠鏡,N,3,0,3,1410_1415_,
397,1,籠頭,N,1,0,1,,
397,1,均勻,Vi,1,0,1,,
397,3,整齊,Vi,6,1,7,640_738_1018_1056_1452_,
398,1,首選,N,14,0,14,445_453_714_714_724_724_811_856_865_1044_1171_1178_1451_,
399,1,常駐,Vi,1,0,1,,
399,3,變成,Vt,5,7,12,611_620_885_893_,2209_2210_2499_2748_3389_3390_
400,3,毛巾,N,11,76,87,707_710_710_717_720_720_1270_1273_1296_1300_,2039_2041_2043_2045_2144_2145_2190_2195_2195_2211_2274_2382_2388_2391_2419_2517_2519_2532_2533_2541_2549_2550_2573_2578_2745_2756_2769_2769_2770_2770_2773_2790_2852_2854_2888_2892_2892_2967_2969_2971_2987_3029_3072_3094_3108_3108_3109_3109_3114_3137_3141_3152_3160_3174_3213_3218_3234_3254_3289_3290_3293_3310_3350_3350_3385_3403_3408_3443_3446_3446_3452_3457_3458_3458_3459_
400,3,床單,N,4,61,65,1066_1141_1143_,2040_2059_2071_2109_2163_2163_2209_2210_2228_2244_2245_2247_2258_2258_2259_2259_2280_2354_2354_2355_2355_2382_2532_2533_2543_2544_2546_2549_2549_2549_2549_2550_2550_2550_2550_2600_2872_2946_2951_2976_3030_3061_3069_3070_3168_3169_3171_3173_3184_3202_3202_3202_3203_3205_3207_3293_3397_3445_3446_3470_
401,3,降低,Vt,1,2,3,,2410_
401,3,飯,N,7,7,14,917_1114_1238_1296_1300_1472_,2411_2450_2453_2782_3034_3365_
401,3,方向,N,3,5,8,662_902_,3246_3266_3448_3453_
404,1,指定,Vt,1,0,1,,
404,1,姐,N,1,0,1,,
405,3,古典,Vi,1,2,3,,2706_
405,1,見不著,Vt,1,0,1,,
405,3,數碼,N,2,1,3,812_,
405,3,現代,Vi,4,1,5,433_814_1201_,
405,3,產品,N,2,5,7,435_,3246_3352_3354_3385_
406,3,天津,N,4,13,17,540_701_702_,2112_2175_2175_2516_2518_2525_2525_2525_2596_2597_3159_3445_
407,3,豐田,N,1,1,2,,
407,1,英國,N,1,0,1,,
407,1,倍兒多,Vi,1,0,1,,
407,1,西門子,N,3,0,3,407_1423_,
407,3,總共,ADV,4,9,13,522_531_799_,2245_2287_2288_2623_2642_2646_3331_3360_
407,3,糟糕,Vi,2,50,52,1358_,2063_2233_2267_2333_2333_2334_2334_2403_2454_2455_2530_2530_2549_2550_2574_2586_2596_2596_2597_2597_2703_2725_2731_2831_2832_2851_2882_2909_2910_3022_3023_3205_3205_3213_3218_3242_3254_3254_3254_3255_3256_3257_3265_3287_3288_3288_3371_3413_3418_
408,1,述,Vt,1,0,1,,
408,3,重,Vi,10,19,29,419_610_619_811_1371_1371_1374_1408_1413_,2052_2202_2325_2576_2857_2858_2915_2952_2976_3186_3188_3224_3255_3256_3274_3341_3383_3384_
408,1,帥,Vi,1,0,1,,
408,1,洋氣,N,1,0,1,,
408,3,油漆味,N,3,3,6,1005_1006_,2740_3396_
408,1,一兩點鐘,N,1,0,1,,
408,3,上班,Vi,2,3,5,999_,2771_3237_
408,1,進展,N,1,0,1,,
408,3,男,N,5,17,22,522_531_984_1423_,2276_2637_2638_2731_2731_2731_2746_2746_2753_3115_3146_3279_3360_3360_3386_3400_
408,3,車聲,N,1,4,5,,3431_3432_3432_
408,3,5樓,N,8,9,17,408_745_871_873_879_881_1089_,2259_3119_3124_3239_3239_3260_3431_3432_
409,3,微笑,Vi,20,5,25,438_525_534_707_707_707_713_714_717_717_717_723_724_912_1112_1120_1168_1175_1419_,2501_2942_3055_3360_
410,1,老字號,N,2,0,2,835_,
410,3,銀川,N,2,2,4,412_,3466_
410,3,過得去,Vi,6,8,14,743_904_1218_1326_1341_,2647_2647_2863_3085_3150_3245_3323_
410,1,好容易,ADV,1,0,1,,
411,3,收錢,Vi,1,7,8,,2361_2695_2705_2706_3264_3313_
411,3,冰箱,N,9,11,20,773_777_813_889_897_910_1007_1430_,2198_2490_2553_2759_3038_3038_3039_3039_3293_3425_
412,1,要道,N,1,0,1,,
412,3,肉,N,1,1,2,,
412,1,老毛,N,1,0,1,,
412,1,閣北街,N,1,0,1,,
412,1,農貿,N,1,0,1,,
412,3,車流聲,N,1,1,2,,
412,1,玉皇,N,1,0,1,,
412,3,市場,N,4,13,17,517_540_1098_,2143_2497_2824_2824_2826_2826_2828_3056_3369_3370_3414_3499_
412,1,抓,Vt,1,0,1,,
412,3,購買,Vt,3,2,5,901_907_,3243_
412,3,品嚐,Vt,3,1,4,657_988_,
412,1,應季,N,1,0,1,,
412,3,鼓樓,N,3,2,5,1151_1158_,3482_
412,1,瓜果,N,1,0,1,,
413,3,聊天,Vi,1,19,20,,2016_2016_2072_2281_2282_2534_2731_2769_2770_2915_3007_3150_3150_3150_3150_3231_3308_3319_
413,3,漳州,N,1,1,2,,
413,3,地區,N,9,4,13,677_846_901_967_1150_1157_1164_1166_,2450_2453_2951_
413,3,海鮮,N,9,7,16,642_901_1086_1316_1320_1321_1325_1425_,2102_2797_2861_3272_3347_3360_
413,1,排檔,N,1,0,1,,
413,3,幹活,Vi,1,2,3,,3341_
416,3,叮,Vt,1,1,2,,
417,1,抱有,Vt,1,0,1,,
417,3,能不能,ADV,2,14,16,1020_,2767_2816_2818_3049_3107_3119_3124_3227_3243_3433_3435_3451_3456_
417,3,想要,Vt,4,5,9,1201_1319_1324_,2008_2009_2322_3253_
418,3,購物點,N,3,1,4,885_893_,
418,1,賣場,N,2,0,2,498_,
418,1,右,N,1,0,1,,
418,1,茵膽平肝,N,1,0,1,,
418,1,片仔黃,N,1,0,1,,
418,3,拐,Vt,2,2,4,418_,2973_
418,1,膠囊,N,1,0,1,,
418,3,藥店,N,3,4,7,1311_1315_,2816_2818_2818_
419,3,星期,N,1,4,5,,2061_2776_3276_
419,3,己經,ADV,1,1,2,,
419,1,開闊,Vt,1,0,1,,
422,1,質數,N,1,0,1,,
422,3,酒樓,N,5,1,6,901_917_967_1338_,
422,1,快活,Vi,1,0,1,,
422,1,上檔,Vi,2,0,2,974_,
422,3,郊區,N,2,1,3,1437_,
422,3,白,Vi,3,13,16,871_879_,2516_2518_2753_2945_2971_3072_3205_3274_3310_3409_3451_3456_
422,1,出品,Vt,1,0,1,,
422,1,所處,N,2,0,2,738_,
422,3,具有,Vt,3,2,5,711_721_,3345_
422,1,好聽,Vi,1,0,1,,
422,3,汕頭,N,2,1,3,732_,
422,1,海鮮城,N,1,0,1,,
423,1,超5星,N,1,0,1,,
423,3,致命,Vi,1,2,3,,3189_
424,1,物美價廉,Vi,3,0,3,1041_1218_,
424,1,醒目,Vi,1,0,1,,
424,3,心理,N,2,7,9,1423_,2550_2731_3103_3253_3319_3344_
424,1,入流,Vi,1,0,1,,
424,3,路邊,N,3,6,9,703_705_,2584_2748_2934_3089_3277_
425,3,17日,N,8,6,14,426_427_428_888_896_1319_1324_,2005_2086_2445_2446_3049_
426,1,士大,N,1,0,1,,
427,1,長江,N,2,0,2,1269_,
427,3,擺設,Vt,2,6,8,904_,2054_2147_2280_2512_3397_
427,3,打擾,Vt,7,8,15,520_529_982_982_1169_1176_,2047_2047_2471_2674_2872_3091_3341_
427,3,自行車,N,1,9,10,,2053_2714_2945_2993_2994_3038_3039_3205_
427,3,共住,Vt,1,3,4,,3495_3497_
427,3,九江,N,3,1,4,427_676_,
427,1,照顧,Vt,3,0,3,714_724_,
427,1,洲,N,1,0,1,,
427,3,標準房,N,1,8,9,,2324_2717_2720_3210_3210_3215_3215_
427,1,格外,ADV,1,0,1,,
427,3,健身房,N,4,3,7,648_654_745_,2436_3258_
427,1,尾數,N,1,0,1,,
428,3,現已,ADV,1,4,5,,2005_3168_3169_
428,1,植,Vt,1,0,1,,
429,3,通話,Vi,1,2,3,,3435_
429,3,黃山,N,4,3,7,677_1423_1423_,2377_3225_
429,1,機轉,N,1,0,1,,
431,1,商品,N,1,0,1,,
431,1,專賣,Vt,1,0,1,,
431,3,斜對面,N,8,2,10,521_530_940_1194_1218_1320_1325_,3318_
432,3,速,Vi,4,9,13,772_776_1005_,2829_2845_2959_3007_3202_3388_3391_3393_
432,1,步驟,N,1,0,1,,
433,3,天天,ADV,5,5,10,872_880_889_897_,2759_2863_2951_3458_
433,3,凱萊,N,1,1,2,,
433,3,華,N,1,1,2,,
433,3,哈爾濱,N,2,5,7,433_,2070_2126_2806_3414_
433,1,融,Vi,1,0,1,,
433,3,順,Vi,1,1,2,,
433,1,餘下,Vt,1,0,1,,
433,1,數,Vt,1,0,1,,
433,3,色調,N,5,3,8,663_1026_1481_1488_,3353_3355_
433,3,金谷,N,1,1,2,,
433,1,華旗,N,1,0,1,,
433,1,排到,Vt,1,0,1,,
433,3,福,N,1,2,3,,2967_
434,1,終究,ADV,1,0,1,,
434,3,查看,Vt,3,10,13,885_893_,2161_2162_2384_2436_2582_2724_3233_3308_3470_
434,3,原則,N,2,1,3,515_,
434,1,舒暢,Vi,4,0,4,443_794_797_,
434,1,清涼,Vi,5,0,5,520_529_707_717_,
434,1,共同,ADV,1,0,1,,
434,3,弄得,Vt,2,8,10,1409_,2097_2798_2800_2862_2883_2922_3331_
434,3,便,ADV,4,12,16,1020_1411_1416_,2180_2180_2280_2609_2609_2609_2609_2609_3185_3433_3435_
434,1,選項,N,1,0,1,,
434,1,鶴,N,1,0,1,,
434,1,便箋,N,1,0,1,,
434,1,綠豆湯,N,2,0,2,442_,
434,3,予以,ADV,5,1,6,438_439_441_515_,
434,3,撥,Vt,1,5,6,,2095_2097_2097_3257_
434,3,插曲,N,6,1,7,434_779_889_897_1337_,
434,3,貌似,Vt,2,1,3,1472_,
434,3,謝絕,Vt,1,1,2,,
434,1,猜想,Vt,1,0,1,,
434,3,認可,Vt,4,2,6,438_439_441_,3231_
434,3,一會兒,N,3,7,10,434_1473_,2551_2551_2604_2671_2742_3103_
434,3,特殊,Vi,4,7,11,434_434_1106_,2136_2140_2387_2923_3431_3432_
434,1,國賓,N,9,0,9,436_437_437_438_439_441_442_443_,
434,3,提議,N,1,1,2,,
434,1,一頭霧水,Vi,1,0,1,,
435,3,次要,A,2,1,3,1497_,
435,3,體驗,Vt,3,2,5,792_1032_,3087_
435,1,大塊頭,N,1,0,1,,
435,3,餐券,N,3,8,11,518_1096_,2037_2534_2534_2615_2615_2864_2986_
435,1,抵,Vt,6,0,6,788_872_880_944_1020_,
435,3,來得及,ADV,5,1,6,710_720_923_931_,
436,3,生活,N,9,4,13,437_439_783_792_1124_1131_1211_1251_,2720_3087_3312_
436,3,石家莊,N,3,1,4,437_517_,
436,3,管家,N,1,1,2,,
437,3,奧運,N,5,4,9,520_529_708_718_,2582_2923_3282_
437,3,研究,Vt,1,2,3,,2721_
437,1,簡化,Vt,1,0,1,,
437,3,31日,N,14,5,19,438_439_440_1169_1170_1171_1172_1173_1176_1177_1178_1179_1180_,2317_2862_2877_2878_
437,3,世紀,N,9,7,16,515_515_516_517_517_1249_1251_1254_,3076_3171_3173_3383_3384_3385_
437,1,繁鎖,Vi,1,0,1,,
438,3,今晚,N,1,3,4,,2518_2746_
439,3,負,Vt,2,1,3,439_,
439,3,停車位,N,1,1,2,,
439,1,有限,Vi,1,0,1,,
439,1,門前,N,1,0,1,,
439,1,抵現券,N,1,0,1,,
439,3,後院,N,1,2,3,,2440_
441,1,售完,Vt,1,0,1,,
441,3,3日,N,1,9,10,,2057_2111_2516_2518_2672_2857_2858_2941_
441,3,熱切,Vi,1,1,2,,
442,1,紙鶴,N,1,0,1,,
442,1,問候卡,N,1,0,1,,
442,1,出家,Vi,1,0,1,,
442,3,25日,N,9,13,22,588_590_795_798_800_983_1057_1088_,2623_2624_2700_2701_2779_3159_3254_3257_3288_3433_3435_3444_
443,1,跤,N,1,0,1,,
443,1,幸,ADV,1,0,1,,
443,3,摔,Vt,1,3,4,,2232_2609_
443,1,大礙,N,2,0,2,783_,
443,3,方案,N,1,2,3,,3466_
445,3,正門,N,4,2,6,453_890_898_,3040_
447,1,太原市,N,2,0,2,455_,
447,3,顯然,ADV,5,5,10,455_1319_1324_1384_,2097_2517_2519_2522_
447,1,橫向,ADV,2,0,2,455_,
448,3,調到,Vt,2,4,6,456_,2773_3174_3473_
449,3,利,N,2,3,5,457_,3495_3497_
450,3,山西,N,2,3,5,458_,2133_2183_
451,3,相稱,Vi,3,2,5,459_1059_,3110_
451,3,極其,ADV,6,36,42,459_710_720_1441_1446_,2012_2014_2014_2124_2267_2368_2369_2457_2494_2495_2521_2585_2608_2608_2652_2655_2680_2691_2740_2759_2803_2867_2871_2950_3226_3361_3362_3433_3433_3435_3435_3451_3456_3480_3482_
451,3,協調,Vt,5,5,10,459_910_1007_1018_,2252_2253_2309_2771_
451,3,氣味,N,5,21,26,459_1139_1346_1455_,2175_2225_2226_2267_2304_2307_2325_2363_2363_2367_2444_2483_2714_2742_2802_2965_2966_3087_3141_3319_
451,3,單獨,ADV,10,3,13,459_480_489_714_724_749_856_865_1092_,2193_2802_
460,3,大雨,N,3,3,6,793_796_,3274_3467_
460,3,新來,Vi,1,2,3,,3115_
460,3,淋,Vt,3,1,4,888_896_,
460,1,雨水,N,1,0,1,,
460,3,只好,ADV,17,43,60,546_546_555_555_612_621_636_638_886_889_894_897_1232_1294_1298_1430_,2061_2161_2162_2175_2232_2391_2425_2428_2436_2528_2604_2608_2669_2740_2742_2769_2770_2841_2846_2971_3013_3013_3065_3067_3083_3084_3132_3185_3195_3196_3213_3218_3289_3290_3294_3319_3337_3360_3431_3432_3443_3459_
462,3,不滿,Vt,1,4,5,,2812_2851_2928_
465,1,五指山,N,2,0,2,465_,
466,3,說明,N,14,59,73,481_681_682_714_724_749_924_932_1169_1176_1224_1226_1234_,2134_2139_2143_2193_2201_2208_2237_2238_2318_2319_2360_2361_2426_2454_2455_2467_2468_2483_2574_2609_2700_2701_2746_2752_2754_2754_2754_2757_2757_2758_2758_2775_2779_2816_2818_2865_2872_2885_2887_2965_2966_2979_3049_3049_3076_3098_3139_3146_3182_3183_3253_3255_3255_3255_3256_3256_3256_3360_
466,3,網站,N,9,20,29,681_682_857_866_1032_1224_1226_1234_,2237_2238_2267_2309_2342_2342_2417_2467_2468_2475_2574_2779_2865_2965_2966_2979_3182_3183_3245_
466,3,英才,N,6,13,19,681_682_1224_1226_1234_,2237_2238_2467_2468_2574_2779_2865_2965_2966_2979_3182_3183_
466,3,索引,N,6,13,19,681_682_1224_1226_1234_,2237_2238_2467_2468_2574_2779_2865_2965_2966_2979_3182_3183_
466,3,誠聘,Vt,6,13,19,681_682_1224_1226_1234_,2237_2238_2467_2468_2574_2779_2865_2965_2966_2979_3182_3183_
467,3,好久,Vi,1,8,9,,2005_2009_2209_2210_3223_3383_3384_
467,1,餘地,N,2,0,2,1054_,
468,3,嘗試,Vt,8,7,15,469_472_473_923_931_1436_1497_,2517_2519_3187_3187_3189_3189_
469,3,風情,N,2,1,3,473_,
469,3,民族,N,4,2,6,473_1333_1371_,3458_
469,1,篇,N,2,0,2,473_,
470,3,攜帶,Vt,2,2,4,474_,3462_
470,1,帶單,N,2,0,2,474_,
470,3,小孩,N,10,21,31,474_669_669_813_872_880_1057_1443_1448_,2393_2445_2445_2446_2446_2483_2483_2483_2483_2629_2776_2934_2934_3162_3352_3354_3423_3423_3424_3424_
470,3,不變,Vi,2,1,3,474_,
471,3,實話,N,4,8,12,475_1124_1131_,2777_2824_2826_3205_3249_3360_3360_
471,3,看看,Vt,12,24,36,475_546_555_630_710_720_956_962_1099_1211_1239_,2232_2392_2463_2465_2680_2707_2708_2733_2761_2762_2807_2816_2818_2872_2907_2976_3055_3083_3098_3103_3227_3319_3470_
471,1,醉,Vi,2,0,2,475_,
471,3,市,N,3,10,13,475_481_,2320_2509_2579_2698_3032_3033_3065_3067_3163_
471,1,清醒,Vi,2,0,2,475_,
471,1,游泳館,N,6,0,6,475_1249_1249_1250_1250_,
476,1,聽起來,ADV,2,0,2,485_,
476,3,牛,N,2,7,9,485_,2081_2083_2083_2359_2537_2538_
477,3,客觀,Vi,6,15,21,486_630_1211_1211_1211_,2134_2161_2193_2314_2317_2362_2525_2551_2671_2815_2924_3264_3296_3418_
477,3,得知,Vt,2,4,6,486_,2857_2858_3360_
477,1,頭銜,N,2,0,2,486_,
477,1,無愧,Vi,2,0,2,486_,
477,1,落伍,Vi,2,0,2,486_,
478,3,濟南,N,8,7,15,482_482_484_487_491_491_493_,3013_3013_3255_3255_3256_3256_
478,3,自帶,N,3,3,6,487_658_,3108_3109_
480,1,法式,A,2,0,2,489_,
480,1,封門,N,2,0,2,489_,
481,3,公寓,N,2,19,21,1418_,2519_2554_2555_2621_2730_2872_3055_3103_3187_3189_3232_3294_3295_3345_3427_3427_3427_3427_
481,1,餿臭,Vi,1,0,1,,
481,1,吐出來,Vi,1,0,1,,
481,1,把握,N,1,0,1,,
481,3,忍無可忍,Vi,1,3,4,,2511_2691_
481,3,暈,Vi,4,34,38,630_823_1202_,2059_2075_2126_2149_2197_2273_2392_2492_2771_2791_2824_2826_2879_2880_2945_2959_2961_2963_2997_3034_3041_3103_3110_3195_3289_3290_3307_3331_3364_3383_3384_3434_3436_
481,1,39樓,N,1,0,1,,
481,3,做飯,Vi,1,2,3,,3293_
481,1,23樓,N,4,0,4,481_1020_1251_,
481,3,快要,ADV,2,1,3,1145_,
481,1,24樓,N,1,0,1,,
482,3,雜誌,N,4,1,5,491_1070_1077_,
482,1,泉城,N,2,0,2,491_,
482,1,銀座,N,2,0,2,491_,
482,1,浴鹽,N,2,0,2,491_,
482,1,大明湖,N,2,0,2,491_,
482,1,棉,N,2,0,2,491_,
482,3,好看,Vi,3,3,6,491_1085_,2031_3347_
483,3,接收,Vt,2,1,3,492_,
484,1,夜床,N,2,0,2,493_,
494,3,西藏,N,3,3,6,495_498_,2226_2892_
494,3,造成,Vt,8,16,24,516_568_577_1054_1124_1131_1423_,2210_2252_2253_2363_2406_2408_2759_2761_2762_3160_3226_3296_3462_3466_3466_
494,3,住進來,Vi,1,1,2,,
495,1,年頭,N,3,0,3,1114_1201_,
495,3,受不了,Vt,6,20,26,710_720_1087_1258_1455_,2019_2272_2284_2320_2383_2560_2587_2611_2830_2898_3102_3265_3392_3394_3431_3431_3432_3432_3478_
495,3,雙層,A,4,7,11,662_966_1431_,2141_2299_2302_2634_3487_3487_
497,1,目的地,N,1,0,1,,
498,3,熟悉,Vt,7,4,11,830_888_896_902_916_944_,3458_3495_3497_
498,1,物美大,N,1,0,1,,
499,3,壓抑,Vt,3,6,9,870_878_,2452_2817_2819_3108_3109_
499,3,衣櫃,N,1,8,9,,2445_2446_3237_3278_3278_3434_3436_
499,3,定位,N,2,1,3,701_,
499,3,浴袍,N,5,2,7,851_860_1277_1284_,2872_
499,3,匹配,Vi,1,1,2,,
499,3,農村,N,1,1,2,,
499,1,比標,N,1,0,1,,
499,3,簡陋,Vi,6,43,49,773_777_1333_1411_1416_,2101_2102_2184_2211_2235_2236_2243_2339_2426_2514_2547_2548_2564_2566_2585_2651_2654_2731_2742_2828_2830_2871_2882_2893_2975_2975_3019_3020_3065_3067_3197_3199_3305_3327_3364_3364_3433_3434_3435_3436_3451_3456_
500,3,規模,N,4,1,5,1173_1180_1290_,
500,3,看上去,ADV,5,12,17,947_1088_1163_1165_,2342_2484_2619_2620_2626_2771_2822_3030_3249_3460_3477_
501,3,勉強,Vi,5,20,25,1001_1013_1491_1494_,2071_2124_2224_2387_2387_2387_2483_2547_2713_2740_2816_2818_2956_2957_3083_3165_3312_3434_3436_
502,3,不及,Vt,1,2,3,,2870_
502,1,中州,N,2,0,2,502_,
502,3,皇冠,N,3,3,6,502_506_,2917_3364_
502,3,感想,N,1,3,4,,2813_3160_
503,1,溫水,N,1,0,1,,
503,3,帶上,Vt,1,2,3,,3265_
503,1,泡澡,N,1,0,1,,
503,1,泳衣,N,2,0,2,1106_,
504,3,能力,N,3,7,10,540_1423_,2671_2750_2750_2882_3162_3177_
504,3,搞定,Vt,6,4,10,520_529_700_1090_1366_,2361_2855_2856_
505,1,達車,N,1,0,1,,
505,3,辦法,N,2,32,34,846_,2083_2104_2124_2195_2391_2564_2569_2816_2818_2828_2872_2881_2961_2963_3038_3039_3056_3073_3105_3110_3196_3281_3281_3281_3327_3327_3434_3436_3470_3470_3478_
505,3,關鍵,N,3,6,9,906_1329_,2438_2440_2872_2976_3195_
505,3,有一點點,ADV,2,2,4,1328_,2649_
506,1,木質,N,1,0,1,,
506,3,門框,N,1,5,6,,3289_3290_3318_3318_
506,1,比中州,N,1,0,1,,
506,3,性,N,1,4,5,,2316_2771_3363_
506,3,次,Vt,1,1,2,,
507,3,清楚,Vi,7,44,51,838_1203_1211_1394_1403_1430_,2019_2069_2081_2083_2225_2226_2252_2253_2309_2376_2445_2445_2446_2446_2681_2690_2719_2722_2759_2769_2770_2795_2846_2872_2933_3083_3117_3146_3161_3174_3187_3189_3267_3278_3278_3319_3341_3352_3354_3433_3435_3448_3453_
508,1,天河城,N,1,0,1,,
508,1,離琶洲展館,N,1,0,1,,
508,3,健身,Vi,1,1,2,,
509,1,寧夏,N,2,0,2,511_,
512,1,回應,Vt,1,0,1,,
512,1,北街,N,1,0,1,,
513,3,缺,Vt,2,2,4,630_,3487_
514,1,快捷味,N,1,0,1,,
515,1,入微,Vi,1,0,1,,
515,1,河北,N,4,0,4,516_517_517_,
516,3,客史,N,2,1,3,516_,
516,3,不可以,ADV,3,8,11,832_1217_,2630_2761_2762_3049_3065_3067_3115_
516,3,錄,Vt,1,1,2,,
516,3,開窗,N,3,5,8,516_820_,2205_3270_3480_3482_
516,1,入到,Vt,1,0,1,,
516,3,溝通,Vt,5,8,13,778_857_866_1100_,2342_2731_2816_2818_2924_3076_3334_
517,3,接下來,ADV,1,5,6,,2798_2800_3433_3435_
517,1,運營,Vi,1,0,1,,
517,1,逐,Vt,1,0,1,,
517,3,門鈴,N,1,3,4,,2908_3231_
517,1,私享,Vt,1,0,1,,
517,3,完畢,Vi,3,6,9,546_555_,2445_2446_2446_2702_3319_
517,1,2000年,N,1,0,1,,
517,3,睡好,Vi,2,10,12,697_,2408_2639_2756_2932_3144_3261_3262_3263_3483_
518,1,亂亂,Vi,2,0,2,1335_,
518,3,亂哄哄,Vi,1,5,6,,2281_2282_2442_3499_
520,3,悄悄,ADV,2,2,4,529_,2301_
520,1,延長,Vt,2,0,2,529_,
520,1,小吃區,N,2,0,2,529_,
520,1,入座,Vi,2,0,2,529_,
520,1,一一,ADV,2,0,2,529_,
520,1,送至,Vt,2,0,2,529_,
520,3,請勿,N,4,3,7,529_1169_1176_,2047_2047_
520,3,物品,N,10,27,37,529_540_889_897_1025_1054_1054_1220_1222_,2045_2163_2232_2244_2245_2337_2553_2640_2640_2679_2680_2842_2843_2872_2872_2873_3083_3084_3084_3084_3279_3296_3316_3360_3462_3462_
520,3,驚喜,Vi,7,2,9,529_629_801_814_1106_1419_,3454_
520,3,遺漏,Vi,2,3,5,529_,2226_2731_
520,3,觀看,Vt,4,2,6,529_1183_1189_,2616_
520,1,南普陀,N,2,0,2,529_,
520,1,問卷,N,3,0,3,529_1257_,
520,3,廈門,N,24,9,33,520_520_520_521_521_522_524_524_528_528_529_529_529_529_530_530_531_533_533_537_537_1469_1470_,2305_2308_2308_2309_3202_3268_3434_3436_
520,3,遞,Vt,2,1,3,529_,
520,1,廈,N,4,0,4,521_529_530_,
520,3,查找,Vt,2,2,4,529_,2858_
520,1,牌號,N,2,0,2,529_,
520,3,飛機,N,15,23,38,521_529_530_634_674_710_710_720_720_1082_1316_1321_1469_1470_,2292_2353_2700_2701_2784_2798_2800_3013_3013_3084_3101_3159_3159_3184_3193_3195_3231_3337_3360_3433_3435_3462_
520,1,收看,Vt,2,0,2,529_,
520,3,座位,N,4,1,5,529_842_967_,
520,3,引導,Vt,2,1,3,529_,
520,3,便於,Vt,5,2,7,520_529_529_763_,3048_
520,1,輪渡,N,4,0,4,524_529_533_,
521,1,打理,Vt,2,0,2,530_,
521,1,視覺,N,2,0,2,530_,
521,3,超大,Vi,8,3,11,530_799_977_1069_1076_1303_1306_,2257_2714_
521,1,至,Vt,2,0,2,530_,
521,3,上午,N,3,17,20,530_1430_,2457_2530_2554_2554_2555_2555_2674_2680_2816_2818_3103_3308_3433_3433_3435_3435_
521,1,申請到,Vt,2,0,2,530_,
521,3,鼓浪嶼,N,2,2,4,530_,3435_
521,3,升到,Vt,3,2,5,530_1352_,2608_
521,3,公車,N,4,1,5,530_1151_1158_,
521,3,極力,ADV,3,4,7,530_1500_,2565_3159_3487_
521,3,隨口,ADV,2,1,3,530_,
521,3,靠在,Vt,2,2,4,530_,3382_
521,1,植物園,N,4,0,4,521_530_530_,
521,1,記性,N,2,0,2,530_,
521,3,某某,N,2,2,4,530_,3072_
521,1,看電,Vi,2,0,2,530_,
521,1,表揚表揚,Vt,2,0,2,530_,
521,1,秀,N,2,0,2,530_,
522,3,不耐煩,Vi,2,8,10,531_,2608_2828_2881_3308_3308_3433_3435_
522,1,輪,Vt,5,0,5,531_783_842_916_,
522,1,妥貼,Vi,2,0,2,531_,
522,3,泰國,N,4,2,6,531_713_723_,2800_
522,1,燃油,N,4,0,4,531_1491_1494_,
522,3,生硬,Vi,2,15,17,531_,2471_2566_2581_2803_2869_2869_2981_2982_3032_3033_3084_3282_3357_3417_
522,1,鷺江,N,2,0,2,531_,
522,1,鴨肉,N,2,0,2,531_,
522,3,年輕,Vi,2,3,5,531_,2746_2746_
522,1,包間,N,2,0,2,531_,
522,3,豆漿,N,4,4,8,531_1054_1054_,2597_3288_3308_
522,1,渡,Vt,2,0,2,531_,
522,1,麵線,N,2,0,2,531_,
522,3,淡,Vi,2,2,4,531_,3294_
522,1,訓練有素,Vi,3,0,3,531_634_,
522,1,領事館,N,2,0,2,531_,
522,1,彬彬有禮,Vi,4,0,4,531_889_897_,
522,3,糊,Vt,2,1,3,531_,
522,3,控制,Vt,4,9,13,531_1408_1413_,2450_2453_2759_3065_3067_3096_3327_3465_
522,1,智能,N,2,0,2,531_,
524,1,起步,Vi,5,0,5,533_670_670_801_,
524,1,廈大,N,2,0,2,533_,
525,3,餐飲部,N,3,1,4,534_982_,
526,1,慇勤,Vi,5,0,5,535_674_714_724_,
526,3,判斷,Vt,2,2,4,535_,2818_
527,1,不遜,Vt,2,0,2,536_,
528,1,四通八達,Vi,5,0,5,537_819_916_974_,
528,3,錦江,N,4,20,24,537_982_982_,2033_2035_2043_2045_2383_2489_2558_2613_2613_2647_2647_2852_3092_3112_3367_3367_3368_3368_3426_
538,1,刮鬍子刀,N,1,0,1,,
538,3,一次性,N,2,22,24,964_,2318_2319_2399_2401_2450_2453_2534_2544_2631_2649_2649_2791_2824_2826_3139_3139_3139_3205_3246_3246_3419_
539,3,鬧市,N,3,1,4,837_1115_,
539,1,區不遠,N,1,0,1,,
540,1,盜走,Vt,1,0,1,,
540,1,水森,N,1,0,1,,
540,3,用來,Vt,1,3,4,,2945_3253_
540,3,拔掉,Vt,1,1,2,,
540,1,洋貨,N,1,0,1,,
540,1,密保,N,1,0,1,,
540,3,西餐,N,5,5,10,663_948_982_1105_,3175_3175_3176_3176_
540,1,保管,Vt,1,0,1,,
540,3,配置,Vt,1,4,5,,2996_3352_3354_
540,1,盜號,N,2,0,2,540_,
540,3,鍵,N,1,4,5,,2425_2428_2919_
540,1,關機,Vi,2,0,2,1232_,
540,3,差別,N,2,4,6,1431_,2491_3347_3437_
540,3,間,N,13,18,31,540_540_550_559_679_754_827_830_1068_1075_1201_1431_,2004_2006_2006_2018_2070_2232_2389_2508_2572_2574_2709_2711_2718_2721_2753_2787_2789_
540,3,貴重,Vi,3,5,8,889_897_,2924_3083_3296_3462_
540,3,幸好,ADV,2,7,9,1418_,2222_2649_3098_3213_3218_3319_
540,3,私人,N,2,5,7,815_,2458_2458_2987_3316_
540,1,永久,N,1,0,1,,
540,1,麻花,N,1,0,1,,
540,3,活,Vi,1,1,2,,
540,3,櫃,N,1,1,2,,
540,1,可口可樂,N,1,0,1,,
540,3,純淨水,N,1,2,3,,2053_
540,3,日期,N,1,1,2,,
540,3,自動,Vi,5,21,26,835_835_1469_1470_,2139_2139_2143_2143_2287_2288_2425_2428_2480_2616_2616_2700_2701_2873_3098_3115_3170_3170_3172_3172_
540,3,登,Vt,7,3,10,540_875_883_1087_1089_1425_,2360_2361_
540,1,偏小4,N,1,0,1,,
540,3,電源,N,3,20,23,1007_1253_,2059_2425_2425_2428_2428_2522_2616_2616_2651_2654_3333_3333_3431_3431_3431_3432_3432_3432_3465_
543,1,地漏,N,1,0,1,,
543,1,遠3,N,1,0,1,,
543,3,入口,N,1,1,2,,
543,3,暢,Vi,1,6,7,,2814_2849_3389_3390_3465_
543,1,津濱,N,1,0,1,,
543,3,粗糙,Vi,2,3,5,1013_,2528_3242_
543,3,浴盆,N,1,4,5,,2097_2144_2145_
544,3,3星級,N,4,3,7,983_1350_1472_,2626_2828_
544,3,舊舊,Vi,3,7,10,841_957_,2283_2532_2533_2534_3213_3218_
546,3,颱風,N,2,1,3,555_,
546,3,保護,Vt,5,2,7,555_714_724_754_,2746_
546,3,衝,Vi,4,3,7,555_618_627_,2608_3095_
546,1,轉帳,Vi,2,0,2,555_,
546,3,第三天,N,4,1,5,546_555_555_,
546,3,計算,Vt,2,2,4,555_,2701_
546,1,風風,N,2,0,2,555_,
546,3,包括,Vt,5,16,21,555_813_815_960_,2195_2266_2305_2308_2634_2908_2939_2940_2980_3246_3246_3254_3329_3366_3388_
546,3,無視,Vt,2,2,4,555_,3435_
546,3,白天,N,13,22,35,546_551_555_555_560_707_717_872_880_887_895_1384_,2131_2133_2367_2450_2453_2548_2868_2931_2939_2940_3008_3038_3039_3098_3110_3375_3375_3377_3377_3431_3432_
546,1,購,Vt,4,0,4,555_1171_1178_,
546,3,齊備,Vi,5,1,6,555_828_1359_1364_,
546,3,招待,Vt,2,2,4,555_,3397_
546,1,忙著,Vt,2,0,2,555_,
546,3,洲際,N,14,6,20,546_555_555_610_611_611_611_617_619_620_620_620_626_,2391_2391_2391_2391_2391_
546,3,套餐,N,9,7,16,555_813_1096_1326_1450_1450_1452_1452_,2754_2754_2946_3118_3118_3418_
546,3,專人,N,2,2,4,555_,2465_
546,1,加快,Vt,2,0,2,555_,
546,3,出現,Vi,5,21,26,555_743_1169_1176_,2252_2253_2363_2476_2527_2604_2742_2754_2764_2796_2816_2818_2872_2923_2946_2976_3294_3329_3433_3435_
546,1,卡鎖,N,2,0,2,555_,
546,3,賬單,N,2,2,4,555_,2391_
546,3,配備,N,3,10,13,555_1249_,2305_2308_2426_2596_2597_2759_2773_3296_3345_
546,3,共,ADV,4,7,11,555_1114_1425_,2070_2070_3101_3160_3433_3435_
546,3,皮蛋,N,2,2,4,555_,2861_
546,1,雲霄,N,2,0,2,555_,
546,3,刷,Vt,2,20,22,555_,2015_2128_2151_2151_2151_2287_2288_2391_2767_2914_3002_3074_3150_3255_3255_3256_3256_3330_3337_
546,3,再三,ADV,3,4,7,555_1088_,2638_2828_3180_
546,1,尖,Vi,10,0,10,555_780_782_783_800_856_859_865_868_,
546,1,糊味,N,2,0,2,555_,
546,1,彩,N,2,0,2,555_,
546,1,價差,N,2,0,2,555_,
546,3,棋牌室,N,2,1,3,555_,
546,1,接待處,N,2,0,2,555_,
546,1,至終,Vi,2,0,2,555_,
546,3,加油,Vi,2,1,3,555_,
546,1,搖滾,N,2,0,2,555_,
546,1,始,ADV,2,0,2,555_,
546,3,提示,Vt,6,12,18,550_555_559_749_1383_,2097_2710_2712_2784_3253_3333_3443_3448_3453_3475_3475_
546,3,統計,N,2,1,3,555_,
546,3,震,Vt,2,1,3,555_,
546,1,升4,Vt,2,0,2,555_,
546,1,處理卡,N,2,0,2,555_,
546,1,報錯,Vt,2,0,2,555_,
546,3,開幕式,N,4,1,5,546_555_555_,
546,1,百尺竿頭,Vi,2,0,2,555_,
546,1,警報器,N,2,0,2,555_,
546,3,吵架,Vi,2,1,3,555_,
546,3,頻繁,Vi,2,2,4,555_,2949_
546,1,4格,N,2,0,2,555_,
546,1,歸心似箭,Vi,2,0,2,555_,
546,1,卡左刷右刷,N,2,0,2,555_,
546,1,趕回來,Vi,2,0,2,555_,
546,3,無動於衷,Vi,2,2,4,555_,3295_
546,3,同志,N,4,5,9,555_876_884_,2288_2416_3232_3409_
546,3,短,Vi,4,5,9,555_787_921_,2809_3288_3431_3432_
546,1,火火,Vi,2,0,2,555_,
546,3,咨詢,Vt,3,5,8,555_982_,2793_2872_3083_3341_
546,1,音量,N,2,0,2,555_,
546,3,共有,Vt,2,2,4,555_,3435_
546,3,打麻將,Vi,2,1,3,555_,
546,1,鎖卡,N,2,0,2,555_,
546,3,音響,N,2,3,5,555_,2408_2540_
546,1,餘額,N,2,0,2,555_,
546,1,冷靜點,N,2,0,2,555_,
546,1,16樓,N,2,0,2,555_,
546,3,刷卡,Vi,12,26,38,546_546_555_555_555_756_758_886_894_990_993_,2072_2128_2149_2149_2515_2609_2731_3031_3074_3268_3289_3289_3290_3290_3308_3313_3313_3330_3330_3337_3367_3368_3388_3488_3490_
546,1,福建,N,4,0,4,555_1220_1222_,
546,1,福州,N,12,0,12,550_550_554_555_559_559_563_569_578_1462_1467_,
546,1,奧運會,N,2,0,2,555_,
546,1,那麼樣,ADV,2,0,2,555_,
546,3,樣子,N,9,26,35,555_670_830_875_883_1058_1304_1307_,2031_2313_2313_2313_2316_2316_2316_2372_2375_2450_2453_2609_2671_2757_2758_2782_2988_3078_3088_3111_3184_3232_3347_3360_3418_
546,3,仔細,Vi,5,10,15,555_962_1057_1500_,2272_2759_2864_2976_3020_3139_3231_3462_3478_
546,3,洗衣,Vi,8,2,10,555_599_608_736_736_1335_1344_,3011_
546,3,瘦肉,N,2,1,3,555_,
546,1,發癲,N,2,0,2,555_,
546,1,刮小,N,2,0,2,555_,
547,1,東百,N,2,0,2,556_,
548,1,茶水,N,2,0,2,557_,
549,3,相符,Vi,2,2,4,558_,3083_
550,3,報紙,N,9,2,11,559_889_897_1259_1378_1490_1493_1495_,3458_
550,1,明日,N,2,0,2,559_,
550,3,當日,N,2,4,6,559_,2761_2762_3296_
550,3,每天,N,11,6,17,559_714_724_787_817_889_897_1088_1088_1088_,2126_2498_2864_3308_3458_
551,3,陽台,N,9,8,17,560_855_864_1090_1343_1418_1425_1428_,2861_2861_2898_3056_3187_3189_3351_
551,3,跑,Vi,4,15,19,560_1114_1135_,2411_2594_2756_2769_2770_2784_2911_2933_2933_3282_3360_3360_3409_3443_
551,1,醉醺醺,Vi,2,0,2,560_,
551,1,形形色色,Vi,2,0,2,560_,
551,1,引導到,Vt,4,0,4,560_710_720_,
551,1,烏龍茶,N,2,0,2,560_,
551,1,字條,N,2,0,2,560_,
551,3,曬,Vt,2,5,7,560_,2252_2253_2253_2390_
551,1,過時,Vi,4,0,4,560_611_620_,
551,1,新四星,N,2,0,2,560_,
551,3,洗,Vt,10,40,50,560_630_630_663_872_880_1181_1187_1235_,2134_2228_2235_2236_2380_2391_2460_2461_2521_2544_2547_2578_2579_2679_2756_2759_2780_2781_3016_3047_3051_3103_3174_3201_3234_3266_3288_3298_3301_3389_3390_3417_3434_3436_3466_3495_3495_3497_3497_
551,3,一路,ADV,5,3,8,560_710_720_837_,2754_3083_
551,3,老婆,N,8,5,13,560_817_923_923_931_931_1437_,2245_2387_2387_2387_
551,3,夜總會,N,5,1,6,560_660_732_740_,
551,3,升為,Vt,2,2,4,560_,2773_
552,3,強調,Vt,4,6,10,561_593_602_,2035_2416_2530_2731_3083_
553,3,花瓣,N,4,1,5,562_1479_1486_,
553,1,夠得上,Vt,3,0,3,562_1000_,
554,3,開燈,Vi,3,3,6,563_1384_,2367_3076_
554,3,內裡,N,2,1,3,563_,
554,3,遊戲,N,3,2,5,563_1237_,3133_
554,3,堅持,Vt,7,17,24,563_641_1112_1120_1490_1493_,2163_2252_2253_2273_2525_2549_2550_2767_3038_3039_3063_3069_3070_3308_3431_3432_
554,3,破爛,Vi,2,7,9,563_,2165_2196_2213_2381_2483_3397_
554,1,泡茶,Vi,2,0,2,563_,
554,3,奢華,Vi,2,3,5,563_,3384_3473_
554,1,到進,Vt,2,0,2,563_,
566,3,算不上,Vt,2,5,7,575_,2105_2773_3163_3305_
566,1,勤快,Vi,4,0,4,575_1296_1300_,
566,1,車門,N,6,0,6,575_707_717_1319_1324_,
566,3,拎,Vt,2,8,10,575_,2223_2572_2917_3083_3470_3480_3482_
566,3,30日,N,3,9,12,575_732_,2555_2565_2744_2816_2818_3180_3431_3432_
568,1,高峰,N,4,0,4,577_662_672_,
568,1,補送,Vt,2,0,2,577_,
568,3,當天,N,6,32,38,577_756_758_1060_1252_,2055_2061_2081_2081_2083_2083_2239_2258_2258_2259_2259_2295_2445_2446_2494_2495_2509_2816_2818_2881_2967_2975_2988_3032_3033_3049_3224_3270_3319_3341_3371_
568,3,嚴肅,Vi,2,3,5,577_,3448_3453_
568,1,獲贈,Vt,2,0,2,577_,
568,1,洗衣券,N,8,0,8,568_568_568_577_577_577_577_,
568,3,首日,N,4,1,5,568_577_577_,
568,3,深深,Vi,4,2,6,577_1441_1446_,2762_
568,3,上面,N,9,32,41,577_630_961_1073_1080_1319_1324_1336_,2038_2040_2162_2190_2241_2260_2340_2341_2360_2361_2380_2480_2662_2671_2803_2817_2819_2841_2861_2864_2872_2908_2924_3083_3150_3196_3202_3202_3313_3458_3470_
569,1,２００１年,N,2,0,2,578_,
569,1,溫泉水,N,2,0,2,578_,
570,3,種類,N,5,7,12,579_957_1091_1371_,2305_2308_2332_2626_2749_3345_
570,1,淑女房,N,2,0,2,579_,
572,3,程定,N,2,1,3,581_,
572,3,協,Vi,4,2,6,581_1152_1159_,3315_
572,1,水果盤,N,2,0,2,581_,
582,3,風光,N,2,1,3,583_,
582,1,燕窩嶺,N,2,0,2,583_,
582,3,賣到,Vt,2,1,3,583_,
582,1,傅,N,2,0,2,583_,
582,1,海帶,N,2,0,2,583_,
582,3,門票,N,3,2,5,583_1232_,2731_
582,1,撿,Vt,2,0,2,583_,
582,1,漲潮,Vi,2,0,2,583_,
582,1,老虎,N,2,0,2,583_,
582,1,徒步到,Vt,2,0,2,583_,
582,3,灘,N,2,2,4,583_,3126_
584,3,飛機場,N,2,2,4,657_,2369_
584,1,秋林,N,1,0,1,,
584,1,哈爾賓,N,1,0,1,,
584,3,遠大,Vi,2,1,3,584_,
584,3,哥們,N,1,1,2,,
584,1,起步費,N,1,0,1,,
584,3,12日,N,3,5,8,1011_1048_,2436_3252_3353_3355_
584,1,交流,Vi,2,0,2,982_,
585,3,尚可,Vi,5,12,17,696_813_850_1450_,2045_2057_2389_2413_2470_2756_2763_2814_3011_3012_3203_
588,3,付賬,Vi,2,1,3,590_,
589,3,針線,N,1,1,2,,
589,1,高登,N,1,0,1,,
589,3,客房部,N,3,23,26,1239_1343_,2902_2904_2999_3150_3433_3433_3433_3433_3433_3433_3433_3433_3433_3435_3435_3435_3435_3435_3435_3435_3435_3435_
591,1,下到,Vt,1,0,1,,
591,1,帶房卡,N,1,0,1,,
592,3,敬請,Vt,2,2,4,601_,2680_
592,3,高度,A,2,6,8,601_,2060_2608_2609_3049_3397_
592,3,管理層,N,2,6,8,601_,2226_2258_2259_2745_2745_
592,3,吸煙區,N,10,1,11,592_593_593_593_601_601_602_602_602_,
592,3,加強,Vt,13,23,36,601_675_755_757_982_1013_1054_1169_1170_1176_1177_1399_,2069_2126_2126_2225_2226_2227_2227_2258_2259_2322_2359_2388_2447_2475_2500_2501_2769_2770_2862_3163_3373_3374_
592,3,無煙房,N,3,11,14,601_978_,2520_2532_2532_2533_2533_2594_2995_3024_3026_3040_
592,1,吸煙房,N,4,0,4,592_601_601_,
592,3,諒解,Vt,2,2,4,601_,2408_
593,1,真真,Vi,2,0,2,602_,
593,1,打敗,Vt,2,0,2,602_,
593,1,試探,Vt,2,0,2,602_,
593,3,換成,Vt,3,13,16,602_1259_,2324_2398_2534_2731_2946_3040_3086_3210_3215_3318_3327_3487_
593,1,搗糨糊,N,2,0,2,602_,
599,3,金額,N,2,4,6,608_,3246_3246_3308_
599,1,軟飲,Vt,2,0,2,608_,
599,1,雲霄路,N,2,0,2,608_,
599,3,休閒,Vi,3,2,5,608_790_,3319_
599,3,度假村,N,2,5,7,608_,3243_3243_3243_3245_
599,3,不行,Vi,5,33,38,608_674_761_1375_,2129_2149_2149_2162_2162_2312_2315_2332_2353_2365_2444_2540_2549_2550_2594_2763_2802_2816_2818_2869_2870_3057_3088_3103_3115_3117_3117_3214_3219_3227_3307_3379_
599,1,32樓,N,2,0,2,608_,
600,1,裡外,N,2,0,2,609_,
600,1,合力,ADV,2,0,2,609_,
600,1,餐點,N,4,0,4,609_1359_1364_,
610,1,新鮮度,N,2,0,2,619_,
610,3,品牌,N,6,15,21,619_675_779_923_931_,2266_2388_2391_2569_2569_2596_2597_2647_2647_2647_3220_3221_3352_3354_
610,3,重慶,N,11,9,20,610_610_610_619_619_619_619_912_1386_1388_,2284_2416_2771_2815_2846_2961_2963_3079_
610,1,明牌,N,2,0,2,619_,
610,1,相若,Vi,2,0,2,619_,
610,3,走進去,Vi,2,2,4,619_,3351_
610,3,總算,ADV,3,7,10,619_1203_,2483_2528_2841_2946_3289_3290_
610,3,合格,Vi,2,3,5,619_,2062_2949_
610,1,頂級,A,2,0,2,619_,
610,3,劣質,A,2,1,3,619_,
610,3,相差,Vt,5,17,22,619_668_989_992_,2198_2612_2621_2621_2656_2659_2718_2721_2759_2766_2953_3049_3119_3124_3282_3359_
610,3,碑,N,6,1,7,610_619_619_793_796_,
611,1,改住,Vt,2,0,2,620_,
611,1,相較,Vi,2,0,2,620_,
611,3,攜城,N,4,8,12,611_620_620_,2549_2549_2549_2550_2550_2550_2550_
611,1,驅,Vt,3,0,3,620_1339_,
611,3,利益,N,2,5,7,620_,2475_2535_2535_3076_
611,3,老舊,Vi,9,11,20,620_660_980_1091_1125_1132_1141_1143_,2189_2235_2236_2294_2335_2544_2754_2848_3104_3313_
611,3,續,Vt,4,6,10,611_620_620_,2688_2809_2867_3105_3257_
611,1,續訂,Vt,2,0,2,620_,
612,3,豪,Vi,4,5,9,618_621_627_,3124_3129_3130_3326_
612,3,擔保,Vt,2,10,12,621_,2284_2412_2731_2794_2921_2956_2957_3488_3490_
612,3,明明,N,3,23,26,621_1212_,2174_2211_2211_2502_2534_2572_2615_2630_2700_2701_2765_2771_3079_3084_3129_3130_3165_3329_3433_3435_3489_3491_
612,1,跑過去,Vi,2,0,2,621_,
613,3,特點,N,5,4,9,622_967_1384_1438_,2440_2996_3131_
613,1,商務型,N,4,0,4,622_1185_1191_,
614,3,符合,Vt,8,23,31,615_623_624_828_1088_1089_1453_,2085_2202_2212_2364_2607_2797_2810_2811_2814_2922_3012_3065_3067_3160_3240_3272_3347_3347_3360_3389_3390_3463_
615,1,格調,N,7,0,7,624_886_894_1334_1334_1499_,
616,3,禮賓,N,2,1,3,625_,
616,1,照常,Vi,2,0,2,625_,
616,1,花盆,N,4,0,4,616_625_625_,
616,1,田園,N,2,0,2,625_,
616,1,難看,Vi,3,0,3,625_962_,
616,3,可怕,Vi,2,9,11,625_,2344_2349_2508_2535_2863_3069_3070_3415_
616,3,90年代,N,2,3,5,625_,2151_2997_
616,3,範圍,N,5,2,7,625_889_897_1437_,3294_
617,3,希爾頓,N,2,2,4,626_,2361_
617,1,對罵,Vi,2,0,2,626_,
617,1,上前,Vi,2,0,2,626_,
617,1,伙,N,2,0,2,626_,
617,3,上海人,N,2,2,4,626_,3407_
617,1,調解,Vt,2,0,2,626_,
618,1,老態,N,2,0,2,627_,
618,3,更新,Vt,3,5,8,627_1091_,2161_3146_3258_3260_
618,3,早點,ADV,7,3,10,627_630_1067_1074_1304_1307_,3389_3390_
618,1,當局,N,2,0,2,627_,
618,1,平平,Vi,2,0,2,627_,
628,1,薄膜,N,1,0,1,,
628,3,愛人,N,2,4,6,901_,2483_2483_2639_
628,1,解渴茶,N,1,0,1,,
628,1,揚灰,Vi,1,0,1,,
628,1,成標,N,1,0,1,,
628,1,房客人,N,1,0,1,,
628,3,2分鐘,N,1,1,2,,
628,1,覆蓋,Vt,1,0,1,,
628,1,米粥,N,1,0,1,,
628,1,敦煌,N,17,0,17,628_628_628_628_629_630_630_630_630_633_642_1141_1143_1433_1435_1437_,
628,3,塑料,N,1,7,8,,2453_2651_2654_2756_2864_3332_
628,1,邊上,N,3,0,3,856_865_,
628,3,路面,N,1,2,3,,2708_
628,3,累,Vt,8,5,13,674_788_872_880_889_897_1088_,2483_2639_2869_3360_
628,3,路過,Vt,1,3,4,,2333_2334_
629,3,多餘,A,1,2,3,,2807_
629,1,顯示屏,N,1,0,1,,
629,1,莫高窟,N,3,0,3,630_632_,
630,3,下定,Vt,1,1,2,,
630,3,心有餘悸,Vi,1,1,2,,
630,1,大字,N,1,0,1,,
630,3,相迎,Vi,3,2,5,1309_1313_,3482_
630,3,不好意思,Vi,3,5,8,821_1019_,2226_2746_2775_3385_
630,3,之,N,1,7,8,,2511_2547_2589_2836_3296_3344_
630,1,教唆,Vt,1,0,1,,
630,1,郵箱,N,1,0,1,,
630,1,九寨溝,N,1,0,1,,
630,3,姓名,N,1,10,11,,2037_2174_2359_2360_2360_2361_2361_2746_2925_
630,3,心想,Vt,1,2,3,,2742_
630,1,停業,Vi,1,0,1,,
630,1,解決掉,Vt,1,0,1,,
630,1,登錄,Vt,1,0,1,,
630,3,巴,N,2,2,4,823_,2283_
630,3,頓時,ADV,1,5,6,,2828_3146_3433_3435_
630,1,論壇,N,1,0,1,,
630,3,後悔,Vt,5,17,22,701_876_884_1088_,2065_2457_2529_2719_2722_2733_2740_2777_2809_2976_2998_3015_3163_3267_3434_3436_
630,1,碰碰運氣,Vi,1,0,1,,
630,3,阿,N,1,3,4,,2915_3413_
630,1,滋滋,ADV,1,0,1,,
630,3,說說,Vt,3,6,9,1319_1324_,2037_2037_2162_3031_3443_
630,3,屏幕,N,2,2,4,1007_,2616_
630,3,這時,N,3,7,10,707_717_,2445_2446_2508_2606_3159_3159_
630,1,愁,Vt,3,0,3,890_898_,
630,1,對應,Vt,1,0,1,,
630,1,館子,N,2,0,2,1423_,
630,3,說出,Vt,1,2,3,,2925_
630,1,大肆,ADV,1,0,1,,
630,1,瓶頸,N,1,0,1,,
630,3,數字,N,5,3,8,972_1219_1221_1366_,2302_3153_
630,3,放棄,Vt,1,1,2,,
630,1,漸進,Vi,1,0,1,,
630,3,無所謂,Vi,3,8,11,1433_1435_,2757_2758_3037_3040_3225_3448_3453_
630,3,打算,Vt,3,16,19,912_1209_,2061_2629_2761_2762_2909_2910_2960_2962_3069_3070_3184_3233_3253_3253_3360_
630,3,評上,Vt,2,4,6,1240_,2199_2837_3078_
630,1,夢鄉,N,1,0,1,,
631,1,暖氣片,N,1,0,1,,
631,3,洗完,Vt,1,9,10,,2272_2547_2730_2753_2946_3062_3352_3354_
631,1,隔離,Vt,1,0,1,,
631,3,11月,N,2,14,16,821_,2134_2345_2350_2794_2815_2902_2904_3089_3139_3196_3296_3296_3476_
632,1,無證,N,1,0,1,,
632,1,耽擱,Vt,1,0,1,,
632,1,接車,N,2,0,2,632_,
632,3,行程,N,3,15,18,872_880_,2372_2375_2494_2495_2740_2747_2769_2770_2798_2800_2933_3103_3167_3185_
632,1,接站,N,1,0,1,,
632,3,涉嫌,Vt,1,1,2,,
632,1,雅丹,N,1,0,1,,
632,3,包車,Vt,2,6,8,1367_,3069_3070_3070_3163_3319_
632,3,班,N,8,8,16,670_782_783_841_842_1430_1455_,2458_3049_3213_3218_3360_3434_3436_
632,1,玉門關,N,1,0,1,,
632,3,後門,N,3,3,6,670_823_,2861_3049_
633,3,驢友,N,1,1,2,,
633,1,行都,N,1,0,1,,
634,1,派車,N,1,0,1,,
634,3,遲,Vi,1,1,2,,
635,3,地圖,N,7,5,12,637_1045_1049_1062_1129_1136_,2124_2493_3132_3319_
636,3,蓋,Vt,2,12,14,638_,2045_2116_2119_2360_2361_2477_2656_2773_3180_3202_3470_
636,1,穿上,Vt,2,0,2,638_,
636,3,毛衣,N,2,1,3,638_,
636,3,毛褲,N,2,1,3,638_,
636,3,熱風,N,2,1,3,638_,
639,1,粉面,N,1,0,1,,
639,3,不慎,Vi,1,2,3,,2904_
639,3,價值,N,1,5,6,,2226_2523_2719_2722_
639,1,送回,Vt,1,0,1,,
639,1,不菲,Vi,1,0,1,,
640,1,小貴,N,1,0,1,,
640,1,忽冷忽熱,N,2,0,2,700_,
641,3,規,N,1,1,2,,
641,1,距,N,1,0,1,,
641,1,迅速,Vi,1,0,1,,
641,3,機構,N,1,2,3,,3385_
641,3,亦,ADV,3,2,5,801_1334_,3111_
641,1,溫文,Vi,1,0,1,,
641,3,故障,Vi,1,5,6,,2143_2498_2598_2747_
641,1,嘉許,Vt,1,0,1,,
641,1,殊堪,ADV,1,0,1,,
641,1,置評,Vi,1,0,1,,
641,1,委實,ADV,1,0,1,,
641,3,大理,N,2,8,10,1232_,2231_2231_2231_3074_3074_3074_3118_
641,1,菜色,N,1,0,1,,
641,3,先前,N,2,1,3,912_,
641,1,奉,Vt,1,0,1,,
641,3,望,Vt,4,8,12,669_783_1371_,2388_2731_2731_2731_2731_2780_3007_
641,1,住入,Vt,1,0,1,,
641,1,尺度,N,1,0,1,,
641,3,踏實,Vi,3,2,5,886_894_,3118_
641,1,恰當,Vi,1,0,1,,
641,3,古城,N,2,9,11,941_,2231_2232_2232_2232_2232_2232_2232_3074_
641,3,推介,Vt,2,2,4,641_,2851_
642,1,整體性,N,2,0,2,1147_,
642,1,酒家,N,1,0,1,,
642,3,不遠處,N,7,1,8,856_859_865_868_1141_1143_,
642,3,早茶,N,3,3,6,805_821_,3198_3200_
642,1,麥凱樂,N,1,0,1,,
642,1,中高,A,1,0,1,,
644,3,視而不見,Vi,1,2,3,,2587_
644,3,賓部,N,1,1,2,,
644,1,短途,N,1,0,1,,
644,3,禮,N,2,4,6,960_,2609_2688_3015_
645,1,日本客人,N,4,0,4,651_770_774_,
648,3,偶爾,ADV,5,1,6,654_1378_1409_1450_,
648,3,在一起,Vi,6,15,21,654_889_897_921_1007_,2048_2272_2434_2548_2742_3139_3139_3205_3231_3308_3357_3451_3456_3472_
648,3,金,N,6,4,10,654_1062_1062_1408_1413_,2189_2659_2797_
648,1,銀,N,2,0,2,654_,
648,3,痛苦,Vi,2,5,7,654_,2347_2596_2597_3412_
649,3,明珠,N,3,3,6,655_1015_,2005_3074_
649,3,荒涼,Vi,2,1,3,655_,
649,1,蓮花,N,4,0,4,655_1186_1192_,
649,1,易初,N,4,0,4,655_1186_1192_,
650,3,厲害,Vi,4,4,8,656_783_783_,2180_3132_3470_
650,3,堵,Vt,5,7,12,656_761_995_996_,2679_2823_2825_3319_3389_3390_
650,1,個別,A,3,0,3,656_973_,
657,3,右邊,N,2,1,3,1011_,
657,1,包河,N,1,0,1,,
657,1,午晚餐,N,1,0,1,,
657,3,窗子,N,3,6,9,870_878_,2425_2428_3040_3237_3477_
657,3,敏感,Vi,3,1,4,1169_1176_,
658,3,必要,N,4,10,14,1125_1132_1290_,2031_2071_2081_2083_2651_2654_2776_3170_3172_
658,1,多加,N,1,0,1,,
658,3,旅客,N,4,6,10,783_1359_1364_,2231_2231_2313_2316_2609_
659,1,商,N,1,0,1,,
659,3,旅,N,2,6,8,822_,2861_2945_3327_3479_3481_
661,3,修好,Vt,9,19,28,675_872_880_939_1139_1168_1175_1419_,2753_3433_3433_3433_3433_3433_3433_3433_3433_3435_3435_3435_3435_3435_3435_3435_3435_3466_
662,1,週遭,N,1,0,1,,
662,3,甚至,ADV,1,25,26,,2298_2301_2318_2319_2426_2463_2465_2566_2656_2707_2708_2718_2721_2746_2750_2882_3032_3033_3038_3039_3101_3446_3495_3497_
662,3,走對,Vt,1,1,2,,
662,3,恐怖,Vi,1,25,26,,2095_2097_2097_2344_2349_2387_2387_2425_2428_2438_2440_2683_2684_2686_2687_2714_2884_2886_2958_3035_3150_3316_3387_3397_
662,3,立刻,ADV,4,8,12,871_879_1062_,2037_2183_2467_2468_2608_2609_2835_
662,1,臨街房,N,1,0,1,,
662,3,長話,N,1,1,2,,
662,3,早晚,N,1,1,2,,
663,3,觀,Vt,1,4,5,,2714_2767_2767_
663,1,雪茄,N,1,0,1,,
663,1,正中,N,1,0,1,,
663,1,髮露,N,1,0,1,,
663,3,一向,ADV,1,3,4,,3187_3189_
663,3,忙碌,Vi,1,2,3,,2646_
663,3,款式,N,2,1,3,1095_,
663,3,牙刷,N,4,9,13,663_663_842_,2306_2445_2446_2791_2791_2791_2791_2873_
663,1,乳酪,N,1,0,1,,
663,1,50樓,N,1,0,1,,
663,3,肥皂,N,1,2,3,,2349_
663,3,回到,Vt,5,14,19,837_1061_1062_1106_,2572_2680_2714_2806_2873_2946_3195_3254_3308_3397_3433_3435_3483_
665,3,自助餐廳,N,1,2,3,,3180_
665,1,靈,Vi,1,0,1,,
666,3,展會,N,1,3,4,,2957_3409_
667,3,韓國人,N,2,3,5,1409_,2206_2326_
668,1,正大,Vi,1,0,1,,
668,1,陸家嘴,N,1,0,1,,
668,1,列入,Vt,1,0,1,,
669,1,溫情,N,1,0,1,,
669,1,大關,N,1,0,1,,
669,3,基地,N,1,1,2,,
669,1,過街,Vi,1,0,1,,
669,3,訓練,N,1,2,3,,3455_
669,1,匯泉,N,1,0,1,,
669,1,帆船,N,2,0,2,669_,
669,3,本地人,N,2,2,4,783_,2638_
669,1,奧帆,N,1,0,1,,
669,1,青少年,N,2,0,2,669_,
669,3,浴場,N,4,1,5,1091_1091_1218_,
669,1,座,N,2,0,2,701_,
669,1,座車,N,2,0,2,669_,
669,3,房屋,N,3,5,8,1020_1369_,2740_3099_3099_3338_
669,1,王朝,N,1,0,1,,
669,1,看書,N,1,0,1,,
669,3,推,Vt,2,12,14,783_,2296_2419_2494_2495_2756_2987_3184_3184_3288_3373_3374_
669,3,海灘,N,5,2,7,857_866_1086_1425_,3385_
669,1,紅磚,N,1,0,1,,
670,3,穩定,Vt,2,4,6,1450_,2654_2666_2802_
670,1,東海路,N,1,0,1,,
670,1,朝右,N,1,0,1,,
670,1,西路,N,1,0,1,,
670,1,小野花,N,1,0,1,,
670,3,愧對,Vt,1,2,3,,2878_
670,3,好不好,Vi,3,1,4,710_720_,
670,3,巴士,N,27,7,34,709_719_782_783_783_786_789_815_833_842_842_843_844_846_857_866_889_889_890_897_897_898_923_931_1135_1135_,2154_2154_2154_2162_2164_2688_
670,1,無疑,ADV,1,0,1,,
670,1,海天,N,2,0,2,670_,
670,3,發呆,Vi,1,1,2,,
670,3,夾,Vt,2,2,4,701_,3071_
670,3,餅乾,N,1,1,2,,
670,1,香港路,N,1,0,1,,
670,3,枕頭,N,4,17,21,783_799_844_,2031_2059_2163_2406_2408_2586_2705_2706_2775_2775_2775_2775_2882_2955_3389_3390_
670,1,15樓,N,6,0,6,771_775_843_1037_1454_,
672,3,補,Vt,1,8,9,,2315_2528_2631_2731_2740_3409_3409_
672,3,時段,N,1,1,2,,
672,3,睡眠,N,2,5,7,1332_,2162_2704_2714_3484_
672,3,台盆,N,1,2,3,,2162_
674,1,老五星,N,2,0,2,1091_,
674,3,曉得,Vt,1,6,7,,2316_2543_2744_3074_3253_
674,3,飛,Vi,2,3,5,1087_,2226_2571_
674,3,頭,N,8,19,27,875_883_1007_1294_1298_1304_1307_,2253_2452_2544_2587_2731_2823_2825_2861_2861_2864_3040_3213_3218_3222_3323_3448_3453_3484_
674,3,轉身,Vi,3,5,8,1024_1218_,2119_3239_3413_3460_
674,3,想起,Vt,1,2,3,,3447_
674,1,苦心,ADV,1,0,1,,
674,3,牛肉,N,1,2,3,,2127_
674,1,異常,ADV,1,0,1,,
674,3,到底,ADV,5,15,20,710_720_816_1057_,2081_2083_2398_2754_3049_3107_3298_3301_3433_3433_3433_3435_3435_3435_
674,3,時刻,N,3,5,8,1480_1487_,2759_3022_3023_3150_
674,3,等待,Vt,3,10,13,1201_1239_,2579_2724_2731_2775_3132_3433_3433_3435_3435_
674,1,小弟,N,1,0,1,,
674,3,當地人,N,2,1,3,1425_,
674,1,黑椒,N,1,0,1,,
674,3,咖啡廳,N,1,4,5,,2739_3360_3360_
674,1,鹹澀,Vi,1,0,1,,
674,1,大年初一,N,1,0,1,,
675,1,升成,Vt,1,0,1,,
675,1,年紀,N,3,0,3,1163_1165_,
675,3,下水,Vi,3,18,21,1239_1266_,2211_2322_2382_2522_2522_2814_2849_2917_3112_3321_3321_3322_3322_3389_3390_3465_3466_
675,3,發覺,Vt,1,5,6,,2946_2946_2946_3001_
675,3,堵塞,Vt,1,5,6,,2607_3017_3018_3137_
675,3,大致,ADV,1,2,3,,3435_
676,1,青菜,N,3,0,3,714_724_,
676,1,東樓標,N,1,0,1,,
676,1,肉片湯,N,1,0,1,,
677,3,下來,Vi,2,6,8,835_,2775_2823_2825_3013_3095_
677,3,廬山,N,1,6,7,,3318_3318_3318_3319_3319_
677,1,快餐店,N,2,0,2,943_,
677,3,乘車,Vi,1,1,2,,
681,1,多樣,Vi,2,0,2,682_,
681,3,娛樂,N,4,7,11,682_1071_1078_,2436_2571_2576_2939_2940_2945_
683,3,帶有,Vt,1,1,2,,
683,3,污跡,N,1,8,9,,2521_2683_2686_2795_2888_3069_3070_
683,3,煙味,N,8,37,45,745_1251_1251_1408_1408_1413_1413_,2175_2175_2289_2356_2384_2517_2519_2532_2533_2541_2576_2636_2683_2686_2728_2729_2754_2775_2775_2775_2869_3083_3095_3111_3186_3186_3188_3188_3213_3213_3218_3218_3255_3256_3389_3390_
685,3,鋼琴,N,2,2,4,690_,2008_
686,1,餐飲街,N,2,0,2,691_,
687,3,隔開,Vt,2,3,5,692_,2946_3278_
687,3,洗澡間,N,3,3,6,692_973_,3187_3189_
687,1,磨砂,N,2,0,2,692_,
689,3,偏差,N,2,2,4,694_,3491_
695,1,影子,N,1,0,1,,
695,1,披露,Vt,1,0,1,,
695,3,簡潔,Vi,2,1,3,1253_,
695,1,海河,N,4,0,4,695_698_698_,
698,3,純粹,ADV,1,4,5,,2502_2619_2620_
698,3,騙人,Vi,1,4,5,,3054_3253_3342_
699,3,角落,N,1,3,4,,2589_2861_
699,3,資料,N,1,8,9,,2220_2222_2298_2301_2534_2924_2924_
699,3,比不上,Vt,2,5,7,1020_,2318_2319_2872_3029_
699,3,懷疑,Vt,3,20,23,949_962_,2115_2118_2340_2341_2363_2521_2528_2534_2560_2596_2597_2750_2750_2767_2776_2925_3016_3289_3290_
699,1,赫赫,Vi,1,0,1,,
699,3,廁紙,N,1,1,2,,
699,1,狼狽,Vi,1,0,1,,
699,3,永遠,ADV,1,14,15,,2411_2589_2671_2745_2765_2919_3015_3022_3023_3122_3127_3195_3425_
699,1,焦點,N,1,0,1,,
699,1,強化,Vt,1,0,1,,
699,1,填寫,Vt,1,0,1,,
699,1,總部,N,2,0,2,783_,
699,3,手紙,N,1,1,2,,
699,1,是也,ADV,1,0,1,,
701,1,盯上,Vt,1,0,1,,
701,1,活該,Vi,1,0,1,,
701,3,賊,N,2,1,3,701_,
701,1,外套,N,1,0,1,,
701,3,放鬆,Vt,1,1,2,,
701,3,口袋,N,3,1,4,710_720_,
701,1,好心,Vi,1,0,1,,
701,1,覺出,Vt,1,0,1,,
701,3,恐怕,ADV,2,3,5,982_,2721_3014_
701,3,偷,Vt,1,6,7,,2530_2724_3001_3016_3462_
701,3,椅子,N,1,5,6,,2301_2450_2453_2613_
701,1,下手,Vi,1,0,1,,
701,3,套,Vt,2,4,6,804_,2271_2746_2746_
701,1,掏,Vt,3,0,3,1124_1131_,
701,3,平常,N,1,2,3,,2361_
701,3,暗示,Vt,1,1,2,,
701,1,破財,Vi,1,0,1,,
701,1,警惕,Vt,1,0,1,,
701,3,做到,Vt,4,8,12,711_721_1088_,2308_2647_2671_2746_3002_3044_3048_
702,1,知名度,N,1,0,1,,
702,3,打出,Vt,1,2,3,,3194_
702,3,打表,N,1,2,3,,2701_
703,1,完備,Vi,4,0,4,705_1327_1377_,
703,1,加盟店,N,2,0,2,705_,
707,1,北房,N,2,0,2,717_,
707,3,睡懶覺,Vi,2,1,3,717_,
707,1,晨泳,Vi,4,0,4,707_717_717_,
707,3,莫,ADV,2,5,7,717_,2561_2562_2809_2809_
707,3,接觸,Vt,4,7,11,717_1311_1315_,3038_3039_3170_3172_3431_3432_
707,3,等候,Vt,2,2,4,717_,3460_
707,3,招呼,Vt,3,8,11,717_917_,2445_2446_2450_2453_2587_2835_3150_
707,3,緊接著,ADV,2,1,3,717_,
707,3,帶來,Vt,7,11,18,717_1169_1176_1371_1398_1407_,2312_2315_2432_2435_2447_2747_2840_3146_3231_3345_
707,3,一會,N,7,19,26,710_717_720_912_1031_1031_,2342_2432_2432_2435_2435_2509_2746_2748_2933_3281_3281_3397_3433_3433_3435_3435_3448_3453_
707,1,止咳,Vi,2,0,2,717_,
707,1,含片,N,2,0,2,717_,
707,1,樓門,N,2,0,2,717_,
707,3,深刻,Vi,7,5,12,717_944_990_993_1028_1029_,2260_2616_2960_2962_
707,3,明天,N,4,11,15,717_1270_1273_,2231_2231_2598_2598_2775_2861_3063_3119_3124_3274_
707,1,早已,ADV,2,0,2,717_,
707,1,咳嗽,Vi,8,0,8,710_710_714_717_720_720_724_,
707,1,天色,N,2,0,2,717_,
707,1,破例,Vi,2,0,2,717_,
707,1,為榮,Vi,2,0,2,717_,
707,3,消毒,Vt,4,4,8,710_717_720_,3161_3298_3301_
707,1,果汁,N,2,0,2,717_,
707,1,細微,Vi,2,0,2,717_,
707,1,無微不至,Vi,2,0,2,717_,
707,1,樓新,N,2,0,2,717_,
707,1,遞上,Vt,4,0,4,710_717_720_,
707,1,羹,N,2,0,2,717_,
707,1,銀耳,N,6,0,6,710_710_717_720_720_,
707,1,機車,N,2,0,2,717_,
707,1,送入,Vt,2,0,2,717_,
708,1,帶路,Vi,4,0,4,711_718_721_,
709,1,生還,Vi,2,0,2,719_,
709,3,延遲,Vt,3,10,13,719_1054_,2293_2309_2353_2705_2706_3197_3199_3416_3416_
709,3,航班,N,2,9,11,719_,2083_2287_2288_2384_2498_2956_2957_3159_
709,3,瞭解到,Vt,2,2,4,719_,2933_
709,3,服務台,N,5,13,18,719_917_964_1066_,2085_2309_2609_2764_2974_3119_3124_3213_3218_3386_3443_3477_
710,3,還給,Vt,7,11,18,714_720_724_916_920_1060_,2127_2567_3032_3033_3049_3184_3186_3188_3254_3327_
710,3,裝,Vt,5,10,15,720_872_880_1139_,2126_2151_2303_2306_2483_2647_2915_3146_3484_
710,1,童言,N,2,0,2,720_,
710,3,橙汁,N,3,2,5,720_1054_,2597_
710,3,慣例,N,3,1,4,720_921_,
710,1,接送車,N,2,0,2,720_,
710,1,興高采烈,Vi,2,0,2,720_,
710,3,播放,Vt,2,3,5,720_,3431_3432_
710,3,腿,N,3,4,7,720_1007_,2117_2867_3276_
710,1,輕微,Vi,2,0,2,720_,
710,3,舉,Vt,3,8,11,720_1082_,2642_2646_2927_3108_3109_3119_3124_
710,3,具體,Vi,2,11,13,720_,2359_2426_2510_2511_2529_2651_2654_2795_2902_2904_
710,3,蚊子,N,9,24,33,720_980_980_1087_1087_1339_1339_1367_,2266_2425_2428_2505_2549_2550_2714_2740_2750_2780_2976_2976_2993_2994_3035_3035_3091_3091_3205_3257_3276_3276_3385_
710,3,藥,N,2,5,7,720_,2816_2818_2818_3360_
710,1,碘敷,N,2,0,2,720_,
710,1,改定,Vt,2,0,2,720_,
710,1,裝上,Vt,2,0,2,720_,
710,3,文化,N,4,4,8,720_822_822_,2824_2826_2964_
710,1,不一,Vi,2,0,2,720_,
710,1,感觸,N,2,0,2,720_,
710,3,咬,Vt,3,7,10,720_1339_,2528_2976_2976_2976_3257_3257_
710,1,候機廳,N,2,0,2,720_,
710,1,包包,N,2,0,2,720_,
710,3,餐具,N,3,10,13,720_749_,2040_2127_3014_3231_3298_3298_3301_3301_3427_
710,1,病情,N,2,0,2,720_,
710,3,抵達,Vt,3,3,6,720_1234_,3448_3453_
710,1,卡通,N,3,0,3,720_1007_,
710,1,驕傲,Vi,2,0,2,720_,
710,1,甜美,Vi,3,0,3,720_736_,
710,3,忙,Vi,4,11,15,720_1311_1315_,2753_2835_2855_2856_2889_2890_3170_3172_3184_3409_
710,3,師傅,N,2,7,9,720_,2231_2753_2815_2815_3448_3453_
710,3,醫生,N,2,5,7,720_,2816_2816_2818_2818_
710,1,舒緩,Vt,2,0,2,720_,
710,3,不得了,Vi,2,10,12,720_,2432_2435_2510_2511_2525_2781_2945_3038_3039_
710,1,端上,Vt,2,0,2,720_,
710,3,閒,Vi,2,2,4,720_,2680_
710,1,西裝,N,2,0,2,720_,
710,1,螃蟹,N,2,0,2,720_,
710,1,背景,N,2,0,2,720_,
710,3,大盤,N,2,2,4,720_,2770_
710,1,王子,N,4,0,4,710_720_720_,
710,3,減輕,Vt,2,1,3,720_,
710,3,查,Vt,3,23,26,720_1020_,2012_2298_2301_2372_2375_2527_2582_2731_2731_2731_2838_3038_3039_3107_3264_3367_3368_3386_3386_3433_3435_3459_
710,1,兒童,N,2,0,2,720_,
710,1,負面,N,2,0,2,720_,
710,1,油精,N,2,0,2,720_,
710,3,寫有,Vt,2,1,3,720_,
710,1,玩偶,N,7,0,7,710_710_720_720_720_1087_,
710,3,行駛,Vi,2,2,4,720_,3378_
710,1,體現出,Vt,2,0,2,720_,
710,3,晚飯,N,8,5,13,710_710_720_720_720_1326_1333_,2798_2800_2946_3195_
710,1,童言無忌,Vi,2,0,2,720_,
710,1,過多,Vi,2,0,2,720_,
710,3,欺,Vt,2,2,4,720_,3033_
710,1,談起,Vt,2,0,2,720_,
710,1,和風,N,2,0,2,720_,
710,1,談談,Vt,2,0,2,720_,
710,3,今天,N,4,14,18,720_876_884_,2279_2731_2889_2890_2942_2968_3105_3110_3119_3124_3184_3227_3296_
710,1,擦藥,Vi,2,0,2,720_,
710,3,出口,N,4,2,6,720_912_1082_,2754_
710,1,薯條,N,2,0,2,720_,
710,1,病,N,2,0,2,720_,
710,3,薑湯,N,6,1,7,711_711_720_721_721_,
710,1,推車,N,2,0,2,720_,
710,3,專用,Vi,2,2,4,720_,2334_
710,3,媽媽,N,2,2,4,720_,3360_
710,3,汗顏,Vi,2,2,4,720_,3355_
710,3,企業,N,2,17,19,720_,2410_2824_2824_2824_2824_2824_2826_2826_2826_2826_2826_2830_2852_2954_3002_3316_
710,1,涼涼,Vi,2,0,2,720_,
710,3,父母,N,3,6,9,720_1409_,2446_2806_2869_2870_3072_
710,3,抓癢,Vi,2,2,4,720_,2550_
710,1,帥氣,Vi,2,0,2,720_,
710,3,用心,Vi,2,2,4,720_,3254_
710,1,發燒,Vi,2,0,2,720_,
710,3,取得,Vt,4,4,8,720_1491_1494_,2826_3433_3435_
710,3,身穿,Vt,2,1,3,720_,
711,1,可謂,Vt,2,0,2,721_,
711,1,披巾,N,2,0,2,721_,
711,3,感冒,Vi,5,13,18,711_721_721_1062_,2462_2475_2475_2662_2703_2773_2958_3187_3189_3265_3397_3470_
711,3,拿出,Vt,2,6,8,721_,2495_2549_2550_2846_3470_
711,1,精心,Vi,2,0,2,721_,
711,1,想不到,ADV,2,0,2,721_,
711,1,極地,N,4,0,4,711_721_721_,
711,1,海底,N,4,0,4,711_721_721_,
711,1,不已,Vi,2,0,2,721_,
711,3,世界,N,6,11,17,711_721_721_738_901_,2626_2731_2731_2899_2936_2937_3076_3206_3253_3254_
711,1,好玩,Vi,3,0,3,721_1054_,
711,1,罕有,Vi,2,0,2,721_,
711,1,青島市,N,2,0,2,721_,
711,1,首屈一指,Vi,2,0,2,721_,
711,1,沖劑,N,2,0,2,721_,
711,1,真心誠意,Vi,2,0,2,721_,
713,3,流出來,Vi,2,2,4,723_,3435_
713,3,海南,N,2,2,4,723_,2384_
713,1,話水,N,2,0,2,723_,
714,1,取來,Vt,2,0,2,724_,
714,3,貼,Vt,4,8,12,714_724_724_,3043_3205_3319_3360_3360_3409_3413_
714,1,主任,N,5,0,5,724_1028_1029_1030_,
714,1,喉寶,N,2,0,2,724_,
714,1,進餐,Vi,2,0,2,724_,
714,1,有方,Vi,2,0,2,724_,
714,1,雲南白藥膏,N,2,0,2,724_,
714,1,藍,Vi,4,0,4,714_724_724_,
714,3,著,Vt,4,6,10,724_888_896_,3115_3431_3431_3432_3432_
714,1,咽炎,N,2,0,2,724_,
714,1,痊癒,Vi,2,0,2,724_,
714,1,膏藥,N,4,0,4,714_724_724_,
714,1,整整齊齊,Vi,2,0,2,724_,
714,1,下旬,N,3,0,3,724_1020_,
714,3,樹立,Vt,2,2,4,724_,2671_
714,1,避暑,Vi,2,0,2,724_,
714,1,空調房,N,2,0,2,724_,
714,1,感同身受,Vi,2,0,2,724_,
714,3,總經理,N,2,5,7,724_,2671_2672_2889_2890_
714,1,金玉,N,2,0,2,724_,
714,1,黏膜,N,2,0,2,724_,
714,1,腳面,N,2,0,2,724_,
714,3,培養,Vt,2,1,3,724_,
714,1,一瘸一拐,ADV,2,0,2,724_,
714,1,明年,N,2,0,2,724_,
714,1,糖漿,N,2,0,2,724_,
714,3,至上,Vi,2,1,3,724_,
714,1,慢性,A,2,0,2,724_,
714,3,盛,Vi,2,1,3,724_,
714,3,生,Vt,4,14,18,724_913_1498_,2271_2552_2554_2555_2573_2718_2721_2731_3069_3070_3233_3233_3233_
714,3,攜程網,N,7,11,18,724_1020_1141_1143_1319_1324_,2204_2502_2987_3032_3033_3076_3133_3146_3159_3329_
714,1,小盤,N,2,0,2,724_,
714,1,王傑,N,2,0,2,724_,
714,3,炒,Vt,2,5,7,724_,2861_3144_3184_3333_
714,1,服用,Vt,2,0,2,724_,
714,3,注意到,Vt,5,3,8,714_724_724_1135_,2700_2701_
714,3,天下,N,4,1,5,724_888_896_,
714,3,花生米,N,2,2,4,724_,2893_
714,1,見效,Vi,2,0,2,724_,
714,1,金嗓子,N,2,0,2,724_,
715,1,粵式,N,2,0,2,725_,
715,1,中方,N,2,0,2,725_,
729,1,層次,N,1,0,1,,
731,3,跟不上,Vt,3,1,4,1303_1306_,
732,3,相同,Vi,2,8,10,1423_,2616_2804_2840_2861_2861_3146_3454_
732,3,9樓,N,4,5,9,1025_1025_1025_,2384_2707_2708_3372_
732,3,吵到,Vt,1,6,7,,2444_3029_3073_3117_3331_
733,1,泉州市,N,1,0,1,,
736,1,褲兜,N,1,0,1,,
736,3,找找,Vt,1,2,3,,3095_
736,3,務,N,1,1,2,,
736,3,找遍,Vt,1,1,2,,
736,3,拿出來,Vi,3,3,6,1181_1187_,2083_2163_
736,3,無話可說,Vi,1,5,6,,2126_2928_3289_3290_
736,3,冤枉,Vt,2,1,3,1495_,
737,3,掉線,N,1,1,2,,
738,1,白鷺,N,1,0,1,,
738,3,彷彿,ADV,1,2,3,,2392_
738,1,丹,N,3,0,3,1442_1447_,
738,1,附送,Vt,1,0,1,,
738,1,洗面,Vi,1,0,1,,
738,1,夢幻,N,1,0,1,,
738,3,啟動,Vt,1,6,7,,2372_2375_2425_2428_2616_
738,1,靜謐,Vi,1,0,1,,
738,1,花期,N,1,0,1,,
738,1,奶,N,1,0,1,,
738,1,桃園,N,2,0,2,739_,
738,3,處處,ADV,1,2,3,,2288_
738,1,桃花,N,3,0,3,739_739_,
738,1,壯觀,Vi,1,0,1,,
738,1,楓,N,1,0,1,,
738,1,化妝袋,N,1,0,1,,
738,1,小燈,N,1,0,1,,
738,3,別墅,N,2,11,13,1366_,2630_2630_2775_3324_3324_3422_3433_3433_3435_3435_
739,1,燦爛,Vi,1,0,1,,
739,3,碰巧,ADV,1,1,2,,
739,1,開花,Vi,1,0,1,,
739,3,季節,N,2,5,7,1088_,3187_3187_3189_3189_
741,3,拖拉,Vt,1,2,3,,3415_
742,1,敞亮,Vi,1,0,1,,
742,1,單行,A,1,0,1,,
742,3,昏暗,Vi,1,15,16,,2452_2480_2683_2683_2686_2686_2756_2900_2912_3030_3103_3258_3331_3417_
742,1,朝陽,N,1,0,1,,
742,3,暗,Vi,1,15,16,,2090_2128_2144_2145_2266_2543_2725_2796_2817_2819_2876_3047_3051_3246_
743,3,保證,Vt,1,19,20,,2124_2126_2325_2535_2608_2609_2647_2651_2654_2671_2671_2761_2762_2861_2900_3083_3448_3453_
743,1,制訂,Vt,1,0,1,,
743,3,系列,N,3,1,4,1005_1032_,
743,3,旺季,N,4,8,12,743_830_983_,2386_2388_2564_3032_3033_3099_3224_
743,3,措施,N,2,4,6,1031_,2226_2324_3243_
743,3,上述,N,1,4,5,,2245_2753_3111_
743,3,清晨,N,1,1,2,,
744,1,菜餚,N,2,0,2,1063_,
745,3,耐心,N,8,6,14,835_886_894_943_944_1057_1425_,2637_2638_2902_2904_3270_
745,3,開水,N,2,2,4,787_,2509_
745,1,利用,Vt,1,0,1,,
745,1,不巧,Vi,1,0,1,,
745,1,冰水,N,2,0,2,745_,
745,3,不厭其煩,Vi,1,1,2,,
746,1,警覺性,N,1,0,1,,
747,3,政府,N,3,10,13,1018_1371_,2300_2450_2453_2816_2818_2867_2951_3181_3246_
748,3,事宜,N,2,2,4,759_,2361_
748,3,死板,Vi,1,1,2,,
748,1,被動,Vi,2,0,2,960_,
749,3,不失,Vt,3,2,5,1244_1248_,2762_
749,1,藥片,N,1,0,1,,
749,3,帳號,N,1,1,2,,
749,1,滅蚊器,N,1,0,1,,
749,1,索取,Vt,2,0,2,1201_,
749,3,收走,Vt,1,3,4,,2453_3231_
749,3,菜品,N,3,2,5,1114_1423_,2308_
750,3,無線,A,1,1,2,,
750,3,做為,Vt,4,3,7,945_1164_1166_,2140_2322_
750,1,旋轉,Vt,6,0,6,1096_1167_1174_1326_1471_,
753,3,擁擠,Vi,2,2,4,1201_,3472_
753,3,不明,Vi,1,1,2,,
754,3,改變,Vt,1,8,9,,2305_2308_2309_2483_2494_2495_3205_
754,1,黃山湖,N,1,0,1,,
754,3,支架,N,1,1,2,,
755,3,毛病,N,2,2,4,757_,3465_
755,3,普通話,N,9,3,12,757_778_814_889_890_897_898_912_,3215_3468_
756,1,用上,Vt,2,0,2,758_,
756,3,準確,Vi,3,3,6,758_1060_,2560_3475_
756,3,筆記本,N,3,7,10,758_1018_,2428_2718_2721_2968_3103_3333_
759,1,解答,N,2,0,2,1423_,
759,3,詳細,Vi,2,6,8,1102_,2288_2359_2651_2654_2671_
760,3,難吃,Vi,4,14,18,820_1212_1348_,2050_2053_2272_2419_2596_2597_2662_2830_2871_2929_3194_3237_3333_
761,3,牆壁,N,1,14,15,,2145_2188_2246_2290_2378_2390_2412_2740_2995_2997_3035_3076_3397_
761,3,外牆,N,1,1,2,,
762,1,遜色,Vi,1,0,1,,
762,1,李南濱路,N,1,0,1,,
762,3,美食,N,4,2,6,782_819_846_,2133_
762,1,高檔次,A,1,0,1,,
762,1,街不遠,N,1,0,1,,
763,3,厚實,Vi,3,1,4,1481_1488_,
763,1,星湖,N,3,0,3,769_769_,
764,3,節假日,N,1,2,3,,2762_
766,3,型號,N,1,1,2,,
766,3,湖景,N,1,5,6,,3232_3232_3232_3232_
767,3,外邊,N,1,2,3,,3333_
768,3,旅行團,N,6,2,8,901_1278_1279_1285_1286_,2882_
768,3,份,N,8,5,13,772_776_807_1124_1131_1469_1470_,2305_2308_2731_3438_
768,1,住觀景房,N,1,0,1,,
768,3,價廉物美,Vi,4,1,5,1063_1085_1386_,
769,1,人文,N,1,0,1,,
769,1,碧波,N,1,0,1,,
769,1,氣息,N,1,0,1,,
770,3,對方,N,2,17,19,774_,2972_3205_3253_3253_3433_3433_3433_3433_3433_3433_3435_3435_3435_3435_3435_3435_
771,1,聚會,N,2,0,2,775_,
771,1,怡情,Vi,2,0,2,775_,
771,3,洗臉盆,N,2,4,6,775_,2139_2143_2322_
771,3,週日,N,2,1,3,775_,
771,3,週四,N,2,2,4,775_,3463_
771,1,啤酒街,N,2,0,2,775_,
771,3,火,Vi,2,3,5,775_,2276_3184_
772,1,打哆嗦,Vi,2,0,2,776_,
773,1,隨叫隨到,Vi,3,0,3,777_956_,
773,1,青島人,N,2,0,2,777_,
773,3,順便,ADV,3,9,12,777_956_,2037_2269_2742_2946_3013_3158_3196_3419_
773,1,回青,N,2,0,2,777_,
773,1,丟臉,Vi,2,0,2,777_,
778,3,亞,N,1,3,4,,3433_3435_
779,1,粵語,N,1,0,1,,
779,3,類似,Vt,4,4,8,1007_1169_1176_,2680_3146_3443_
779,3,表情,N,1,10,11,,2460_2461_2534_2572_2609_2742_3043_3335_3360_
779,3,嘴,N,1,1,2,,
779,3,最終,ADV,1,10,11,,2309_2680_2731_2823_2825_2946_3083_3243_3421_
779,1,聽得懂,Vt,1,0,1,,
779,3,說到,Vt,1,3,4,,2858_3231_
779,3,表現出,Vt,1,1,2,,
779,3,付款,Vi,2,8,10,903_,2284_2287_2288_3084_3388_3388_3477_
780,1,酒相,N,1,0,1,,
780,1,維多利亞灣,N,1,0,1,,
780,1,園,N,3,0,3,1251_1251_,
780,3,班車,N,17,7,24,784_841_856_858_858_859_865_867_867_868_888_896_901_1231_1316_1321_,2232_2458_2458_2689_3185_3185_
780,1,蜜月,N,3,0,3,854_863_,
780,1,沙嘴,N,8,0,8,782_783_800_856_859_865_868_,
780,3,往返,Vt,5,1,6,851_860_923_931_,
782,1,維港,N,1,0,1,,
782,3,釣魚,Vi,1,2,3,,2946_
782,3,情景,N,1,1,2,,
782,1,安逸,Vi,3,0,3,1442_1447_,
782,1,血拼,N,1,0,1,,
782,1,黃埔,N,3,0,3,783_783_,
782,3,穿梭,Vi,3,1,4,842_844_,
782,3,道,N,3,2,5,921_1016_,3231_
782,1,新天地,N,1,0,1,,
782,3,開發,Vt,1,1,2,,
782,3,老人,N,3,3,6,1057_1343_,3360_3463_
783,3,鳳凰,N,1,3,4,,2797_2996_
783,3,內地,N,5,2,7,788_872_880_1436_,3400_
783,1,末班車,N,1,0,1,,
783,1,盈門,Vi,1,0,1,,
783,1,棒子,N,1,0,1,,
783,1,掃中,Vt,1,0,1,,
783,1,九龍站,N,1,0,1,,
783,3,身,N,5,23,28,886_894_1356_1361_,2119_2163_2252_2253_2389_2436_2528_2609_2636_2753_2816_2818_2898_2946_3103_3242_3289_3289_3290_3290_3418_3418_
783,1,同學家,N,1,0,1,,
783,1,喳喳,ADV,1,0,1,,
783,1,園景,N,1,0,1,,
783,3,吃不消,Vt,3,1,4,1088_1473_,
783,1,林青霞,N,1,0,1,,
783,1,東取,Vt,1,0,1,,
783,3,路程,N,5,3,8,889_897_1070_1077_,2821_2847_
783,1,落灰,N,1,0,1,,
783,3,劃,Vt,1,2,3,,3142_
783,3,太晚,Vi,1,8,9,,2562_2791_3237_3281_3304_3448_3453_
783,1,食客,N,1,0,1,,
783,1,海逸,N,1,0,1,,
783,1,海港城,N,13,0,13,801_802_804_804_811_812_869_874_875_877_882_883_,
783,3,碰上,Vt,3,2,5,1138_1498_,3394_
783,3,壓縮,Vt,1,1,2,,
783,3,結婚,Vi,2,5,7,1018_,3132_3132_3392_3394_
783,1,鞋印,N,1,0,1,,
783,3,銅鑼灣,N,8,1,9,801_833_847_847_889_897_907_,
783,1,總站,N,5,0,5,847_847_847_1267_,
783,1,渡到,Vt,1,0,1,,
783,1,豪宅,N,1,0,1,,
783,3,格局,N,1,6,7,,2519_3017_3018_3371_3371_
783,1,園景房,N,1,0,1,,
783,3,中檔,N,1,1,2,,
783,1,灣仔,N,5,0,5,783_842_842_921_,
783,3,環,N,1,3,4,,2973_3235_
783,3,韓國,N,1,3,4,,3360_3360_
783,1,團隊客,N,1,0,1,,
783,1,金鐘,N,11,0,11,842_846_886_887_887_887_894_895_895_895_,
783,3,線,N,10,10,20,801_842_849_1053_1067_1074_1270_1273_1450_,2162_2892_3103_3210_3210_3215_3215_3288_3332_
783,1,駐地,N,1,0,1,,
783,3,週一,N,1,1,2,,
783,1,口子,N,1,0,1,,
783,1,海天閣,N,1,0,1,,
783,3,衛視,N,1,1,2,,
784,1,淨化器,N,1,0,1,,
784,3,好不,ADV,1,2,3,,3435_
784,3,形狀,N,1,1,2,,
784,3,四周,N,3,5,8,1359_1364_,3084_3145_3376_3378_
784,3,嚴重,Vi,2,28,30,949_,2144_2145_2206_2206_2206_2206_2233_2284_2326_2363_2560_2575_2647_2728_2729_2754_2816_2816_2818_2818_2960_2962_2997_3074_3119_3124_3295_
785,3,極了,ADV,4,3,7,828_1088_1088_,3070_3347_
786,1,惠康,N,1,0,1,,
786,3,尖沙咀,N,14,5,19,815_842_851_857_860_866_872_880_901_923_923_931_931_,2154_2162_2162_2162_
786,3,轉,Vt,6,12,18,820_885_893_1359_1364_,2316_2360_2360_2360_2361_2361_2361_2389_2497_2623_2753_
786,1,泡麵,N,1,0,1,,
786,1,遙遠,Vi,1,0,1,,
786,3,車費,N,3,2,5,842_1005_,3254_
786,3,海洋,N,11,2,13,815_835_886_886_887_890_894_894_895_898_,3254_
786,3,旺角,N,14,1,15,815_872_880_891_899_901_907_907_907_923_923_931_931_,
786,3,關門,Vi,8,6,14,786_875_883_887_895_910_958_,2489_2742_3034_3098_3277_
786,3,偏僻,Vi,3,15,18,816_842_,2493_2581_2715_2716_2781_2833_2882_2918_2943_2973_3318_3318_3319_3360_
787,1,喜慶,N,1,0,1,,
787,3,腳,N,2,10,12,1029_,2565_2587_2599_2976_3307_3356_3363_3422_3443_
787,3,樓梯,N,1,10,11,,2572_2753_2753_2753_2946_3119_3124_3239_3319_
787,3,如意,Vi,2,3,5,982_,2740_2771_
787,3,委屈,Vt,1,1,2,,
787,1,彩條,N,1,0,1,,
787,3,電,Vt,5,5,10,789_906_1001_1049_,2582_3084_3103_3103_
787,1,中環,N,18,0,18,835_835_835_837_842_842_885_885_889_891_893_893_897_899_907_1053_1056_,
787,3,換新,Vt,1,2,3,,2922_
787,3,2月,N,9,14,23,795_798_1038_1270_1273_1451_1489_1492_,2070_2534_2551_2631_2816_2816_2818_2818_3253_3433_3433_3435_3435_
787,1,伸腿,Vi,1,0,1,,
787,1,品位,N,2,0,2,974_,
787,3,18日,N,3,7,10,1203_1203_,2450_2453_2831_2832_3055_3316_
787,1,床沿,N,1,0,1,,
787,3,個子,N,2,1,3,787_,
787,3,紅,Vi,2,4,6,819_,2038_2040_2040_
787,3,燈籠,N,1,1,2,,
788,1,中央一台,N,1,0,1,,
788,1,酷愛,Vt,1,0,1,,
788,3,在於,Vt,2,3,5,1107_,3392_3394_
788,3,皇悅,N,1,2,3,,2162_
788,3,缺陷,N,1,1,2,,
788,1,西環,N,5,0,5,789_790_841_843_,
788,3,浴池,N,1,1,2,,
788,1,中遠,N,2,0,2,792_,
788,3,港島,N,1,2,3,,2162_
790,3,遊,Vt,1,4,5,,2047_2954_3319_
790,1,軌電,N,1,0,1,,
790,1,全程,ADV,1,0,1,,
790,1,折算,Vt,1,0,1,,
790,3,港幣,N,10,2,12,801_801_816_835_842_887_895_903_917_,3296_
792,1,嚼,Vt,1,0,1,,
792,3,南北,N,1,1,2,,
792,3,居民,N,3,3,6,888_896_,2671_2893_
792,3,銀聯,N,1,1,2,,
792,1,不緊,Vt,1,0,1,,
793,1,門童冒,N,2,0,2,796_,
793,3,褲子,N,2,1,3,796_,
793,3,旺,Vi,6,1,7,794_796_797_1242_1246_,
793,3,眾,A,3,1,4,796_1211_,
793,3,皆,ADV,2,1,3,796_,
793,3,人氣,N,4,1,5,794_796_797_,
794,1,果籃,N,5,0,5,795_797_798_1084_,
794,3,拜訪,Vt,3,3,6,797_1329_,2746_2746_
794,3,那天,N,4,4,8,797_1319_1324_,2838_3291_3292_
794,1,調不,N,2,0,2,797_,
794,3,燙,Vt,6,1,7,795_797_798_1242_1246_,
794,3,絕,Vi,3,2,5,797_1423_,3309_
794,3,濃烈,Vi,2,3,5,797_,2636_3071_
795,3,全面,ADV,4,5,9,798_1126_1133_,2671_2883_3168_3169_
795,3,變化,N,3,5,8,798_1366_,2463_2465_2522_2883_
795,1,晚安,Vi,2,0,2,798_,
795,1,一絕,N,2,0,2,798_,
795,1,配送,Vt,2,0,2,798_,
795,1,菜式,N,4,0,4,798_1124_1131_,
801,3,飲食,N,6,2,8,819_1071_1078_1093_1094_,3246_
801,1,彌敦道,N,1,0,1,,
801,1,適於,Vt,1,0,1,,
801,3,時代,N,3,1,4,821_844_,
801,3,九龍,N,7,2,9,813_815_901_916_921_934_,2162_
802,3,擦乾,Vt,1,2,3,,2391_
802,1,廣東道,N,1,0,1,,
802,3,水斗,N,1,1,2,,
802,3,口頭,ADV,1,2,3,,2608_
802,1,接頭,N,1,0,1,,
803,1,怡東,N,1,0,1,,
803,1,嘉福,N,1,0,1,,
803,3,異味,N,3,27,30,811_1350_,2205_2283_2283_2285_2478_2587_2600_2600_2748_2753_2808_2913_2976_3065_3067_3076_3077_3170_3172_3207_3277_3324_3479_3480_3481_3482_
804,1,嘉逸,N,1,0,1,,
804,1,住尖東,N,1,0,1,,
804,1,彌墩道,N,1,0,1,,
804,1,星光,N,1,0,1,,
805,3,具,Vt,2,4,6,1326_,2291_2388_3415_
805,3,意義,N,1,4,5,,3115_3118_3243_
805,1,五臟,N,1,0,1,,
806,3,搶,Vt,1,5,6,,2769_2770_3232_3399_
807,3,每年,N,1,3,4,,3255_3256_
808,1,時機,N,1,0,1,,
808,3,塗,Vt,1,3,4,,2501_2531_
808,1,貴上,Vi,1,0,1,,
808,3,遇上,Vt,1,8,9,,3038_3039_3244_3244_3433_3435_3475_
811,1,煙癮,N,1,0,1,,
811,1,絕佳,Vi,4,0,4,1124_1131_1366_,
811,3,交代,Vt,1,1,2,,
811,1,卡佛,N,1,0,1,,
811,1,乘搭,Vt,1,0,1,,
812,3,連著,ADV,3,3,6,1181_1187_,3098_3132_
812,1,港艾美,N,1,0,1,,
813,3,鏡子,N,5,2,7,814_815_817_1052_,3132_
813,3,不再,ADV,6,14,20,854_863_1054_1153_1160_,2407_2436_2571_2589_2698_2761_2762_2842_2843_3356_3373_3374_3429_
813,1,共計,Vt,1,0,1,,
813,1,誘導,Vt,1,0,1,,
813,1,飛快,ADV,1,0,1,,
813,3,拒絕,Vt,1,12,13,,2269_2287_2288_2309_2606_2616_2731_2748_2869_2882_3083_
813,1,試圖,Vt,1,0,1,,
813,1,小巴,N,6,0,6,814_814_816_817_817_,
813,3,嚇人,Vi,1,6,7,,2578_2684_2687_2830_2975_
813,3,大一,N,1,5,6,,2008_2272_2731_2776_
814,3,迪士尼,N,1,1,2,,
814,3,富豪,N,2,1,3,819_,
814,1,歧視,Vt,1,0,1,,
814,1,收好,Vt,1,0,1,,
814,3,一共,ADV,2,11,13,1088_,2453_2596_2597_2616_2623_3029_3101_3102_3196_3446_
814,1,飄飄,Vi,1,0,1,,
814,1,比做,Vt,1,0,1,,
814,3,合算,Vi,2,1,3,1199_,
814,3,不怎麼,ADV,7,6,13,962_1304_1307_1316_1321_1474_,2253_2273_2525_3056_3316_
814,1,品店,N,1,0,1,,
814,1,榴蓮,N,1,0,1,,
814,3,做好,Vt,4,5,9,1031_1181_1187_,2609_2769_2770_3371_
814,1,口香舌滑,Vi,1,0,1,,
814,1,直達車,N,1,0,1,,
814,3,樣,N,1,1,2,,
814,3,甜,Vi,1,1,2,,
814,1,甜品,N,2,0,2,835_,
814,1,老先生,N,1,0,1,,
814,1,新城,N,1,0,1,,
814,3,四面,N,1,1,2,,
815,3,回程,N,1,1,2,,
815,1,吉之島,N,1,0,1,,
815,1,隧道,N,1,0,1,,
815,1,特多,N,1,0,1,,
815,1,巴士站,N,2,0,2,842_,
815,3,麥當勞,N,4,1,5,857_866_1266_,
815,1,小鋪,N,1,0,1,,
815,1,寨城,N,1,0,1,,
815,1,百佳,N,6,0,6,889_897_901_1124_1131_,
815,1,九龍城,N,4,0,4,816_817_819_,
815,1,坐1,Vi,1,0,1,,
815,1,外資,N,1,0,1,,
815,3,間隔,N,1,1,2,,
816,3,大上,Vt,1,1,2,,
817,3,寄存,Vt,5,3,8,923_931_1319_1324_,2746_2933_
817,3,角度,N,1,3,4,,2731_2753_
817,1,鎖好,Vt,1,0,1,,
818,3,拼,Vt,3,4,7,889_897_,2445_2446_2867_
819,3,阿姨,N,4,1,5,886_894_912_,
819,1,天堂,N,1,0,1,,
819,3,稱為,Vt,1,2,3,,3140_
819,1,茶包,N,1,0,1,,
819,1,眼花繚亂,Vi,1,0,1,,
819,3,屋子,N,1,11,12,,2236_2271_2323_2340_2341_2740_2740_2740_2750_2766_
819,3,享用,Vt,2,4,6,1437_,3246_3253_3360_
819,1,換乘,Vt,2,0,2,847_,
819,1,甜品店,N,1,0,1,,
820,1,便利店,N,4,0,4,889_897_901_,
820,3,日用品,N,1,2,3,,3177_
820,3,沙田,N,5,1,6,822_822_822_826_,
820,3,飲料,N,4,8,12,1054_1054_1430_,2170_2305_2308_2309_2492_3038_3039_
820,1,軌道,N,1,0,1,,
820,1,屈臣氏,N,3,0,3,889_897_,
821,3,走走,Vi,4,4,8,856_865_1238_,2162_2941_3319_
821,3,狹小,Vi,2,8,10,1362_,2169_2197_2390_3083_3333_3352_3354_
821,3,正確,Vi,1,3,4,,3037_3307_
822,1,藝術館,N,1,0,1,,
822,1,科學館,N,1,0,1,,
822,1,城門河,N,1,0,1,,
822,3,參觀,Vt,1,2,3,,3173_
822,3,友,N,1,1,2,,
822,1,興趣,N,1,0,1,,
822,1,週三,N,1,0,1,,
823,1,學校,N,1,0,1,,
823,1,攤主,N,1,0,1,,
823,1,風趣,Vi,1,0,1,,
823,1,左手,N,1,0,1,,
823,1,換匯,Vt,1,0,1,,
823,1,報攤,N,1,0,1,,
823,3,拐角處,N,1,3,4,,2659_2703_
823,3,住宅,N,2,4,6,904_,2776_3055_3345_
825,3,關掉,Vt,1,8,9,,2037_2753_2946_2971_3196_3433_3435_
826,1,略微,ADV,2,0,2,1201_,
827,3,混亂,Vi,1,5,6,,2678_2790_2873_3132_
828,1,處於,Vt,2,0,2,1346_,
828,1,相鄰,Vi,1,0,1,,
828,3,火車票,N,2,3,5,1431_,2919_2919_
828,3,警察,N,2,7,9,830_,2869_2869_2924_3296_3376_3378_
828,3,機票,N,2,1,3,1011_,
828,1,把守,Vt,1,0,1,,
828,1,取款機,N,1,0,1,,
828,1,拼車,Vi,1,0,1,,
828,3,國家,N,4,8,12,875_883_1371_,2040_2249_2251_2417_2582_2594_2759_
828,1,西寧市,N,1,0,1,,
828,1,鳥瞰,Vt,1,0,1,,
828,1,領導人,N,1,0,1,,
828,1,集散點,N,1,0,1,,
828,1,代買,Vt,1,0,1,,
828,3,西寧,N,4,2,6,828_830_831_,3453_
828,1,群山,N,1,0,1,,
828,3,19樓,N,1,3,4,,3327_3327_
828,1,夏利車,N,1,0,1,,
828,1,塔爾寺,N,1,0,1,,
830,1,菜湯,N,1,0,1,,
830,1,執勤,Vi,1,0,1,,
830,1,流暢,Vi,3,0,3,1224_1226_,
830,1,警總,N,1,0,1,,
831,1,青海,N,1,0,1,,
831,1,房床離門,N,1,0,1,,
833,1,半山,N,3,0,3,835_835_,
833,1,高尚,Vi,1,0,1,,
833,1,美食區,N,1,0,1,,
833,1,蘭桂,N,2,0,2,837_,
833,3,坊,N,1,1,2,,
835,3,放下,Vt,4,5,9,990_993_1057_,2555_2698_2709_2711_
835,1,地頭,N,1,0,1,,
835,1,路費,N,1,0,1,,
835,3,走動,Vi,1,3,4,,2720_3306_
835,1,扶梯,N,3,0,3,835_1427_,
835,1,蓮香樓,N,1,0,1,,
835,3,午飯,N,2,4,6,1326_,3129_3130_3184_
835,1,纜車站,N,1,0,1,,
835,1,任食,N,1,0,1,,
835,1,震撼,Vt,1,0,1,,
835,1,山頂,N,2,0,2,835_,
835,1,下午茶,N,4,0,4,924_932_1095_,
835,1,怡,Vi,1,0,1,,
835,1,雙標房,N,1,0,1,,
835,1,不一定,ADV,4,0,4,907_1490_1493_,
835,3,通常,ADV,1,5,6,,3032_3033_3226_3246_
835,3,省,N,6,7,13,835_907_1141_1143_1232_,2231_2391_2391_2494_2495_3007_
835,1,蘭桂芳,N,1,0,1,,
835,1,小時候,N,1,0,1,,
835,1,赤柱,N,3,0,3,890_898_,
835,1,小食店,N,1,0,1,,
835,1,就是,Vt,1,0,1,,
836,3,好說,Vi,1,1,2,,
837,1,取靜,N,1,0,1,,
837,3,往來,Vt,2,1,3,907_,
837,3,酒巴,N,1,2,3,,2994_
837,3,起床,Vi,2,10,12,1088_,2703_2767_2862_2862_2987_3233_3418_3431_3432_
837,3,住處,N,1,2,3,,3205_
837,3,取,Vt,4,6,10,902_1025_1025_,2361_2609_2714_3205_3231_
837,3,區,N,2,2,4,1049_,3163_
837,1,工具,N,1,0,1,,
837,1,晨跑,Vi,1,0,1,,
837,1,鄰近,Vt,1,0,1,,
837,1,漫步,Vi,1,0,1,,
837,3,前往,Vt,1,5,6,,2153_2168_2883_3388_
837,1,異國情調,N,1,0,1,,
837,1,清早,N,1,0,1,,
837,3,返回,Vt,3,3,6,1343_1430_,2933_3013_
838,3,仁,N,1,1,2,,
838,1,建材,N,1,0,1,,
838,1,改名為,Vt,1,0,1,,
838,3,濃重,Vi,1,8,9,,2335_2534_2728_2729_2754_3389_3390_
838,3,民,N,1,1,2,,
841,3,鐘頭,N,1,2,3,,3471_
841,3,來回,Vt,5,10,15,857_866_885_893_,2933_2933_3069_3069_3070_3070_3210_3215_3341_
842,1,港澳,N,5,0,5,888_896_907_1095_,
842,3,連鎖,A,1,11,12,,2283_2283_2391_2996_3047_3051_3112_3220_3221_3345_
842,1,繁忙,Vi,1,0,1,,
842,3,雙人床,N,2,3,5,1114_,3438_3438_
842,1,飄,N,1,0,1,,
842,1,紅墈,N,1,0,1,,
842,1,皇后大道,N,3,0,3,891_899_,
842,3,陪,Vt,1,1,2,,
842,3,牙膏,N,1,1,2,,
842,3,改成,Vt,1,4,5,,2671_2767_2846_
842,1,商業街,N,8,0,8,1141_1143_1148_1219_1221_1261_1328_,
842,1,沿路,ADV,3,0,3,885_893_,
842,1,尼敦,N,1,0,1,,
843,3,壁紙,N,1,3,4,,2180_3076_
843,3,簡,Vi,1,1,2,,
844,1,拼成,Vt,1,0,1,,
844,3,看出,Vt,1,1,2,,
844,1,洗衣店,N,1,0,1,,
844,3,不易,Vi,2,1,3,1215_,
844,3,簡約,Vi,1,1,2,,
844,1,飄窗,N,1,0,1,,
844,3,住宅區,N,1,2,3,,2671_
844,1,羽,N,1,0,1,,
844,1,絨,N,1,0,1,,
844,1,跑馬,Vi,2,0,2,846_,
845,3,幾乎,ADV,4,44,48,875_883_1021_,2004_2006_2006_2042_2048_2057_2062_2180_2183_2367_2498_2517_2519_2731_2731_2756_2775_2839_2888_2914_2945_2945_2965_2966_2967_3029_3071_3074_3152_3170_3172_3204_3231_3270_3318_3318_3360_3375_3377_3388_3392_3394_3397_
845,3,居民區,N,3,4,7,892_900_,3306_3480_3482_
846,1,懷舊,Vi,1,0,1,,
846,1,到臨,Vi,1,0,1,,
846,1,寸土寸金,Vi,3,0,3,886_894_,
846,1,購買到,Vt,1,0,1,,
846,1,幽雅,Vi,1,0,1,,
846,1,扯遠,Vt,1,0,1,,
846,3,靠山,N,1,1,2,,
846,1,全球,N,1,0,1,,
847,1,號數,N,1,0,1,,
847,3,單床,N,1,3,4,,2752_2776_
847,3,註,N,2,3,5,1423_,3448_3453_
847,1,胖,Vi,1,0,1,,
847,1,跑馬地,N,1,0,1,,
847,3,養,Vt,3,2,5,1113_1121_,3482_
847,1,地名,N,1,0,1,,
847,1,車頭,N,1,0,1,,
847,1,床位,N,1,0,1,,
847,3,醫院,N,1,7,8,,2800_3132_3360_3360_3397_3397_
848,1,超軟,Vi,1,0,1,,
849,1,叮叮,ADV,9,0,9,885_889_889_889_893_897_897_897_,
849,1,紫荊,N,1,0,1,,
849,1,儀式,N,1,0,1,,
849,1,離金,N,1,0,1,,
849,1,站出來,Vi,3,0,3,1243_1247_,
850,1,強求,Vt,1,0,1,,
851,1,漢口,N,2,0,2,860_,
851,1,道逢,N,2,0,2,860_,
852,1,星期一,N,2,0,2,861_,
852,1,八月,N,2,0,2,861_,
853,1,側看,Vt,2,0,2,862_,
853,1,不新,Vi,2,0,2,862_,
854,3,可取,Vi,2,4,6,863_,2517_2519_3235_
854,1,新界,N,2,0,2,863_,
854,3,度,Vt,2,1,3,863_,
854,1,屯門,N,4,0,4,854_863_863_,
854,1,留在,Vt,2,0,2,863_,
855,1,刷銀聯卡,N,2,0,2,864_,
856,1,半島,N,6,0,6,857_865_866_1167_1174_,
856,1,遊艇,N,2,0,2,865_,
856,3,這邊,N,2,4,6,865_,3059_3074_3099_
856,3,好友,N,2,1,3,865_,
856,1,東南亞菜,N,2,0,2,865_,
856,1,錯不了,Vi,2,0,2,865_,
856,3,無敵,Vi,5,1,6,865_889_897_1409_,
856,1,渡假,Vi,4,0,4,859_865_868_,
856,3,露台,N,2,1,3,865_,
856,1,入時,Vi,2,0,2,865_,
856,3,六樓,N,2,1,3,865_,
856,3,吃完,Vt,5,3,8,865_1087_1145_1238_,2757_2758_
856,3,平方,N,2,5,7,865_,2372_2375_2391_3307_
857,3,名,Vt,4,3,7,866_1294_1298_,3488_3490_
857,3,忠告,N,2,3,5,866_,2555_3076_
857,3,黃金海岸,N,2,2,4,866_,3385_
857,1,下載,Vt,2,0,2,866_,
857,1,青年會,N,4,0,4,866_914_914_,
858,1,搭上,Vt,2,0,2,867_,
858,3,十全十美,Vi,2,2,4,867_,2308_
870,3,平台,N,4,1,5,878_1319_1324_,
870,3,反正,ADV,8,26,34,878_885_893_935_1020_1171_1178_,2098_2104_2161_2234_2247_2318_2319_2432_2435_2464_2466_2541_2737_2931_3007_3036_3195_3202_3233_3253_3313_3351_3397_3409_3418_
870,3,好不容易,ADV,2,10,12,878_,2102_2272_2272_2528_2828_3038_3039_3329_3333_
870,3,受騙,Vi,2,1,3,878_,
871,3,洗衣服,Vi,2,2,4,879_,3188_
871,3,放回,Vt,2,3,5,879_,3298_3301_
871,1,洗面盆,N,2,0,2,879_,
871,1,指定為,Vt,2,0,2,879_,
871,3,不幸,Vi,2,3,5,879_,3495_3497_
871,3,冷水,N,2,6,8,879_,3201_3433_3435_3448_3453_
871,3,等於,Vt,2,3,5,879_,2898_2964_
871,3,好處,N,3,6,9,879_1429_,2189_2249_2251_2269_2274_
872,1,朗豪,N,2,0,2,880_,
872,1,纜車,N,2,0,2,880_,
872,1,橡木,N,2,0,2,880_,
872,1,免稅店,N,2,0,2,880_,
872,1,攜程報,N,2,0,2,880_,
872,1,朗庭,N,2,0,2,880_,
872,1,迪斯尼,N,2,0,2,880_,
872,1,價券,N,2,0,2,880_,
872,1,幸運,Vi,3,0,3,880_934_,
872,1,受寵若驚,Vi,2,0,2,880_,
872,3,小朋友,N,2,1,3,880_,
872,3,美國,N,2,5,7,880_,2798_2800_3312_3345_
872,3,桌,N,2,4,6,880_,2790_2790_3201_
872,1,游個泳,N,2,0,2,880_,
872,1,自由行,Vi,2,0,2,880_,
874,3,惟獨,ADV,2,1,3,882_,
875,1,轉接,Vt,2,0,2,883_,
875,3,三亞,N,6,7,13,883_1088_1088_1425_1425_,3253_3253_3253_3253_3272_3272_
875,3,喜,Vt,6,4,10,883_1087_1089_1423_1425_,2361_3047_3051_
875,1,盡興,Vi,2,0,2,883_,
875,1,備有,Vt,3,0,3,883_1251_,
875,3,縫,N,2,1,3,883_,
876,1,嗡嗡,ADV,2,0,2,884_,
876,1,采光,N,2,0,2,884_,
876,3,勸,Vt,2,7,9,884_,2045_2486_2782_3119_3124_3477_
876,3,銀子,N,2,1,3,884_,
876,1,憋屈,Vt,2,0,2,884_,
876,1,老年,N,2,0,2,884_,
885,1,８月,N,2,0,2,893_,
885,1,１日,N,2,0,2,893_,
885,1,一般來說,ADV,2,0,2,893_,
885,1,動漫,N,2,0,2,893_,
885,3,比價,Vi,2,1,3,893_,
885,1,出發到,Vt,2,0,2,893_,
885,1,俗稱,Vt,2,0,2,893_,
885,1,一舉兩得,Vi,2,0,2,893_,
885,1,提早,Vt,2,0,2,893_,
885,1,側面,N,2,0,2,893_,
885,1,看準,Vt,2,0,2,893_,
885,3,看起來,ADV,3,15,18,893_1091_,2163_2198_2260_2261_2263_2265_2380_2412_2606_2948_3013_3074_3288_3466_
885,1,闊落,Vi,2,0,2,893_,
885,1,上環,N,10,0,10,885_888_889_889_893_893_896_897_897_,
885,1,海鮮價,N,4,0,4,887_893_895_,
885,1,港鐵站,N,2,0,2,893_,
885,3,體會,Vt,2,1,3,893_,
885,1,安置,Vt,2,0,2,893_,
885,3,確,ADV,4,4,8,893_1217_1425_,2097_2322_2771_
886,1,安頓好,Vt,2,0,2,894_,
886,1,暈暈,Vi,2,0,2,894_,
886,3,乎乎,Vt,2,1,3,894_,
886,3,坐大,Vi,2,1,3,894_,
886,3,怎樣,ADV,4,13,17,894_1019_1057_,2225_2226_2309_2522_2700_2701_3071_3071_3098_3186_3188_3282_
886,3,何處,N,2,1,3,894_,
886,1,巴過,Vt,2,0,2,894_,
886,3,報,Vt,2,8,10,894_,2372_2375_2530_2579_2812_3487_3487_
886,3,壓,Vt,4,3,7,894_1319_1324_,3289_3290_
886,1,回過味,N,2,0,2,894_,
886,1,比迪斯尼,N,2,0,2,894_,
886,3,解釋,N,2,49,51,894_,2040_2205_2211_2229_2284_2287_2288_2360_2361_2372_2375_2502_2517_2517_2519_2519_2616_2690_2731_2742_2761_2762_2776_2816_2818_2847_2889_2890_2956_2957_2972_2972_3049_3083_3115_3132_3174_3213_3218_3255_3256_3260_3283_3289_3290_3397_3448_3453_
887,1,收入,N,3,0,3,895_1292_,
887,1,雲吞麵,N,2,0,2,895_,
887,1,狂喜,Vi,2,0,2,895_,
887,3,語氣,N,2,5,7,895_,2085_2746_3448_3453_
887,3,辦好,Vt,2,4,6,895_,2375_2970_3253_
887,3,上到,Vt,2,4,6,895_,2744_2933_3253_
887,3,放好,Vt,2,4,6,895_,2247_2769_2770_
887,3,物價,N,3,1,4,895_957_,
887,1,主婦,N,2,0,2,895_,
887,1,疲勞,Vi,2,0,2,895_,
887,1,小店,N,2,0,2,895_,
887,3,輕聲,ADV,2,1,3,895_,
887,1,狠心,Vi,2,0,2,895_,
887,1,順道,ADV,2,0,2,895_,
887,1,再下去,ADV,2,0,2,895_,
887,1,菜市場,N,2,0,2,895_,
887,3,民居,N,2,2,4,895_,2720_
888,3,大學,N,2,1,3,896_,
888,1,左轉,Vi,2,0,2,896_,
888,1,當當車,N,2,0,2,896_,
888,1,港大,N,2,0,2,896_,
889,3,費時,Vi,2,1,3,897_,
889,3,開不了,Vt,2,6,8,897_,2247_2390_2828_2828_2869_
889,1,讓人,N,3,0,3,897_961_,
889,1,眾位,N,2,0,2,897_,
889,1,看上,Vt,4,0,4,897_1181_1187_,
889,1,問完,Vt,2,0,2,897_,
889,1,張照,N,2,0,2,897_,
889,1,敲碎,Vt,2,0,2,897_,
889,1,上會,N,2,0,2,897_,
889,3,寫錯,Vt,2,2,4,897_,3282_
889,3,遂,ADV,2,2,4,897_,2245_
889,3,那,ADV,2,15,17,897_,2232_2527_2718_2721_2730_2746_2750_2864_3159_3265_3371_3418_3489_3491_
889,3,崩潰,Vi,2,6,8,897_,3172_3433_3433_3435_3435_
889,1,明報,N,2,0,2,897_,
889,3,拍,Vt,2,4,6,897_,2945_3376_3378_
889,3,英文,N,2,8,10,897_,2264_2326_2757_2757_2758_2758_2996_
889,1,慣,Vt,2,0,2,897_,
889,1,終點,N,2,0,2,897_,
889,1,亂放,Vt,2,0,2,897_,
889,3,歐洲杯,N,3,3,6,897_1366_,2702_2702_
889,3,門卡,N,3,8,11,897_1451_,2089_2561_2561_2562_2562_2747_2747_
889,3,隨手,ADV,2,5,7,897_,2769_2770_3488_3490_
889,1,井井有條,Vi,2,0,2,897_,
889,1,晃蕩,Vi,4,0,4,889_897_897_,
889,1,為佳,Vi,2,0,2,897_,
889,3,房號,N,2,8,10,897_,2360_2361_2361_2416_2671_2731_3282_
889,3,單人床,N,4,5,9,897_1270_1273_,2639_3332_3433_3435_
889,3,頻道,N,4,8,12,897_1366_1366_,2057_2163_2702_2702_2702_2915_3153_
889,1,街坊,N,2,0,2,897_,
889,1,兼有,Vt,2,0,2,897_,
889,3,意思,N,5,12,17,897_1034_1384_1423_,2318_2319_2707_2708_3163_3163_3163_3246_3296_3388_3473_
889,3,半死,Vi,2,1,3,897_,
889,1,駛向,Vt,2,0,2,897_,
890,3,行業,N,2,7,9,898_,2315_2815_3049_3139_3495_3497_
890,1,淺水灣,N,2,0,2,898_,
890,3,問路,Vi,2,2,4,898_,2795_
890,1,眉頭,N,2,0,2,898_,
890,1,皺,Vt,2,0,2,898_,
891,1,金碧輝煌,Vi,2,0,2,899_,
891,1,大王,N,2,0,2,899_,
891,1,鍋貼,N,2,0,2,899_,
891,1,輪船,N,2,0,2,899_,
891,1,海鮮街,N,2,0,2,899_,
891,3,這兒,N,2,7,9,899_,2756_2907_3013_3364_3405_3410_
892,3,景觀,N,7,5,12,900_1168_1175_1296_1300_1437_,2881_2954_3146_3146_
901,3,大陸,N,1,3,4,,2717_2720_
901,1,定房住,Vt,2,0,2,901_,
901,1,.07年,N,1,0,1,,
901,3,火鍋,N,3,5,8,1385_1386_,2537_2538_2538_3141_
901,1,大眾化,Vt,1,0,1,,
901,1,全世,N,1,0,1,,
901,1,名牌,N,2,0,2,907_,
901,3,6日,N,3,3,6,1032_1062_,2924_3203_
901,1,荃灣,N,2,0,2,907_,
901,1,界,N,1,0,1,,
901,1,健身室,N,1,0,1,,
901,1,新婚,Vi,1,0,1,,
901,1,28樓,N,2,0,2,1146_,
902,3,習慣性,N,1,2,3,,3083_
902,3,建設,N,1,9,10,,2226_2378_2549_2549_2550_2550_3367_3368_
902,1,迷糊,Vi,1,0,1,,
902,1,鉤,N,1,0,1,,
902,1,標示牌,N,1,0,1,,
902,1,打算給,Vt,1,0,1,,
902,1,用攜程,N,3,0,3,1127_1134_,
902,3,人才,N,1,2,3,,2858_
902,3,所在,N,1,2,3,,2519_
902,3,2日,N,7,12,19,982_1169_1176_1202_1480_1487_,2582_2608_2909_2910_2946_3013_3071_3103_3223_3480_3482_
902,3,偏遠,Vi,1,4,5,,2034_2901_3360_
903,1,兌,Vt,1,0,1,,
903,1,路標,N,1,0,1,,
903,1,一下人,N,1,0,1,,
904,3,地帶,N,1,1,2,,
904,1,消夜,N,1,0,1,,
904,3,文,N,1,1,2,,
904,1,房大,N,1,0,1,,
904,1,夜晚系,N,1,0,1,,
904,1,系荃灣,N,1,0,1,,
904,3,中等,A,3,1,4,954_1292_,
906,3,保險箱,N,2,7,9,910_,2770_3001_3132_3296_3296_3296_
906,1,通達,Vt,1,0,1,,
906,1,面巾紙,N,1,0,1,,
906,1,小童,N,1,0,1,,
906,1,電冰箱,N,1,0,1,,
906,1,話坐,Vi,1,0,1,,
906,3,吹風,Vi,3,1,4,1001_1049_,
907,3,悅,Vt,2,2,4,907_,3466_
907,1,星期六,N,1,0,1,,
907,3,商舖,N,1,1,2,,
907,3,旅遊,Vi,6,13,19,998_1171_1178_1251_1425_,2302_2332_2388_2458_2547_2793_2881_3032_3033_3129_3130_3274_
908,1,腔挲扂,N,1,0,1,,
908,1,怢督,N,1,0,1,,
908,1,湮散,Vi,2,0,2,908_,
908,1,疑珨,N,2,0,2,908_,
908,1,??,Vi,1,0,1,,
908,1,蛂剩,Vi,1,0,1,,
908,1,竭船,N,2,0,2,908_,
908,1,憩稛,N,1,0,1,,
908,1,餚,N,1,0,1,,
908,1,斮疶坴挲,Vi,1,0,1,,
908,1,陶,N,1,0,1,,
908,1,祥岆,N,2,0,2,908_,
908,1,腔岆,N,2,0,2,908_,
908,1,饒弇,N,1,0,1,,
908,1,豖滇腔,N,1,0,1,,
908,1,淩,N,1,0,1,,
908,1,疑,N,2,0,2,1211_,
908,1,散奧,N,1,0,1,,
908,1,鋒眒,N,1,0,1,,
908,1,祥眭耋,N,2,0,2,908_,
908,1,掞剩,Vi,1,0,1,,
910,1,油麻地,N,2,0,2,912_,
910,1,地鐵線,N,1,0,1,,
910,1,基督教會,N,1,0,1,,
910,3,配合,Vt,1,1,2,,
910,3,牆面,N,3,3,6,1244_1248_,2547_2743_
910,1,會首,N,1,0,1,,
910,1,站通,N,1,0,1,,
910,1,三角形,N,1,0,1,,
910,1,所屬,A,1,0,1,,
910,1,靠墊,N,2,0,2,1007_,
910,1,出水量,N,1,0,1,,
910,3,結構,N,2,6,8,970_,2453_2710_2712_2740_2750_
910,1,旅遊行,N,1,0,1,,
910,3,臥室,N,1,8,9,,2054_2252_2252_2253_2253_3239_3345_
910,1,掛壁,N,1,0,1,,
912,3,幸虧,ADV,2,4,6,1019_,2861_3025_3027_
912,1,要不得,Vi,1,0,1,,
912,3,媽,N,1,3,4,,2162_3274_
912,3,門衛,N,1,1,2,,
913,3,品,N,2,1,3,1005_,
915,1,頂層,N,1,0,1,,
915,3,從未,ADV,1,9,10,,2300_2363_2392_2767_2798_2800_2813_2923_
915,3,客廳,N,1,3,4,,3103_3345_
916,3,天橋,N,3,3,6,916_917_,2384_2384_
916,1,天星,N,1,0,1,,
916,1,曬太陽,Vi,1,0,1,,
916,1,回選,Vt,1,0,1,,
916,1,走法,N,1,0,1,,
916,3,長廊,N,1,1,2,,
917,3,走過,Vt,1,1,2,,
917,1,皇帝,N,1,0,1,,
917,1,宏基,N,1,0,1,,
917,3,總理,N,1,1,2,,
917,1,朱熔基,N,1,0,1,,
917,3,飲茶,Vi,1,4,5,,2964_2964_2964_
917,1,一本正經,Vi,1,0,1,,
917,1,紅頭,N,1,0,1,,
917,1,和藹可親,Vi,1,0,1,,
917,1,一級,N,1,0,1,,
917,3,老實說,ADV,1,1,2,,
917,1,創意,N,2,0,2,917_,
917,1,阿三,N,1,0,1,,
917,1,爺爺,N,1,0,1,,
919,3,區域,N,1,6,7,,2678_2730_3345_3448_3453_
921,1,授信,N,1,0,1,,
921,3,怪異,Vi,1,5,6,,2090_2093_3170_3172_
921,1,天星輪,N,1,0,1,,
921,1,拼起來,Vi,1,0,1,,
921,1,額度,N,1,0,1,,
921,1,柯布達,N,1,0,1,,
921,3,做法,N,1,9,10,,2463_2465_2584_2690_2700_2701_2879_2880_
921,1,夜光場,N,1,0,1,,
921,3,擺出,Vt,1,1,2,,
921,3,撕,Vt,1,2,3,,3487_
921,1,攢,Vt,1,0,1,,
921,1,玩具,N,1,0,1,,
921,1,駱克道,N,2,0,2,921_,
921,1,一貫,A,2,0,2,1051_,
921,1,造型,N,2,0,2,1091_,
922,1,九鐵,N,2,0,2,930_,
923,1,暫時,ADV,2,0,2,931_,
923,1,花園街,N,2,0,2,931_,
923,1,換算,Vt,2,0,2,931_,
923,3,太子,N,2,1,3,931_,
923,3,賬,N,2,2,4,931_,2834_
923,1,東站,N,2,0,2,931_,
923,3,聲明,N,2,4,6,931_,2097_2272_2498_
923,1,定點,Vi,2,0,2,931_,
923,3,急忙,ADV,2,1,3,931_,
923,1,提升到,Vt,2,0,2,931_,
923,3,正比,N,2,3,5,931_,2252_2253_
923,1,箱包,N,2,0,2,931_,
923,3,運動,N,3,5,8,931_1049_,2761_2762_2882_2882_
923,3,住滿,Vt,2,2,4,931_,2600_
923,1,羅湖,N,2,0,2,931_,
923,1,便捷,Vi,7,0,7,931_1071_1078_1141_1143_1345_,
924,1,30分鐘隊,N,2,0,2,932_,
924,1,雞尾酒,N,2,0,2,932_,
924,3,將近,Vi,4,11,15,932_1383_1430_,2516_2518_2554_2555_2564_2606_2806_2946_3253_3341_
924,3,辛苦,Vt,2,1,3,932_,
924,3,排,Vt,6,4,10,924_932_932_1108_1116_,2259_3098_3347_
924,1,享用到,Vt,2,0,2,932_,
924,3,面子,N,2,1,3,932_,
929,3,同級,N,2,3,5,937_,3154_3155_
929,1,重裝,A,2,0,2,937_,
934,1,帝京住,Vt,1,0,1,,
934,1,親善,A,1,0,1,,
934,1,18樓,N,1,0,1,,
935,3,情願,Vt,1,9,10,,2445_2446_2516_2518_2534_2553_2740_2988_
938,3,老是,ADV,4,1,5,1112_1120_1409_,
938,3,能否,ADV,1,5,6,,2288_2353_3433_3435_
938,1,換樓塵,N,1,0,1,,
938,3,方方,Vi,1,1,2,,
938,3,老樣子,N,1,1,2,,
939,3,網費,N,1,1,2,,
939,3,用到,Vt,1,1,2,,
940,1,出口到,Vt,1,0,1,,
941,3,十月,N,1,1,2,,
942,1,殯儀館,N,2,0,2,943_,
943,3,梳子,N,1,1,2,,
943,1,不妥,Vi,1,0,1,,
943,1,貼牆,N,1,0,1,,
943,1,指路,Vi,1,0,1,,
943,3,客服,N,4,12,16,1224_1226_1451_,2675_2677_2775_2945_3184_3270_3270_3388_3470_3470_3470_
943,3,緊貼,Vt,1,1,2,,
943,3,臨近,Vt,1,5,6,,2856_3016_3228_3229_
943,1,便器,N,1,0,1,,
943,1,大家樂,N,1,0,1,,
943,1,大自在,Vi,1,0,1,,
944,3,信,N,1,9,10,,2684_2687_2824_2826_2945_3015_3206_3463_
944,3,節省,Vt,1,2,3,,2946_
944,1,精確,Vi,1,0,1,,
944,1,示,Vt,1,0,1,,
946,1,油點,N,1,0,1,,
946,1,開線,Vi,1,0,1,,
946,1,乾洗,Vt,1,0,1,,
946,1,仿古,Vi,1,0,1,,
947,1,寫意,Vi,3,0,3,1439_1444_,
947,1,南湖,N,2,0,2,947_,
948,1,別緻,Vi,2,0,2,972_,
948,1,鄰湖,N,1,0,1,,
948,3,作,Vt,2,13,15,1348_,2247_2406_2408_2690_2746_2747_2761_2762_2793_2869_3073_3319_
948,3,電腦桌,N,1,1,2,,
948,3,跑上來,Vi,1,1,2,,
948,1,一覽無餘,Vi,1,0,1,,
948,1,匹薩,N,1,0,1,,
949,3,後果,N,2,1,3,1019_,
949,1,撞進,Vt,1,0,1,,
949,1,堂皇,Vi,1,0,1,,
950,1,招商,Vi,1,0,1,,
954,3,長春,N,2,10,12,957_,2167_2167_2167_2359_2680_2680_2828_2949_3001_
957,3,雙早,N,2,3,5,1451_,2893_2986_
957,3,被褥,N,2,8,10,985_,2705_2706_2939_2940_2976_3446_3485_
957,3,人聲,N,1,2,3,,3370_
958,1,小賣部買點,N,1,0,1,,
958,3,方便麵,N,1,1,2,,
958,3,10點鐘,N,1,1,2,,
958,3,訂餐,N,1,2,3,,2102_
959,3,漢庭,N,2,8,10,960_,2919_3049_3487_3487_3487_3487_3487_
960,1,越,ADV,2,0,2,960_,
960,1,後勤,N,1,0,1,,
960,3,定期,ADV,1,2,3,,2949_
960,3,床頭燈,N,1,4,5,,2893_2923_2969_
960,3,旅行網,N,1,2,3,,3345_
960,3,檢修,Vt,1,1,2,,
960,1,忽視,Vt,1,0,1,,
960,1,待人,Vi,1,0,1,,
960,1,祝攜程,N,1,0,1,,
961,3,彈簧,N,1,5,6,,2909_2910_3022_3023_
962,1,恐龍園,N,1,0,1,,
962,3,麵包,N,1,4,5,,3360_3360_3360_
962,1,站台,Vi,1,0,1,,
962,1,過期,Vi,2,0,2,1430_,
962,3,制服,N,1,4,5,,2359_2572_2907_
962,3,說錯,Vt,1,2,3,,2361_
962,1,花花,Vi,1,0,1,,
962,1,虎丘,N,2,0,2,963_,
963,1,定園,N,1,0,1,,
963,1,寒山寺,N,1,0,1,,
963,1,金門路,N,1,0,1,,
963,1,留園,N,2,0,2,964_,
964,3,乘坐,Vt,1,3,4,,3255_3256_
964,3,板,N,1,5,6,,2720_2737_2744_3115_
964,3,老媽,N,1,4,5,,3360_3360_3360_
964,1,套裝,N,1,0,1,,
965,1,靈活,Vi,1,0,1,,
966,3,程度,N,4,9,13,1114_1469_1470_,2025_2036_2175_2189_2204_2864_3119_3124_
966,3,壺,N,1,2,3,,3477_
966,3,枕套,N,1,7,8,,2041_2209_2210_2517_2519_2951_
966,3,電熱,A,1,1,2,,
967,3,佔,Vt,2,3,5,1238_,2382_2624_
967,1,江湖,N,1,0,1,,
967,1,亞運村,N,1,0,1,,
967,3,客滿,Vi,2,2,4,1352_,2257_
967,1,日日,ADV,1,0,1,,
968,1,情人,N,1,0,1,,
968,1,約會,N,1,0,1,,
968,1,大錢,N,1,0,1,,
970,1,忽略,Vt,1,0,1,,
970,3,採用,Vt,1,3,4,,3493_3493_
970,1,細察,Vt,1,0,1,,
970,3,木板,N,2,1,3,1350_,
971,3,清清楚楚,Vi,1,5,6,,2969_3099_3431_3432_
971,3,咳嗽聲,N,1,1,2,,
971,1,私密,Vi,1,0,1,,
973,1,調好,Vt,1,0,1,,
973,1,暢通,Vt,1,0,1,,
974,3,宜家,Vi,1,3,4,,2647_2647_
974,3,衛浴,N,1,8,9,,2596_2597_2790_3012_3321_3322_3396_
974,1,純毛,A,1,0,1,,
976,1,親和力,N,1,0,1,,
978,3,完好,Vi,1,2,3,,3218_
978,1,預期,Vt,1,0,1,,
979,3,北路,N,1,1,2,,
979,1,解放,Vt,1,0,1,,
980,3,打死,Vt,3,4,7,980_1367_,2126_3035_3194_
980,3,拉上,Vt,1,2,3,,2953_
980,1,該死,Vi,1,0,1,,
980,3,五指,N,1,2,3,,2706_
980,3,伸手,Vi,3,2,5,1319_1324_,2706_
980,3,吵醒,Vt,1,12,13,,2425_2428_2767_2795_2861_3016_3041_3204_3242_3431_3432_
981,3,暖風,N,1,6,7,,2045_2062_2868_3089_3476_
981,1,充足,Vi,1,0,1,,
982,3,調換,Vt,2,9,11,1259_,2606_2606_2740_2740_2740_2740_2873_3146_
982,1,臨時會,N,1,0,1,,
982,3,抱歉,Vt,2,17,19,982_,2226_2258_2259_2284_2454_2455_2475_2671_2702_2798_2800_2889_2890_2976_3163_3331_
982,3,程序,N,1,5,6,,2555_2671_2862_3288_
982,3,留意到,Vt,1,1,2,,
982,1,機器聲,N,1,0,1,,
982,1,惠顧,Vt,1,0,1,,
982,1,適當,Vi,1,0,1,,
982,1,避開,Vt,1,0,1,,
982,3,光,N,2,3,5,1367_,2740_3103_
982,1,恭候,Vt,2,0,2,1032_,
982,3,唐山,N,2,1,3,982_,
982,1,動工,Vi,1,0,1,,
982,1,居停,Vi,1,0,1,,
982,1,力求,Vt,2,0,2,1239_,
982,3,關注,Vt,3,1,4,1030_1030_,
982,1,接洽,Vt,1,0,1,,
982,3,萬事,N,1,2,3,,2435_
982,3,離店,N,1,14,15,,2253_2295_2337_2536_2798_2800_2902_2904_2949_3160_3308_3397_3465_
982,3,創造,Vt,1,1,2,,
982,3,深感,Vt,1,2,3,,2535_
982,1,懇請,Vt,1,0,1,,
983,3,秦皇島,N,1,1,2,,
983,1,煤,N,2,0,2,986_,
983,1,車4,N,1,0,1,,
984,1,藝術性,N,1,0,1,,
987,1,修橋,N,1,0,1,,
988,3,臭,Vi,2,10,12,988_,2297_2300_2946_2988_3253_3318_3380_3443_3443_
988,3,叫來,Vt,1,10,11,,2753_2873_2873_2917_2923_2923_2958_3175_3176_
988,1,顛倒,Vt,1,0,1,,
988,1,吭聲,Vi,1,0,1,,
988,1,鱈魚,N,1,0,1,,
988,3,容忍,Vt,1,5,6,,2124_2180_2702_3472_
988,3,黑白,A,1,3,4,,3353_3355_
988,3,片,N,1,2,3,,3333_
988,3,然,Vi,1,2,3,,2519_
988,1,香煎銀,N,1,0,1,,
988,3,上菜,Vi,1,2,3,,2976_
988,3,奇貴,Vi,1,2,3,,2688_
990,1,郝,N,3,0,3,993_1500_,
990,1,買成,Vt,2,0,2,993_,
990,1,雜割,N,2,0,2,993_,
990,3,現金,N,3,21,24,993_1041_,2232_2515_2530_2739_2893_3001_3016_3069_3069_3070_3070_3255_3256_3268_3268_3289_3289_3290_3290_3341_
990,3,飛機票,N,2,1,3,993_,
990,1,小屋,N,4,0,4,990_993_993_,
990,1,羊,N,4,0,4,991_993_994_,
991,3,正宗,N,4,5,9,994_1005_1097_,2097_2162_3175_3176_
991,1,雜店,N,2,0,2,994_,
995,3,臭氣,N,2,4,6,996_,3069_3070_3317_
995,1,呼叫,Vt,2,0,2,996_,
995,3,熏,Vt,2,5,7,996_,2997_3231_3231_3317_
995,3,下水道,N,2,5,7,996_,2162_2162_2714_3137_
998,3,服務業,N,1,6,7,,2546_2609_2609_2609_3245_
999,3,上樓,Vi,1,9,10,,2561_2562_2784_2828_3083_3119_3124_3360_
1001,1,店舖,N,1,0,1,,
1002,3,趕快,ADV,1,4,5,,2406_2408_3099_
1004,3,同等,A,2,7,9,1193_,2426_2698_3047_3051_3115_3364_
1005,3,團體,N,1,1,2,,
1005,1,西貝,N,3,0,3,1005_1005_,
1005,3,麗晶,N,2,3,5,1005_,3383_3384_
1005,3,小賣部,N,1,1,2,,
1005,3,飯館,N,1,2,3,,3107_
1005,1,次之,Vi,1,0,1,,
1005,1,敲錯門,Vt,1,0,1,,
1005,3,開會,Vi,3,6,9,1238_1348_,2548_2671_3041_3232_3334_
1005,1,商圈,N,2,0,2,1005_,
1005,1,青山區,N,4,0,4,1005_1005_1005_,
1005,3,百貨,N,3,1,4,1067_1074_,
1005,3,分,Vt,1,21,22,,2162_2162_2232_2272_2276_2392_2475_2516_2518_2520_2527_2527_2671_2752_3022_3023_3038_3039_3448_3453_
1005,1,科麗瓏,N,1,0,1,,
1005,3,量,N,3,4,7,1067_1074_,2316_3098_3237_
1005,3,包頭,N,2,5,7,1005_,2537_2538_2538_3083_
1005,3,水果刀,N,1,1,2,,
1005,3,理論,N,1,23,24,,2097_2229_2287_2288_2290_2360_2361_2483_2510_2511_2549_2549_2550_2550_2606_2836_2914_3163_3186_3188_3288_3349_
1005,3,沒關係,Vi,2,3,5,1020_,2083_2497_
1005,3,插線板,N,1,1,2,,
1005,1,筱面,N,1,0,1,,
1005,3,銀河,N,2,3,5,1005_,2815_3110_
1005,1,住正,N,1,0,1,,
1005,3,驚人,Vi,1,1,2,,
1005,1,廣式,A,1,0,1,,
1005,1,包百,N,3,0,3,1005_1005_,
1005,1,淡淡,Vi,2,0,2,1495_,
1005,1,車9,N,1,0,1,,
1005,1,昆區,N,3,0,3,1005_1005_,
1005,1,晚茶,N,1,0,1,,
1007,1,加菲貓,N,1,0,1,,
1007,1,扎眼,Vi,1,0,1,,
1007,1,圈兒椅,N,1,0,1,,
1007,1,電熨斗,N,1,0,1,,
1007,3,寢具,N,1,1,2,,
1007,3,擋住,Vt,2,2,4,1049_,2841_
1007,3,黃,Vi,1,7,8,,2854_3253_3433_3434_3435_3436_
1007,1,下方,N,1,0,1,,
1007,3,固定,Vt,1,4,5,,2555_2569_3163_
1007,1,腳伸,N,1,0,1,,
1007,3,遮擋,Vt,1,3,4,,3376_3378_
1007,1,條紋,N,1,0,1,,
1007,1,搭配,Vt,1,0,1,,
1007,3,明,N,1,5,6,,2976_3195_3448_3453_
1007,1,濕器,N,1,0,1,,
1007,3,不當,Vi,1,1,2,,
1007,1,錯開,Vt,1,0,1,,
1007,3,白色,N,1,12,13,,2209_2210_2210_2380_2824_2826_3076_3076_3253_3253_3415_
1007,1,格子,N,1,0,1,,
1007,1,燙衣板,N,1,0,1,,
1007,1,俱全,Vi,1,0,1,,
1007,1,一體,N,1,0,1,,
1007,1,冰箱櫃,N,2,0,2,1007_,
1009,3,天鵝,N,3,1,4,1442_1447_,
1009,1,稍許,ADV,1,0,1,,
1010,1,洪崖洞,N,1,0,1,,
1011,1,國航,N,1,0,1,,
1013,1,申定,N,1,0,1,,
1015,1,連雲港,N,1,0,1,,
1016,1,自,ADV,2,0,2,1016_,
1016,1,隱蔽,Vi,1,0,1,,
1016,1,板凳,N,1,0,1,,
1016,3,網線,N,3,25,28,1016_1201_,2221_2649_2738_2809_2809_2809_3119_3119_3124_3124_3196_3196_3196_3264_3264_3281_3333_3333_3386_3386_3431_3431_3432_3432_
1016,3,床頭櫃,N,1,6,7,,2252_2253_2324_2567_2899_
1016,3,哪兒,N,1,2,3,,3013_
1016,1,比高,N,1,0,1,,
1016,1,翻過來,Vi,1,0,1,,
1016,1,接口,ADV,1,0,1,,
1016,3,垃圾桶,N,1,1,2,,
1017,1,北陵,N,1,0,1,,
1018,3,婚禮,N,1,2,3,,3132_
1019,3,護照,N,1,1,2,,
1020,3,不起眼,Vi,1,1,2,,
1020,1,數一數二,Vi,1,0,1,,
1020,1,飽覽,Vt,1,0,1,,
1020,1,蜿蜒,Vi,1,0,1,,
1020,1,新錦江,N,1,0,1,,
1020,3,預定單,N,1,1,2,,
1020,1,光亮,Vi,1,0,1,,
1020,1,鴨綠江,N,5,0,5,1020_1020_1408_1413_,
1020,1,沙洲,N,1,0,1,,
1020,1,小城,N,1,0,1,,
1020,3,當年,N,1,1,2,,
1020,1,拚,Vi,1,0,1,,
1020,1,農田,N,2,0,2,1020_,
1020,1,邊境,N,1,0,1,,
1020,3,深圳,N,9,11,20,1309_1310_1311_1313_1314_1315_1320_1325_,2283_2432_2435_2642_2646_3110_3111_3154_3155_3231_
1020,3,丹東,N,8,5,13,1020_1020_1020_1020_1020_1020_1409_,2287_2287_2288_2288_
1020,3,接待員,N,4,1,5,1020_1020_1497_,
1020,1,鴨綠江橋,N,1,0,1,,
1020,1,異國風光,N,1,0,1,,
1020,1,眼前,N,1,0,1,,
1020,1,隱約,ADV,1,0,1,,
1020,1,留下來,Vi,1,0,1,,
1020,3,江景房,N,3,2,5,1303_1306_,3237_
1021,1,廉價貨,N,1,0,1,,
1021,3,洗頭液,N,1,1,2,,
1023,1,不失為,Vt,1,0,1,,
1023,3,年齡,N,1,2,3,,3173_
1024,3,費勁,Vi,3,2,5,1183_1189_,2446_
1025,3,說服,Vt,1,1,2,,
1025,1,取到,Vt,1,0,1,,
1025,3,哪怕,Vt,1,3,4,,2466_3246_
1025,3,層,N,2,1,3,1201_,
1025,3,零星,Vi,1,1,2,,
1025,1,服務部,N,1,0,1,,
1025,1,1樓,N,3,0,3,1063_1235_,
1026,1,凌亂,Vi,1,0,1,,
1026,3,馬虎,Vi,1,3,4,,2253_2988_
1028,1,發揚,Vt,2,0,2,1029_,
1028,1,客務,N,3,0,3,1029_1030_,
1028,3,肚子,N,1,8,9,,2273_2561_2562_2601_2742_2867_3360_
1028,3,尊,N,2,1,3,1029_,
1028,3,客,N,3,11,14,1029_1061_,2463_2465_2608_2608_2609_2759_3032_3033_3074_3347_
1028,1,捧,Vt,1,0,1,,
1028,1,進取,Vi,1,0,1,,
1028,1,溧陽,N,16,0,16,1028_1028_1028_1029_1029_1029_1029_1029_1030_1030_1030_1030_1031_1031_1032_,
1028,3,金陵,N,14,2,16,1028_1028_1028_1029_1029_1029_1029_1029_1030_1030_1030_1031_1032_,2361_
1029,3,穿,Vt,1,12,13,,2211_2264_2359_2512_2572_2636_2671_2861_2907_3352_3354_
1030,3,衷心,Vi,2,3,5,1031_,2858_3049_
1030,3,5日,N,3,10,13,1309_1313_,2114_2117_2154_2231_2417_2551_2924_3258_3459_
1030,3,召集,Vt,1,1,2,,
1030,3,併入,Vt,1,2,3,,2361_
1031,1,淋浴水,N,1,0,1,,
1031,1,擠成,Vt,1,0,1,,
1031,1,秩序,N,1,0,1,,
1031,1,公務,N,1,0,1,,
1031,1,鼓舞,Vt,1,0,1,,
1031,3,車輛,N,1,2,3,,3016_
1031,1,自信,Vt,1,0,1,,
1031,3,穩,Vi,1,2,3,,3125_
1031,3,水壓,N,2,4,6,1454_,2721_3187_3189_
1032,1,分享,Vt,2,0,2,1211_,
1032,1,討論會,N,1,0,1,,
1032,3,專題,N,1,1,2,,
1032,1,星樓,N,1,0,1,,
1032,1,致力,Vt,7,0,7,1167_1168_1173_1174_1175_1180_,
1032,3,始終,ADV,1,5,6,,2535_3084_3433_3435_
1033,3,理睬,Vt,1,2,3,,3360_
1034,3,顯示,Vt,1,9,10,,2690_2690_2698_2747_2750_2872_3296_3414_
1036,1,斷線,Vi,2,0,2,1450_,
1036,1,食街,N,1,0,1,,
1037,3,請客,Vi,1,2,3,,3355_
1037,3,包房,N,2,1,3,1472_,
1038,3,冬季,N,2,2,4,1088_,2949_
1038,3,沒用,Vi,1,10,11,,2554_2555_2746_3253_3266_3405_3410_3458_3458_
1039,1,單一,Vi,1,0,1,,
1040,1,私家菜,N,1,0,1,,
1040,1,院,N,1,0,1,,
1040,1,宜興,N,4,0,4,1044_1044_1050_,
1041,1,恰,ADV,1,0,1,,
1041,1,機壞,N,1,0,1,,
1041,3,預付,Vt,1,1,2,,
1042,1,腦,N,1,0,1,,
1042,3,協商,Vt,1,2,3,,2771_
1044,3,表面,N,1,2,3,,3386_
1045,1,拿份,N,1,0,1,,
1047,3,有意思,Vi,4,3,7,1211_1270_1273_,2492_3331_
1047,1,小姑娘,N,1,0,1,,
1047,3,熟,Vi,1,2,3,,2762_
1048,1,派頭,N,1,0,1,,
1049,1,團氿,N,1,0,1,,
1049,3,內飾,N,1,2,3,,2089_
1049,3,樸素,Vi,1,1,2,,
1049,1,區位,N,1,0,1,,
1049,1,湖面,N,1,0,1,,
1049,1,高檔,N,1,0,1,,
1049,1,健身區,N,1,0,1,,
1051,3,怎麼說,Vi,1,3,4,,2390_2861_
1054,1,冰凍,Vt,1,0,1,,
1054,1,紅茶,N,1,0,1,,
1054,3,致歉,Vi,1,5,6,,2608_2609_2775_3231_
1054,3,提供給,Vt,1,1,2,,
1054,1,冷飲,N,1,0,1,,
1054,3,原諒,Vt,1,2,3,,3269_
1054,3,加收,Vt,1,18,19,,2081_2083_2239_2380_2554_2554_2554_2555_2555_2555_2876_3253_3255_3256_3288_3288_3460_
1054,3,商量,Vt,1,6,7,,2742_3099_3099_3146_3162_
1054,1,照攜程價,N,1,0,1,,
1054,1,北虹路店,N,1,0,1,,
1054,3,未能,ADV,1,2,3,,2762_
1054,1,互換,Vt,2,0,2,1054_,
1054,1,借過,Vi,1,0,1,,
1054,1,指甲剪,N,2,0,2,1054_,
1054,1,樂意,Vt,2,0,2,1423_,
1055,1,縮小,Vt,1,0,1,,
1057,3,脫落,Vi,1,2,3,,3076_
1057,3,泰山,N,7,1,8,1057_1058_1061_1062_1062_1062_,
1057,3,華僑,N,7,2,9,1057_1057_1057_1061_1062_1062_,2166_
1057,3,紙,N,1,10,11,,2360_2361_2521_2610_2790_2987_3214_3219_3318_
1057,3,多久,N,1,9,10,,2163_2775_2939_2940_3289_3290_3433_3435_
1059,1,材質,N,1,0,1,,
1059,3,評級,N,2,4,6,1082_,2516_2518_3385_
1060,3,變,Vi,1,3,4,,2793_3103_
1060,1,報出,Vt,1,0,1,,
1061,3,氣溫,N,1,5,6,,3181_3194_3425_3470_
1061,1,泰城,N,1,0,1,,
1061,3,泰安,N,2,4,6,1061_,2318_2319_2319_
1061,1,安心,Vi,1,0,1,,
1061,1,撿到,Vt,1,0,1,,
1061,1,蘇秀,N,1,0,1,,
1061,3,錢包,N,3,5,8,1061_1061_,2083_2530_3001_3001_
1061,1,屈一值,N,1,0,1,,
1061,3,爬,Vi,1,9,10,,2530_2931_3119_3124_3177_3187_3189_3473_
1061,3,當即,ADV,1,6,7,,2081_2083_2083_2882_3083_
1061,1,落在,Vt,2,0,2,1431_,
1062,1,紅糖,N,1,0,1,,
1062,1,先於,Vt,1,0,1,,
1062,1,不愧為,Vt,1,0,1,,
1062,3,風寒,N,1,1,2,,
1062,3,約定,Vt,1,1,2,,
1062,1,市區圖,N,1,0,1,,
1062,1,春天,N,1,0,1,,
1062,3,開口,Vi,1,4,5,,2858_3448_3453_
1062,1,姜水,N,1,0,1,,
1062,1,泰安市,N,1,0,1,,
1062,1,關切,Vt,1,0,1,,
1062,1,岱廟,N,1,0,1,,
1062,1,打噴嚏,Vi,1,0,1,,
1062,3,租車,N,1,3,4,,2595_2933_
1062,1,重遊,Vt,1,0,1,,
1063,1,桐鄉,N,3,0,3,1064_1066_,
1066,1,獲知,Vt,1,0,1,,
1066,3,細小,Vi,1,5,6,,2468_2717_2720_2752_
1066,3,毛髮,N,1,4,5,,2419_3202_3223_
1067,1,久光,N,2,0,2,1074_,
1067,1,平民,N,2,0,2,1074_,
1067,1,水果店,N,4,0,4,1074_1311_1315_,
1067,1,靜安寺,N,4,0,4,1068_1074_1075_,
1068,3,說來,ADV,2,3,5,1075_,3187_3189_
1069,3,會員卡,N,4,1,5,1073_1076_1080_,
1069,3,五樓,N,3,6,9,1076_1088_,3033_3213_3218_3388_3397_
1069,3,格林豪泰,N,2,1,3,1076_,
1070,1,中信,N,2,0,2,1077_,
1070,1,泰富,N,2,0,2,1077_,
1070,1,平行,Vi,2,0,2,1077_,
1070,1,淮海路,N,2,0,2,1077_,
1070,1,恆龍,N,2,0,2,1077_,
1070,3,一應俱全,Vi,5,2,7,1077_1105_1194_1427_,2571_
1070,1,鴨,N,2,0,2,1077_,
1070,1,離久光,N,2,0,2,1077_,
1070,1,伙食,N,2,0,2,1077_,
1070,3,閱讀,Vt,2,1,3,1077_,
1070,1,梅龍鎮,N,2,0,2,1077_,
1070,1,南京西路,N,2,0,2,1077_,
1070,1,粉絲,N,2,0,2,1077_,
1070,3,上街,Vi,2,5,7,1077_,3069_3070_3318_3318_
1070,1,冷暖,N,2,0,2,1077_,
1072,1,從前,N,4,0,4,1073_1079_1080_,
1072,1,協同,ADV,2,0,2,1079_,
1073,3,越來越,ADV,4,10,14,1080_1126_1133_,2249_2251_2745_2816_2818_3049_3152_3382_3471_
1073,1,依據,N,2,0,2,1080_,
1073,1,積,Vt,2,0,2,1080_,
1073,3,下降,Vi,4,3,7,1080_1153_1160_,3349_3470_
1081,3,下屬,N,1,1,2,,
1081,1,工行,N,1,0,1,,
1081,3,點菜,Vi,2,3,5,1081_,2419_2976_
1081,3,亂七八糟,Vi,1,1,2,,
1081,1,菜量,N,1,0,1,,
1081,3,呼市,N,2,1,3,1081_,
1081,3,主食,N,1,2,3,,2308_
1081,1,品冷,Vi,1,0,1,,
1081,1,菜價,N,2,0,2,1423_,
1081,1,金輝,N,2,0,2,1081_,
1081,1,服氣,Vi,1,0,1,,
1082,1,官方,N,1,0,1,,
1082,1,加取,Vt,1,0,1,,
1082,3,承諾,N,1,15,16,,2494_2495_2651_2654_2725_2731_2761_2762_2873_3118_3119_3124_3388_3487_
1082,1,牌,N,1,0,1,,
1084,1,爛爛,Vi,1,0,1,,
1085,1,機住,Vt,1,0,1,,
1086,1,度假區,N,3,0,3,1089_1091_,
1086,3,過道,N,1,20,21,,2057_2126_2326_2326_2342_2559_2651_2651_2654_2654_2725_2740_2740_2740_2740_2976_3013_3319_3319_
1086,1,包圍,Vt,1,0,1,,
1086,1,肚火,N,1,0,1,,
1086,1,眼看著,Vt,1,0,1,,
1087,3,封閉,Vi,1,3,4,,2519_2740_
1087,1,習習,Vi,1,0,1,,
1087,1,打轉,Vi,1,0,1,,
1087,3,米粉,N,1,3,4,,2769_2770_
1087,1,煮,Vt,1,0,1,,
1087,1,敞開式,N,1,0,1,,
1088,3,厚厚,Vi,1,1,2,,
1088,1,迫不及待,ADV,1,0,1,,
1088,3,怕熱,Vi,1,2,3,,3133_
1088,1,亞太,N,5,0,5,1088_1091_1091_1091_,
1088,1,立式,A,1,0,1,,
1088,3,要命,Vi,1,25,26,,2151_2208_2224_2339_2339_2457_2523_2671_2704_2791_2945_2976_3031_3031_3038_3039_3194_3360_3434_3436_3450_3452_3455_3457_
1088,3,事先,ADV,1,20,21,,2083_2139_2143_2208_2494_2495_2498_2532_2533_2629_2754_2754_2754_2759_2769_2770_3103_3246_3332_
1088,1,大汗,N,1,0,1,,
1088,1,期中,N,1,0,1,,
1088,3,主題,N,1,2,3,,2753_
1088,3,收銀員,N,1,1,2,,
1088,1,蘭色,N,1,0,1,,
1088,1,連吊扇,N,1,0,1,,
1088,1,淋淋,Vi,1,0,1,,
1088,1,亞龍灣住,Vt,1,0,1,,
1088,1,依依,Vi,1,0,1,,
1090,1,集市,N,1,0,1,,
1091,3,水池,N,1,1,2,,
1091,3,高層,N,13,7,20,1167_1168_1170_1172_1173_1174_1175_1177_1179_1180_1276_1283_,2162_2225_2226_2530_2671_2671_
1091,1,蜈支洲島,N,1,0,1,,
1091,3,電話機,N,1,2,3,,3172_
1091,1,觀海,Vi,1,0,1,,
1091,3,批評,N,1,10,11,,2446_2608_2609_2746_3055_3055_3055_3231_3231_
1091,1,木樓,N,1,0,1,,
1091,1,海濱,N,2,0,2,1091_,
1092,1,艦隊,N,1,0,1,,
1092,1,海軍,N,1,0,1,,
1092,1,黃興,N,1,0,1,,
1092,1,省委,N,1,0,1,,
1092,3,8樓,N,3,2,5,1092_1472_,3117_
1092,1,南海,N,1,0,1,,
1093,3,西湖,N,4,1,5,1093_1094_1094_,
1093,1,排擋,N,5,0,5,1094_1194_1228_1230_,
1095,3,改造,Vt,2,2,4,1249_,3118_
1095,3,身份證,N,1,15,16,,2301_2516_2518_2615_2615_2691_2731_2861_2861_2869_2869_2925_3312_3312_
1095,1,代金券,N,1,0,1,,
1096,1,余,Vt,1,0,1,,
1096,3,退給,Vt,1,2,3,,3083_
1096,3,社會主義,N,1,1,2,,
1096,3,用完,Vt,1,3,4,,2269_2867_
1097,3,精力,N,1,1,2,,
1097,1,復業,Vi,1,0,1,,
1097,1,廣東菜,N,1,0,1,,
1098,1,來過,Vt,1,0,1,,
1098,1,買方,N,1,0,1,,
1098,1,新酒,N,1,0,1,,
1098,1,巴結,Vt,1,0,1,,
1099,1,女門童,N,1,0,1,,
1100,1,升房,N,1,0,1,,
1100,1,升上去,Vt,1,0,1,,
1100,3,總會,ADV,1,1,2,,
1100,3,那時,N,3,1,4,1399_1423_,
1100,1,協調出,Vt,1,0,1,,
1100,3,當事人,N,1,2,3,,3231_
1102,3,東莞,N,6,4,10,1115_1115_1115_1115_1115_,2642_2646_2964_
1102,1,粵海,N,1,0,1,,
1102,3,老兄,N,1,3,4,,2933_3232_
1104,1,金魚,N,1,0,1,,
1104,1,主,Vt,1,0,1,,
1104,1,相隔,Vi,1,0,1,,
1104,3,頻,ADV,1,1,2,,
1104,3,特價房,N,1,3,4,,2855_2856_
1104,3,添,Vt,1,2,3,,3146_
1104,1,送客,Vi,1,0,1,,
1104,3,繞,Vi,1,1,2,,
1104,1,池塘,N,2,0,2,1104_,
1105,1,股份,N,1,0,1,,
1105,1,吃喝玩樂,Vi,1,0,1,,
1105,1,足不出戶,Vi,1,0,1,,
1105,1,式,N,1,0,1,,
1105,1,看頭,N,1,0,1,,
1105,1,粵菜,N,1,0,1,,
1106,3,落後,Vt,1,1,2,,
1106,3,園林,N,1,4,5,,3146_3146_3146_
1106,3,付,Vt,1,33,34,,2083_2232_2603_2605_2731_2731_2754_2761_2761_2762_2762_2842_2843_2902_2904_3069_3070_3232_3246_3253_3253_3254_3255_3255_3256_3256_3289_3290_3313_3397_3423_3424_
1106,1,庭閣,N,1,0,1,,
1106,3,鎮,N,1,1,2,,
1106,3,發票,N,5,22,27,1203_1203_1203_1203_,2101_2102_2102_2139_2139_2143_2143_2232_2232_2354_2355_2534_2588_2754_2754_3289_3290_3487_3487_3487_3487_
1106,1,樓台,N,1,0,1,,
1106,3,感激,Vt,1,1,2,,
1106,3,矮,Vi,1,3,4,,3353_3355_
1108,1,首位,N,2,0,2,1116_,
1112,1,點頭,Vi,2,0,2,1120_,
1112,1,城鎮,N,2,0,2,1120_,
1112,3,進進出出,Vt,2,1,3,1120_,
1112,3,拿過來,Vi,2,2,4,1120_,2259_
1113,1,華清池,N,2,0,2,1121_,
1113,1,魚食,N,2,0,2,1121_,
1114,3,上上下下,N,1,4,5,,3282_3341_3409_
1114,1,雅靜,N,1,0,1,,
1114,1,厭煩,Vt,1,0,1,,
1114,1,幽深,Vi,1,0,1,,
1114,1,做下,Vt,1,0,1,,
1115,1,身處,Vt,1,0,1,,
1115,3,老闆,N,1,9,10,,2232_2934_2934_3140_3184_3184_3184_3409_
1124,1,洽談,Vt,2,0,2,1131_,
1124,1,川菜,N,2,0,2,1131_,
1124,1,明紅,N,4,0,4,1124_1131_1131_,
1124,1,川菜館,N,2,0,2,1131_,
1124,1,飲食店,N,2,0,2,1131_,
1124,3,嘗,Vt,5,2,7,1124_1131_1131_1473_,2742_
1124,3,依然,ADV,4,17,21,1131_1168_1175_,2175_2356_2806_2857_2858_3341_3433_3433_3433_3433_3433_3435_3435_3435_3435_3435_
1124,1,新潮,Vi,2,0,2,1131_,
1124,1,長安,N,8,0,8,1124_1124_1127_1131_1131_1131_1134_,
1125,3,副樓,N,2,1,3,1132_,
1125,1,實有,Vt,2,0,2,1132_,
1126,1,優良,Vi,3,0,3,1133_1344_,
1127,3,競爭,N,2,6,8,1134_,2248_2250_2824_2826_3103_
1129,1,送給,Vt,2,0,2,1136_,
1129,1,訂車,N,2,0,2,1136_,
1130,3,糟,Vi,2,4,6,1137_,2259_2606_2976_
1135,1,窩心,Vi,1,0,1,,
1135,3,寶,N,1,2,3,,3364_
1135,1,生日,N,2,0,2,1378_,
1135,1,蛋糕,N,1,0,1,,
1135,1,永,ADV,1,0,1,,
1135,1,來往,Vt,1,0,1,,
1138,3,地震,Vi,1,2,3,,2638_
1138,3,四川,N,1,2,3,,2638_
1138,1,恢復過來,Vi,1,0,1,,
1138,1,災情,N,1,0,1,,
1139,1,春熙路,N,1,0,1,,
1140,1,天府,N,1,0,1,,
1140,1,牆紙略顯,N,1,0,1,,
1140,1,春曦路,N,1,0,1,,
1141,1,牛肉麵,N,2,0,2,1143_,
1141,3,信號,N,2,10,12,1143_,2324_2335_2528_2528_2688_2702_2893_2916_3454_
1141,3,金鼎,N,2,1,3,1143_,
1141,1,嘉賓,N,2,0,2,1143_,
1141,3,友誼,N,2,1,3,1143_,
1141,1,東南,N,2,0,2,1143_,
1141,3,香,N,2,1,3,1143_,
1141,3,電視台,N,2,3,5,1143_,2701_3422_
1141,3,原,A,3,7,10,1143_1199_,2362_2490_2554_2555_3222_3446_
1141,3,蘭州,N,3,6,9,1143_1437_,2140_2561_2561_2562_2562_
1141,1,素白,Vi,2,0,2,1143_,
1141,1,菜根,N,2,0,2,1143_,
1142,3,預約,Vt,2,3,5,1144_,2498_2604_
1142,1,幾月,N,2,0,2,1144_,
1145,1,賀龍,N,1,0,1,,
1145,3,體育,N,1,2,3,,2408_
1145,1,摩天輪,N,1,0,1,,
1146,1,行政層,N,1,0,1,,
1147,1,街打車,N,1,0,1,,
1148,1,總類,N,1,0,1,,
1148,3,雞蛋,N,2,6,8,1148_,2784_2951_2968_2968_3286_
1148,3,煎,Vt,2,1,3,1148_,
1149,1,食,N,2,0,2,1156_,
1149,3,西安,N,2,3,5,1156_,2284_3458_
1150,1,發達,Vi,2,0,2,1157_,
1150,1,中西部,N,2,0,2,1157_,
1150,3,感慨,N,2,1,3,1157_,
1151,1,鐘樓,N,2,0,2,1158_,
1154,3,薄,Vi,2,12,14,1161_,2953_2972_3022_3023_3171_3173_3332_3389_3390_3495_3497_
1155,3,有時候,ADV,2,7,9,1162_,2656_3038_3039_3074_3300_3303_
1155,3,擅自,ADV,4,4,8,1162_1169_1176_,2222_2674_2924_
1155,3,清掃,Vt,2,1,3,1162_,
1164,3,撥打,Vt,2,16,18,1166_,2095_2097_2097_2445_2445_2445_2446_2446_2446_2680_2680_3170_3172_3333_3483_
1164,3,柳州,N,32,5,37,1164_1166_1166_1167_1167_1168_1168_1171_1171_1171_1171_1172_1173_1173_1173_1174_1174_1175_1175_1178_1178_1178_1178_1179_1180_1180_1180_1296_1297_1300_1301_,2251_2269_3383_3384_
1167,3,即將,ADV,14,2,16,1168_1169_1170_1170_1172_1173_1174_1175_1176_1177_1177_1179_1180_,2226_
1167,3,竣工,Vi,12,2,14,1168_1169_1170_1172_1173_1174_1175_1176_1177_1179_1180_,2226_
1167,3,觀景,N,12,2,14,1168_1169_1170_1172_1173_1174_1175_1176_1177_1179_1180_,2226_
1167,1,打造,Vt,6,0,6,1168_1173_1174_1175_1180_,
1167,1,江面,N,2,0,2,1174_,
1167,3,26樓,N,12,2,14,1168_1169_1170_1172_1173_1174_1175_1176_1177_1179_1180_,2226_
1167,1,厚愛,N,6,0,6,1168_1173_1174_1175_1180_,
1168,1,柳江,N,6,0,6,1168_1169_1175_1175_1176_,
1168,1,夜幕,N,2,0,2,1175_,
1168,1,兩岸,N,2,0,2,1175_,
1168,3,時分,N,2,1,3,1175_,
1168,1,降臨,Vi,2,0,2,1175_,
1168,1,30樓,N,2,0,2,1175_,
1169,3,差錯,N,2,2,4,1176_,2843_
1169,3,深表,N,2,24,26,1176_,2177_2258_2259_2305_2308_2322_2432_2435_2589_2590_2759_2857_2858_2862_3146_3146_3231_3371_3431_3432_3448_3453_3483_
1169,3,避免,Vt,2,4,6,1176_,2603_2605_3146_
1170,3,長期,N,4,12,16,1172_1177_1179_,2097_2137_2141_2528_2743_3044_3048_3069_3070_3076_3345_
1170,3,爭取,Vt,2,1,3,1177_,
1170,1,申報,Vt,2,0,2,1177_,
1171,3,書店,N,2,3,5,1178_,3448_3453_
1171,1,柳州市,N,2,0,2,1178_,
1171,1,娛,Vt,2,0,2,1178_,
1172,3,江景,N,3,6,9,1179_1409_,3239_3239_3239_3239_3239_
1172,3,南面,N,2,1,3,1179_,
1172,3,北面,N,2,3,5,1179_,2671_2671_
1172,3,大力,ADV,3,2,5,1179_1423_,2253_
1181,3,誠意,N,2,2,4,1187_,3231_
1181,1,水龍頭水,N,2,0,2,1187_,
1181,3,廚房,N,2,11,13,1187_,2434_2734_2734_3047_3051_3098_3331_3345_3417_3427_
1182,1,有定餐,N,2,0,2,1188_,
1183,3,製冷,Vi,3,6,9,1189_1375_,2630_3194_3223_3434_3436_
1183,3,相距,Vt,2,2,4,1189_,3011_
1183,3,功率,N,2,2,4,1189_,3189_
1183,1,制熱,N,2,0,2,1189_,
1185,1,松江,N,2,0,2,1191_,
1186,3,經濟性,N,2,3,5,1192_,2053_2421_
1195,3,優惠,Vt,2,3,5,1198_,2838_3345_
1195,1,烏市,N,2,0,2,1198_,
1197,3,改觀,Vi,2,2,4,1200_,3027_
1197,1,2005年,N,2,0,2,1200_,
1199,3,原價,N,1,4,5,,2232_2702_3146_
1201,3,折扣,N,1,1,2,,
1201,1,嶄新,A,1,0,1,,
1201,3,參考,N,1,5,6,,2813_3160_3264_3347_
1201,1,出港,Vi,1,0,1,,
1201,3,剩餘,Vt,1,3,4,,2589_3184_
1201,1,提取,Vt,1,0,1,,
1202,1,等級,N,1,0,1,,
1202,1,蝸牛,N,1,0,1,,
1203,3,著急,Vi,1,3,4,,2846_3319_
1203,3,前廳部,N,1,1,2,,
1203,3,委託,Vt,1,1,2,,
1203,1,月底,N,1,0,1,,
1203,1,掛號信,N,1,0,1,,
1203,1,葉,N,2,0,2,1203_,
1203,3,郵政,N,1,2,3,,2880_
1203,1,嘉興,N,1,0,1,,
1203,3,模糊,Vi,2,6,8,1203_,2960_2962_3308_3433_3435_
1203,3,抗議,Vt,1,6,7,,2245_2309_2510_2511_3247_
1203,3,蓋章,Vi,1,7,8,,2361_3038_3038_3039_3039_3193_
1203,3,財務,N,3,4,7,1203_1203_,3001_3487_3487_
1203,1,開具,Vt,1,0,1,,
1203,1,寄給,Vt,1,0,1,,
1203,1,重開,Vt,1,0,1,,
1204,1,外圍,N,1,0,1,,
1204,1,達標,N,1,0,1,,
1204,1,泳褲,N,1,0,1,,
1205,1,住５星,N,1,0,1,,
1207,3,住住,Vt,3,3,6,1475_1482_,2779_2779_
1207,1,層面,N,1,0,1,,
1208,1,欣喜,Vi,1,0,1,,
1208,1,西部,N,2,0,2,1214_,
1208,3,鼻血,N,1,1,2,,
1208,3,器,N,2,1,3,1211_,
1208,3,流,Vt,1,5,6,,2509_2509_2522_2662_
1211,1,禁不住,Vt,1,0,1,,
1211,1,廣東,N,3,0,3,1326_1334_,
1211,3,羊肉,N,1,3,4,,2538_3476_
1211,1,忐忑,Vi,1,0,1,,
1211,3,安全感,N,1,7,8,,2050_2053_2198_2521_2748_3343_
1211,3,說開,Vi,1,1,2,,
1211,3,勿,ADV,1,2,3,,3083_
1211,1,填補,Vt,1,0,1,,
1211,1,庸,ADV,1,0,1,,
1211,3,陌生,Vi,1,1,2,,
1211,1,平反,Vt,1,0,1,,
1211,1,嘉峪關,N,5,0,5,1211_1211_1211_1437_,
1211,1,缺憾,N,2,0,2,1465_,
1211,1,城樓,N,1,0,1,,
1211,1,外話,N,1,0,1,,
1211,1,置,Vt,1,0,1,,
1211,3,沒辦法,Vi,2,28,30,1430_,2081_2083_2194_2202_2360_2361_2483_2494_2495_2508_2609_2671_2733_2817_2819_2889_2890_3049_3108_3109_3159_3184_3195_3224_3264_3283_3443_
1211,3,乾燥,Vi,1,2,3,,3040_
1212,1,酒泉,N,3,0,3,1213_1213_,
1212,1,住臨街,N,1,0,1,,
1212,1,加開,Vt,1,0,1,,
1212,3,核對,Vt,1,5,6,,2071_2174_2739_3462_
1214,1,含早,N,1,0,1,,
1215,3,陽光,N,1,3,4,,2465_2946_
1215,3,甘肅,N,1,1,2,,
1215,1,費含上,N,1,0,1,,
1217,3,綠色,N,5,6,11,1217_1244_1248_1266_,2759_3243_3395_3433_3435_
1218,3,米線,N,1,1,2,,
1218,1,南疆,N,1,0,1,,
1218,1,橋香圓,N,1,0,1,,
1220,1,聯大,N,2,0,2,1222_,
1220,1,公仔,N,2,0,2,1222_,
1220,1,曼哈頓,N,2,0,2,1222_,
1223,1,掛房費,N,2,0,2,1225_,
1227,3,胃口,N,2,2,4,1229_,3360_
1228,3,寫字檯,N,2,8,10,1230_,2324_2718_2718_2721_2721_3207_3484_
1228,1,百匯,N,2,0,2,1230_,
1228,1,閩,N,2,0,2,1230_,
1231,1,崇聖寺,N,1,0,1,,
1232,3,三塔,N,1,1,2,,
1232,3,台和,N,1,9,10,,2388_2879_2880_3202_3373_3374_3376_3378_
1232,1,滄海,N,1,0,1,,
1232,3,自認,Vt,1,1,2,,
1232,3,半小時,N,1,1,2,,
1232,3,連忙,ADV,1,1,2,,
1232,3,掛掉,Vt,1,1,2,,
1232,3,把手機,N,1,1,2,,
1232,3,倒霉,Vi,1,7,8,,2245_2828_2828_2923_2956_2957_
1233,3,單行道,N,1,2,3,,3378_
1234,3,東部,N,1,2,3,,2453_
1235,1,有點兒,ADV,1,0,1,,
1235,1,香蕉,N,1,0,1,,
1235,1,蘋果,N,2,0,2,1240_,
1235,3,內衣,N,1,2,3,,2355_
1237,1,洗燙,Vt,2,0,2,1238_,
1238,3,難怪,ADV,1,3,4,,3228_3229_
1239,3,類型,N,3,4,7,1469_1470_,2624_2647_3371_
1239,1,腳脖子,N,1,0,1,,
1239,1,一味,ADV,1,0,1,,
1239,1,流走,Vi,1,0,1,,
1239,1,痛快,Vi,1,0,1,,
1239,1,泡沫,N,1,0,1,,
1239,3,意味著,Vt,1,2,3,,2319_
1239,1,洗衣粉,N,1,0,1,,
1239,1,下功夫,Vi,1,0,1,,
1239,1,特惠價,N,1,0,1,,
1239,1,淹掉,Vt,1,0,1,,
1239,3,慢慢,Vi,1,1,2,,
1240,1,第一天,N,2,0,2,1348_,
1240,1,漲價,Vi,2,0,2,1451_,
1240,1,存,Vt,1,0,1,,
1240,1,房務,N,1,0,1,,
1242,3,飽,Vi,2,3,5,1246_,3479_3481_
1242,1,小吃街,N,2,0,2,1246_,
1242,1,麻辣,A,2,0,2,1246_,
1242,1,站打部,N,2,0,2,1246_,
1242,1,計程車,N,2,0,2,1246_,
1242,1,少林,N,4,0,4,1243_1246_1247_,
1242,1,評議,Vt,2,0,2,1246_,
1243,3,跳,Vi,5,6,11,1247_1304_1307_1428_,2148_2272_3212_3217_3344_
1243,3,夜市,N,4,4,8,1247_1362_1437_,3482_3488_3490_
1243,1,麵包房,N,2,0,2,1247_,
1243,3,工廠,N,3,2,5,1247_1329_,3435_
1243,3,食堂,N,2,4,6,1247_,2652_2655_2768_
1243,1,站名,N,2,0,2,1247_,
1243,1,內側,N,2,0,2,1247_,
1243,1,蹦蹦車,N,2,0,2,1247_,
1243,1,始發站,N,2,0,2,1247_,
1243,1,刻刀,N,2,0,2,1247_,
1243,1,公共汽車,N,4,0,4,1247_1433_1435_,
1244,1,個性,N,4,0,4,1244_1248_1248_,
1244,1,木紋,N,2,0,2,1248_,
1244,1,磚石,N,2,0,2,1248_,
1250,3,室內,N,1,1,2,,
1250,1,刺激,N,1,0,1,,
1250,1,造浪,N,1,0,1,,
1250,1,假山,N,1,0,1,,
1250,3,揚州,N,2,2,4,1254_,2541_
1250,1,人工,N,1,0,1,,
1250,1,滑到,Vt,1,0,1,,
1251,1,轉換器,N,1,0,1,,
1251,1,蛋糕店,N,1,0,1,,
1251,1,報紙店,N,1,0,1,,
1251,1,洗梳,Vt,1,0,1,,
1251,1,油,N,1,0,1,,
1251,1,瘦洗湖,N,1,0,1,,
1251,3,換上,Vt,1,2,3,,2826_
1252,3,豪標,N,1,3,4,,2008_3413_
1252,1,透透氣,Vi,1,0,1,,
1253,1,歷經,Vt,1,0,1,,
1253,1,磨難,N,1,0,1,,
1253,1,圖示,Vt,1,0,1,,
1253,1,接線器,N,1,0,1,,
1253,1,插口,Vi,2,0,2,1450_,
1254,3,停放,Vt,1,2,3,,2053_
1254,1,舒適度,N,1,0,1,,
1254,1,美食節,N,1,0,1,,
1256,1,大體,N,1,0,1,,
1259,3,爽快,Vi,1,1,2,,
1259,1,咖啡茶,N,1,0,1,,
1261,1,小食街,N,1,0,1,,
1261,1,酒店門,N,1,0,1,,
1262,1,江門,N,2,0,2,1263_,
1263,1,中性價,N,1,0,1,,
1266,1,肯德雞,N,1,0,1,,
1266,1,強差,N,1,0,1,,
1266,1,圓,Vi,1,0,1,,
1266,1,藍色,N,1,0,1,,
1266,1,孔,N,1,0,1,,
1266,3,人意,N,1,11,12,,2253_2258_2259_2310_2311_2596_2597_2647_2713_3253_
1268,3,宜昌市,N,1,1,2,,
1268,3,宜昌,N,1,1,2,,
1270,3,床頭,N,2,5,7,1273_,2139_2143_2381_2522_
1270,3,晾,Vt,2,2,4,1273_,3204_
1270,1,糖果,N,2,0,2,1273_,
1270,3,要不要,ADV,2,7,9,1273_,2143_2387_2691_2746_2746_3207_
1270,3,信封,N,2,1,3,1273_,
1271,3,放假,Vi,2,2,4,1274_,2483_
1271,1,桑拿房,N,4,0,4,1271_1274_1274_,
1271,1,含單,N,2,0,2,1274_,
1271,3,按摩,Vt,2,7,9,1274_,2316_2565_2565_2746_2746_3476_
1272,3,切,Vt,2,4,6,1275_,2208_3038_3039_
1276,1,大同,Vi,2,0,2,1283_,
1277,1,淨水,N,2,0,2,1284_,
1281,1,出公差,Vi,2,0,2,1288_,
1282,1,一般話,N,2,0,2,1289_,
1282,1,難能可貴,Vi,2,0,2,1289_,
1290,1,時務,N,1,0,1,,
1293,3,體會到,Vt,1,1,2,,
1293,3,成都,N,1,7,8,,2411_2447_3056_3167_3293_3447_
1294,1,響亮,Vi,2,0,2,1298_,
1295,1,嘲音,A,2,0,2,1299_,
1296,1,底樓,N,2,0,2,1300_,
1303,1,包2,N,2,0,2,1306_,
1304,3,表,N,2,8,10,1307_,2141_2322_2972_3074_3180_3431_3432_
1304,1,松花江,N,2,0,2,1307_,
1304,1,畔,N,2,0,2,1307_,
1304,1,霧淞,N,2,0,2,1307_,
1304,3,走出去,Vi,2,3,5,1307_,3353_3355_
1309,1,大地,N,2,0,2,1313_,
1309,3,宗旨,N,2,3,5,1313_,2746_3345_
1309,1,衝浪,Vi,2,0,2,1313_,
1309,3,光纖,N,2,2,4,1313_,2009_
1310,1,火車站店,N,2,0,2,1314_,
1310,1,漁民,N,2,0,2,1314_,
1310,1,村小區,N,2,0,2,1314_,
1310,3,剛才,N,2,4,6,1314_,2317_2731_3253_
1310,3,提到,Vt,3,8,11,1314_1352_,2308_2746_2747_2756_3360_3448_3453_
1311,1,小區店,N,2,0,2,1315_,
1311,1,漁村,N,2,0,2,1315_,
1311,3,溜躂,Vi,2,1,3,1315_,
1311,1,萬象城,N,2,0,2,1315_,
1316,3,頂,Vt,2,3,5,1321_,3246_3409_
1316,3,冷氣,N,2,7,9,1321_,2531_2531_2611_2728_2729_3132_
1316,3,走不動,Vi,2,1,3,1321_,
1316,3,楊,N,2,1,3,1321_,
1318,3,居住,Vi,2,9,11,1323_,3353_3353_3353_3353_3355_3355_3355_3355_
1319,3,善意,N,2,2,4,1324_,3055_
1319,1,空閒,Vi,2,0,2,1324_,
1319,3,您們,N,2,2,4,1324_,2720_
1319,3,結合,Vt,2,5,7,1324_,2706_2816_2818_2967_
1319,3,形同虛設,Vi,2,1,3,1324_,
1319,1,一動不動,ADV,2,0,2,1324_,
1319,3,借鑒,N,2,2,4,1324_,2284_
1319,3,採取,Vt,2,5,7,1324_,2225_2226_2902_2904_
1320,1,住廣,N,2,0,2,1325_,
1326,1,平民化,Vt,1,0,1,,
1326,1,緬懷,Vt,1,0,1,,
1326,3,國產,A,1,1,2,,
1326,1,遊覽,Vt,1,0,1,,
1326,3,家具,N,1,3,4,,2302_2969_
1326,1,悠久,Vi,1,0,1,,
1326,1,佳寧娜,N,1,0,1,,
1326,1,難免,ADV,1,0,1,,
1326,1,百花,N,1,0,1,,
1326,3,初次,ADV,1,2,3,,2435_
1326,1,佛山,N,5,0,5,1326_1326_1328_1329_,
1326,1,用早茶,N,1,0,1,,
1326,1,祖廟,N,2,0,2,1328_,
1327,1,蒸氣浴,N,1,0,1,,
1328,1,麵館,N,1,0,1,,
1328,1,宮,N,1,0,1,,
1328,1,旋,ADV,1,0,1,,
1328,1,貴賓卡,N,1,0,1,,
1332,3,耳,N,1,2,3,,3443_
1334,1,不宣,N,1,0,1,,
1334,3,耐,Vt,1,2,3,,2288_
1334,1,且,ADV,1,0,1,,
1334,1,平宜,N,1,0,1,,
1334,3,容納,Vt,1,1,2,,
1337,3,好感,N,1,3,4,,2843_3364_
1337,3,影響到,Vt,2,7,9,1343_,2714_2987_3119_3124_3431_3432_
1338,1,低點,N,1,0,1,,
1338,3,餐卷,N,1,2,3,,3184_
1339,1,蚊香,N,1,0,1,,
1340,1,糾正,Vt,1,0,1,,
1340,3,讚揚,Vt,1,1,2,,
1341,1,相臨,N,1,0,1,,
1341,3,潮濕,Vi,5,14,19,1423_1423_1423_1423_,2367_2479_2534_2702_2725_2743_2900_2983_2984_3083_3205_3276_3318_
1342,3,空中,N,1,1,2,,
1342,3,悶,Vi,1,7,8,,2858_3056_3451_3451_3456_3456_
1342,3,引來,Vt,1,4,5,,2288_2309_3146_
1342,3,蟲子,N,1,3,4,,2799_3311_
1343,3,不至於,ADV,1,1,2,,
1343,3,素,Vi,1,2,3,,3453_
1343,1,不關,Vt,1,0,1,,
1344,1,迅捷,Vi,1,0,1,,
1345,3,宜賓,N,1,3,4,,2278_2279_
1346,3,流動,Vi,1,2,3,,3435_
1346,3,不良,Vi,1,5,6,,3038_3039_3170_3172_
1347,1,比翠怡,N,1,0,1,,
1348,1,中心區,N,1,0,1,,
1348,3,統一,Vt,1,2,3,,3196_
1348,3,帳,N,1,5,6,,2518_2739_3327_3462_
1349,1,特快,Vi,1,0,1,,
1349,1,沃爾馬,N,1,0,1,,
1349,1,金泉,N,1,0,1,,
1350,3,地面,N,1,5,6,,2128_2289_2760_3310_
1350,1,死角,N,1,0,1,,
1352,1,升標,N,1,0,1,,
1352,3,打聽,Vt,1,1,2,,
1353,1,電源線,N,1,0,1,,
1353,3,貓,N,1,2,3,,3447_
1353,1,金泉住,Vt,1,0,1,,
1355,3,特價,N,2,13,15,1360_,2269_2589_2589_2621_2621_2621_2621_2682_2685_2732_2884_2886_
1356,1,力道,N,2,0,2,1361_,
1356,3,疼,Vi,2,1,3,1361_,
1359,3,內容,N,2,7,9,1364_,2651_2654_2671_2753_3150_3253_
1359,1,鐵塔,N,2,0,2,1364_,
1359,1,解放路,N,2,0,2,1364_,
1359,1,通話費,N,2,0,2,1364_,
1359,3,狹窄,Vi,2,1,3,1364_,
1359,1,儲值卡,N,2,0,2,1364_,
1359,3,找出,Vt,2,4,6,1364_,2097_2933_3466_
1359,1,計數,Vi,2,0,2,1364_,
1359,1,和善,Vi,2,0,2,1364_,
1359,1,手機店,N,2,0,2,1364_,
1359,1,繳,Vt,2,0,2,1364_,
1362,3,封,Vt,1,3,4,,3187_3189_
1366,3,最早,Vi,1,5,6,,2083_2360_2361_2846_
1366,1,庭院式,N,1,0,1,,
1366,3,嚇死,Vt,1,3,4,,2794_2851_
1366,1,年限,N,1,0,1,,
1367,1,派來,Vt,1,0,1,,
1367,1,舟,N,1,0,1,,
1367,1,吞,Vt,1,0,1,,
1367,3,圈套,N,1,2,3,,3039_
1367,1,劇多,N,1,0,1,,
1367,3,氣,Vt,1,32,33,,2005_2029_2030_2031_2264_2272_2273_2353_2416_2454_2455_2516_2518_2567_2601_2742_2746_2790_2806_2934_3146_3167_3184_3190_3253_3282_3289_3290_3313_3360_3446_
1367,1,漏網者,N,1,0,1,,
1367,3,奶粉,N,2,1,3,1367_,
1367,3,捨不得,Vt,1,1,2,,
1367,3,刷鍋,N,1,1,2,,
1367,3,稀,Vi,1,2,3,,3205_
1369,1,回歸,Vt,1,0,1,,
1369,1,貨真價實,Vi,1,0,1,,
1369,1,金版納,N,1,0,1,,
1369,1,別墅型,N,1,0,1,,
1371,1,皇宮,N,1,0,1,,
1371,3,繁多,Vi,1,2,3,,2253_
1371,1,貴寶地,N,1,0,1,,
1371,1,過節,Vi,1,0,1,,
1371,1,釀成,Vt,1,0,1,,
1371,1,虎,N,1,0,1,,
1371,1,植被,N,1,0,1,,
1371,3,丟棄,Vt,1,2,3,,2826_
1371,3,更有甚者,ADV,1,1,2,,
1371,1,傣,N,1,0,1,,
1371,1,疏於,Vt,1,0,1,,
1371,1,常見,Vi,1,0,1,,
1371,1,引,Vt,1,0,1,,
1371,3,鑒,N,1,2,3,,3163_
1371,1,旱季,N,1,0,1,,
1371,1,防範,Vt,1,0,1,,
1371,1,大禍,N,1,0,1,,
1371,1,山野,N,1,0,1,,
1371,3,煙頭,N,1,1,2,,
1371,3,損失,N,1,13,14,,2083_2099_2232_2252_2253_2530_2924_3016_3111_3296_3418_3462_
1371,1,民俗,N,1,0,1,,
1371,1,草木,N,1,0,1,,
1371,1,火勢,N,1,0,1,,
1371,3,防火,Vi,1,3,4,,2651_2654_
1371,3,勝地,N,1,1,2,,
1371,1,繁茂,Vi,1,0,1,,
1371,1,莫大,A,1,0,1,,
1371,1,西雙版納,N,2,0,2,1371_,
1371,1,高昇,Vi,1,0,1,,
1371,3,猛,ADV,1,1,2,,
1371,1,猴山,N,1,0,1,,
1371,1,山林,N,2,0,2,1371_,
1371,1,居於,Vt,1,0,1,,
1378,1,陳舊感,N,1,0,1,,
1378,1,苛刻,Vi,1,0,1,,
1378,1,上小點心,N,1,0,1,,
1378,1,常州,N,1,0,1,,
1378,3,太過,ADV,1,2,3,,2975_
1378,3,男士,N,1,1,2,,
1383,1,聽從,Vt,1,0,1,,
1383,1,勸告,N,1,0,1,,
1383,3,關好,Vt,1,1,2,,
1384,1,通知書,N,1,0,1,,
1384,3,人數,N,1,1,2,,
1384,1,省電,Vi,1,0,1,,
1384,3,長城,N,1,2,3,,2259_
1385,3,離去,Vi,1,2,3,,2097_
1385,1,齊齊,Vi,2,0,2,1386_,
1385,1,巴站,N,1,0,1,,
1386,1,上清寺,N,1,0,1,,
1387,1,漂泊,Vi,1,0,1,,
1396,1,字幕,N,2,0,2,1405_,
1396,3,看清,Vt,2,1,3,1405_,
1398,3,送過來,Vt,2,5,7,1407_,2453_2609_2642_2646_
1398,1,紅酒,N,2,0,2,1407_,
1398,1,加州,N,2,0,2,1407_,
1398,3,杯子,N,2,3,5,1407_,3246_3246_
1398,1,門房,N,2,0,2,1407_,
1399,1,生活區,N,1,0,1,,
1399,1,咖啡店,N,1,0,1,,
1399,3,新建,Vt,1,4,5,,2251_3488_3490_
1408,3,睡衣,N,2,8,10,1413_,3139_3139_3139_3139_3139_3139_3279_
1408,1,巴基斯坦,N,2,0,2,1413_,
1408,1,聯盟,N,2,0,2,1413_,
1409,1,頂尖,Vi,1,0,1,,
1409,1,總得,ADV,1,0,1,,
1409,1,去不了,Vi,1,0,1,,
1409,3,咋地,N,1,1,2,,
1409,3,濺,Vt,1,2,3,,2730_
1409,1,蓮蓬頭,N,1,0,1,,
1410,1,飛鏢,N,2,0,2,1415_,
1410,1,附,Vt,3,0,3,1415_1438_,
1410,3,風景區,N,2,1,3,1415_,
1410,1,鴉綠江,N,2,0,2,1415_,
1411,1,脫鞋,Vi,2,0,2,1416_,
1411,3,裝置,N,2,1,3,1416_,
1411,1,韓式房,N,2,0,2,1416_,
1411,1,衛生間座,N,2,0,2,1416_,
1411,1,炕,N,4,0,4,1411_1416_1416_,
1418,1,一個樣,Vi,1,0,1,,
1418,3,皮膚,N,1,1,2,,
1418,3,單身,Vi,1,3,4,,2511_2560_
1418,1,存有,Vt,1,0,1,,
1418,1,孤立,Vt,1,0,1,,
1418,1,房跟編外,N,1,0,1,,
1418,1,安全門,N,1,0,1,,
1418,3,小氣,Vi,1,4,5,,2919_3402_3407_
1419,1,寧豐,N,1,0,1,,
1419,1,感言,N,1,0,1,,
1421,1,算山,N,1,0,1,,
1423,1,上山,Vi,1,0,1,,
1423,1,臥榻,Vt,1,0,1,,
1423,3,多麼,ADV,1,2,3,,3487_
1423,1,過門,Vi,1,0,1,,
1423,1,床褥,N,1,0,1,,
1423,1,山路,N,1,0,1,,
1423,1,帖子,N,1,0,1,,
1423,1,幾近,ADV,1,0,1,,
1423,1,免去,Vt,1,0,1,,
1423,3,年,N,2,3,5,1423_,2335_2942_
1423,1,北方人,N,2,0,2,1423_,
1423,1,西海,N,1,0,1,,
1423,3,擰,Vt,1,1,2,,
1423,3,潮,N,2,7,9,1423_,2153_2297_2300_2381_3359_3430_
1423,1,電暖器片,N,1,0,1,,
1423,1,發言權,N,1,0,1,,
1423,1,乾糧,N,1,0,1,,
1423,1,情有可原,Vi,1,0,1,,
1423,1,生長,Vi,1,0,1,,
1423,1,落腳處,N,1,0,1,,
1423,1,大峽谷,N,1,0,1,,
1425,1,上完,Vt,1,0,1,,
1425,3,三亞灣,N,1,2,3,,2797_
1425,3,輕,Vi,1,5,6,,2324_2611_2651_2654_
1425,1,老闆娘,N,1,0,1,,
1425,1,蔬菜,N,1,0,1,,
1425,3,珠江,N,3,2,5,1427_1428_,2361_
1425,1,泡飯,N,1,0,1,,
1425,1,住提天域,N,1,0,1,,
1425,1,惡貴,N,1,0,1,,
1425,3,改為,Vt,1,8,9,,2434_2731_3065_3067_3170_3172_3308_
1425,1,東海,N,2,0,2,1429_,
1425,1,春園,N,1,0,1,,
1425,1,壁虎,N,1,0,1,,
1425,3,暈倒,Vi,1,8,9,,2372_2375_3170_3172_3288_3470_3470_
1425,1,俄羅斯人,N,1,0,1,,
1425,1,出馬,Vi,1,0,1,,
1427,3,女兒,N,1,1,2,,
1427,1,電動,A,1,0,1,,
1427,1,攤位,N,1,0,1,,
1427,1,食廊,N,1,0,1,,
1427,3,屋頂,N,1,2,3,,2946_
1428,3,餓,Vi,1,3,4,,3360_3360_
1429,1,新毫華,N,1,0,1,,
1430,3,誤會,N,1,2,3,,2762_
1430,3,從不,ADV,1,2,3,,3446_
1430,1,和氣,Vi,1,0,1,,
1430,3,交接,Vt,1,2,3,,2638_
1430,1,停掉,Vt,1,0,1,,
1430,3,餐盤,N,1,1,2,,
1430,1,喝掉,Vt,1,0,1,,
1430,3,餐桌,N,1,1,2,,
1431,1,虛驚一場,N,1,0,1,,
1431,1,貿易,N,1,0,1,,
1431,1,新興,A,1,0,1,,
1431,3,看重,Vt,1,1,2,,
1431,1,城鄉,N,1,0,1,,
1431,1,感覺出,Vt,1,0,1,,
1431,3,尋找,Vt,1,3,4,,2510_2511_
1431,1,緊挨,Vt,1,0,1,,
1431,1,翠微,Vi,1,0,1,,
1433,1,鳴沙山,N,3,0,3,1435_1437_,
1436,1,坦白,Vi,1,0,1,,
1437,3,頭頂,N,1,2,3,,2725_
1437,1,也已,Vi,1,0,1,,
1437,1,大漠,N,1,0,1,,
1437,1,一趟,N,1,0,1,,
1437,1,每5分鐘,N,1,0,1,,
1437,3,天台,N,1,1,2,,
1438,1,中上,A,1,0,1,,
1439,3,寧靜,Vi,2,1,3,1444_,
1439,1,說不上,Vt,2,0,2,1444_,
1441,1,籐老樹昏鴉,N,2,0,2,1446_,
1441,1,枯,Vi,2,0,2,1446_,
1441,3,流水,N,2,3,5,1446_,3117_3319_
1441,1,慘淡,Vi,2,0,2,1446_,
1442,1,西郊,N,4,0,4,1442_1447_1447_,
1442,1,頂鶴,N,2,0,2,1447_,
1442,1,野貓,N,2,0,2,1447_,
1443,1,炮仗聲,N,2,0,2,1448_,
1443,1,震天,Vi,2,0,2,1448_,
1443,1,大年夜,N,2,0,2,1448_,
1443,1,初四,N,2,0,2,1448_,
1450,1,金城,N,3,0,3,1451_1451_,
1450,3,名不符實,Vi,1,1,2,,
1450,3,上不了,Vt,1,5,6,,2841_2980_3119_3124_
1450,1,和,Vi,1,0,1,,
1450,1,將軍,N,1,0,1,,
1450,1,寬暢,Vi,1,0,1,,
1450,1,沃爾瑪,N,1,0,1,,
1450,1,小賣部鐵,N,1,0,1,,
1451,3,前提,N,1,1,2,,
1451,1,襄樊,N,1,0,1,,
1455,1,八達,N,1,0,1,,
1455,1,新鄭,N,1,0,1,,
1459,3,旅遊區,N,2,2,4,1464_,2881_
1459,1,初二,N,2,0,2,1464_,
1461,1,忘不了,Vt,4,0,4,1462_1466_1467_,
1461,3,怎麼辦,Vi,2,10,12,1466_,2671_3040_3119_3124_3159_3341_3371_3433_3435_
1461,1,滋味,N,2,0,2,1466_,
1465,1,等上,Vt,1,0,1,,
1465,1,往往,ADV,1,0,1,,
1469,3,麗軒,N,2,4,6,1470_,2305_2308_2308_
1471,1,玄武湖,N,1,0,1,,
1472,1,糾纏,Vt,1,0,1,,
1472,3,弄髒,Vt,1,5,6,,2549_2550_3445_3445_
1472,1,霸王,N,1,0,1,,
1472,1,玄武,N,1,0,1,,
1472,3,以上,N,2,9,11,1472_,2434_2483_2651_2654_3132_3132_3431_3432_
1472,1,條款,N,1,0,1,,
1472,3,憤怒,Vi,1,6,7,,2609_2731_2776_3295_3487_
1472,3,桌布,N,1,2,3,,2097_
1472,3,據理力爭,Vi,1,5,6,,2083_2209_2210_2616_
1472,1,高管,N,1,0,1,,
1472,1,要點,N,1,0,1,,
1472,1,酒店點,N,1,0,1,,
1472,1,外賣,Vt,2,0,2,1472_,
1472,3,可惡,Vi,1,7,8,,2740_3231_3231_3239_3257_3319_
1472,1,12樓,N,1,0,1,,
1472,3,一下子,N,1,2,3,,2099_
1473,3,拐角,N,1,6,7,,2004_2006_2006_2756_3438_
1473,1,來訪,Vi,1,0,1,,
1473,1,柔軟,Vi,3,0,3,1481_1488_,
1473,1,扭脖,Vt,1,0,1,,
1473,1,市景房,N,1,0,1,,
1474,1,外國台,N,1,0,1,,
1474,1,地方台,N,1,0,1,,
1475,1,濰坊,N,4,0,4,1477_1482_1484_,
1476,3,反,Vt,2,4,6,1483_,2527_3448_3453_
1477,1,閻蕾,N,2,0,2,1484_,
1477,1,住鳶飛,Vi,2,0,2,1484_,
1478,1,改換,Vt,2,0,2,1485_,
1479,3,玫瑰,N,2,1,3,1486_,
1480,1,閆蕾,N,2,0,2,1487_,
1481,3,衣架,N,2,1,3,1488_,
1481,1,選用,Vt,2,0,2,1488_,
1481,3,放置,Vt,2,1,3,1488_,
1481,3,媲美,Vt,2,2,4,1488_,2686_
1481,1,掛鉤,N,2,0,2,1488_,
1481,1,過人,Vi,2,0,2,1488_,
1489,1,鴛飛大,N,2,0,2,1492_,
1490,3,走道,N,2,12,14,1493_,2381_2517_2519_2863_2961_2963_3030_3030_3103_3141_3417_
1490,3,真心,Vi,2,2,4,1493_,3146_
1491,1,山東省,N,2,0,2,1494_,
1491,1,遊樂園,N,4,0,4,1491_1494_1494_,
1491,1,富華,N,2,0,2,1494_,
1495,3,賓,N,1,1,2,,
1495,1,資深,Vi,1,0,1,,
1495,3,出眾,Vi,1,1,2,,
1495,1,配上,Vt,1,0,1,,
1495,1,香味,N,1,0,1,,
1495,1,顧新峰,N,1,0,1,,
1496,3,婚宴,N,1,2,3,,2835_
1497,3,談,Vt,1,3,4,,3105_3364_
1497,1,萬鵬,N,1,0,1,,
1498,1,實習,Vi,1,0,1,,
1498,3,無奈,Vi,1,17,18,,2095_2097_2233_2295_2363_2775_2823_2825_3017_3018_3146_3239_3239_3295_3388_3443_
1499,1,送進,Vt,1,0,1,,
1499,1,泡好,Vt,1,0,1,,
1499,3,空曠,Vi,1,2,3,,3435_
1499,3,公寓房,N,1,5,6,,2872_2872_2872_2872_
1499,1,升級成,Vt,1,0,1,,
1499,3,換好,Vt,1,1,2,,
1500,3,超乎,Vt,1,1,2,,
1500,3,注重,Vt,1,4,5,,2569_3103_3103_
1500,1,熱誠,N,1,0,1,,
2002,2,沒完,Vi,0,4,4,,2516_2518_3472_
2002,2,虧心事,N,0,1,1,,
2002,2,辯解,Vt,0,1,1,,
2002,2,情,N,0,1,1,,
2002,2,懂,Vt,0,15,15,,2161_2264_2312_2315_2527_2835_2839_2857_2858_3210_3215_3245_3330_3364_
2003,2,挑釁,Vi,0,3,3,,2005_2756_
2003,2,韓日,N,0,2,2,,2005_
2003,2,渤海,N,0,2,2,,2005_
2003,2,必然,ADV,0,2,2,,2005_
2003,2,旅遊團,N,0,3,3,,2005_2232_
2004,2,沒法,ADV,0,27,27,,2006_2043_2045_2050_2053_2059_2188_2246_2339_2393_2483_2540_2589_2728_2729_2734_2742_3074_3119_3124_3227_3278_3278_3418_3477_3485_
2007,2,盡如人意,Vi,0,3,3,,2008_3042_
2007,2,小提琴,N,0,2,2,,2008_
2007,2,挑,Vt,0,4,4,,2008_2517_2519_
2009,2,聊,Vt,0,6,6,,2072_2829_2933_3150_3204_
2009,2,約好,Vt,0,3,3,,2516_2518_
2009,2,滴房,N,0,1,1,,
2009,2,合租,Vt,0,1,1,,
2009,2,部下,N,0,1,1,,
2009,2,電工,N,0,1,1,,
2009,2,同租人,N,0,1,1,,
2009,2,24小時,N,0,1,1,,
2010,2,打手,N,0,2,2,,3309_
2010,2,決不,ADV,0,15,15,,2535_2742_2756_2896_2897_2944_3060_3103_3175_3176_3197_3199_3400_3443_
2011,2,豪生,N,0,3,3,,3345_3345_
2011,2,服務燈,N,0,2,2,,2011_
2012,2,典型,Vi,0,12,12,,2089_2235_2236_2309_2794_2852_2925_3002_3160_3361_3362_
2012,2,慕名,Vi,0,1,1,,
2012,2,皇城,N,0,1,1,,
2012,2,臉,N,0,17,17,,2186_2258_2259_2359_2500_2501_2534_2731_2756_3335_3360_3360_3380_3397_3434_3436_
2012,2,伴,Vt,0,4,4,,2662_2861_3253_
2012,2,看門,Vi,0,1,1,,
2012,2,公車站,N,0,2,2,,3185_
2012,2,立馬,N,0,6,6,,2042_2272_2604_2718_2721_
2012,2,二話不說,Vi,0,1,1,,
2012,2,陽面,N,0,1,1,,
2012,2,拖,Vt,0,9,9,,2175_2231_2528_2544_2725_2776_3195_3360_
2012,2,欣燕,N,0,5,5,,2012_2012_2012_2012_
2012,2,對手,N,0,1,1,,
2012,2,搬去,Vt,0,1,1,,
2012,2,根,N,0,2,2,,3107_
2012,2,改善改善,Vt,0,1,1,,
2012,2,大失所望,Vi,0,7,7,,2718_2721_2909_2910_3233_3417_
2012,2,低廉,Vi,0,1,1,,
2012,2,預計,Vt,0,2,2,,2557_
2012,2,轉機,N,0,1,1,,
2012,2,槍手,N,0,1,1,,
2012,2,新街口,N,0,4,4,,2012_2012_2012_
2013,2,水管,N,0,12,12,,2159_2159_2391_2421_2946_3433_3433_3433_3435_3435_3435_
2013,2,折騰,Vt,0,16,16,,2175_2333_2334_2561_2562_2837_2861_3119_3124_3213_3218_3279_3281_3289_3290_
2014,2,倒底,ADV,0,1,1,,
2014,2,冷熱,N,0,1,1,,
2014,2,反掉,Vt,0,1,1,,
2014,2,散發出,Vt,0,1,1,,
2015,2,扣款,N,0,2,2,,3327_
2015,2,後會,N,0,1,1,,
2015,2,帳單,N,0,11,11,,2059_2445_2446_2534_2549_2550_2739_3038_3039_3150_
2015,2,適宜,Vi,0,1,1,,
2015,2,觀潮節,N,0,1,1,,
2015,2,前後,ADV,0,4,4,,3083_3119_3124_
2015,2,海寧人,N,0,1,1,,
2015,2,機子,N,0,1,1,,
2015,2,煩,Vt,0,9,9,,2212_2577_2747_2864_3032_3033_3119_3124_
2015,2,做錯,Vt,0,1,1,,
2016,2,用語,N,0,4,4,,2651_2654_3146_
2016,2,當班,Vi,0,4,4,,2225_2226_3308_
2016,2,完,Vt,0,12,12,,2139_2143_2516_2518_2691_2941_3150_3289_3289_3290_3290_
2016,2,登記表,N,0,1,1,,
2016,2,不理,Vt,0,13,13,,2155_2209_2210_2231_2314_2317_2642_2646_3103_3231_3360_3465_
2016,2,身份,N,0,5,5,,2582_2582_2746_2869_
2016,2,稍候,Vi,0,1,1,,
2016,2,丟給,Vt,0,1,1,,
2017,2,正面,N,0,6,6,,2342_3213_3213_3218_3218_
2017,2,怨婦狀,N,0,1,1,,
2017,2,面無表情,Vi,0,8,8,,2134_2649_2753_2807_3392_3394_3470_
2019,2,太髒,Vi,0,1,1,,
2019,2,太舊,Vi,0,2,2,,2546_
2019,2,臭味,N,0,13,13,,2532_2533_2599_2683_2686_2928_3195_3253_3344_3389_3390_3419_
2020,2,一塌糊塗,Vi,0,12,12,,2627_2753_2917_2945_2958_3187_3189_3351_3353_3355_3365_
2020,2,拉倒,Vi,0,1,1,,
2021,2,鐵路,N,0,3,3,,3228_3229_
2022,2,毫無,ADV,0,4,4,,2050_2053_3160_
2022,2,樓用,N,0,1,1,,
2022,2,連接,Vt,0,6,6,,3170_3170_3172_3172_3333_
2023,2,不能夠,ADV,0,1,1,,
2023,2,高溫,N,0,1,1,,
2024,2,刪除,Vt,0,5,5,,3159_3296_3327_3327_
2025,2,二星,N,0,7,7,,2075_2328_2330_3385_3433_3435_
2027,2,什剎海,N,0,1,1,,
2027,2,有力,Vi,0,1,1,,
2027,2,充其量,ADV,0,7,7,,2112_2836_2873_2917_2944_3141_
2028,2,遠達,Vt,0,4,4,,3413_3413_3413_
2029,2,搞笑,Vi,0,7,7,,2208_2761_2762_3031_3031_3105_
2029,2,報警,Vi,0,14,14,,2530_2530_2549_2550_2680_2680_2680_2746_2812_2924_2924_3038_3039_
2029,2,責任,N,0,20,20,,2252_2253_2494_2495_2530_2731_2759_2861_2921_3294_3296_3367_3368_3433_3433_3433_3435_3435_3435_
2029,2,智商,N,0,3,3,,2651_2654_
2029,2,佩服,Vt,0,1,1,,
2029,2,罵,Vt,0,8,8,,2208_2857_2858_2934_2934_2946_3040_
2029,2,竄,Vi,0,1,1,,
2029,2,老鼠,N,0,7,7,,2785_2926_2978_3254_3473_3473_
2030,2,冷天,N,0,2,2,,2031_
2030,2,搬家,Vi,0,2,2,,2031_
2032,2,髒亂,Vi,0,11,11,,2034_2235_2236_2794_2965_2966_3012_3087_3095_3247_
2033,2,人民路,N,0,2,2,,2035_
2033,2,水流聲,N,0,2,2,,2035_
2033,2,姍姍來遲,Vi,0,2,2,,2035_
2033,2,入眠,Vi,0,2,2,,2035_
2036,2,英語,N,0,9,9,,2036_2036_2154_2154_2296_2718_2721_3468_
2036,2,古老,Vi,0,2,2,,2476_
2036,2,三峽,N,0,4,4,,2333_2334_2759_
2036,2,說出來,Vi,0,1,1,,
2037,2,存入,Vt,0,1,1,,
2037,2,瓶裝水,N,0,4,4,,2274_2521_2972_
2037,2,高分,N,0,2,2,,2037_
2037,2,調查,Vt,0,3,3,,3296_3458_
2037,2,踹,Vt,0,2,2,,2037_
2037,2,引起,Vt,0,4,4,,2309_2816_2818_
2037,2,稱呼,Vt,0,2,2,,3181_
2037,2,指出,Vt,0,2,2,,2342_
2037,2,個性化,Vt,0,1,1,,
2037,2,第2天,N,0,8,8,,2406_2408_2731_2828_3013_3369_3370_
2037,2,券,N,0,1,1,,
2037,2,發動機,N,0,1,1,,
2037,2,節目,N,0,8,8,,2070_2070_2388_2652_2655_3353_3355_
2037,2,鎖,N,0,9,9,,2134_2205_2757_2758_2828_2873_3083_3222_
2037,2,發出,Vt,0,6,6,,2609_3038_3039_3098_3098_
2037,2,徹底,Vi,0,7,7,,2232_2680_3170_3172_3319_3443_
2037,2,灰色,N,0,3,3,,2382_2987_
2037,2,巨響,N,0,1,1,,
2037,2,莫名,A,0,3,3,,2284_3409_
2037,2,筷子,N,0,1,1,,
2037,2,年底,N,0,1,1,,
2037,2,刺鼻,Vi,0,10,10,,2559_2588_2742_2748_2965_2966_2983_2984_3397_
2037,2,哪來,ADV,0,1,1,,
2037,2,恍然大悟,Vi,0,4,4,,2069_3233_3308_
2037,2,刀叉,N,0,1,1,,
2037,2,看好,Vt,0,3,3,,2769_2770_
2037,2,可想而知,ADV,0,5,5,,2081_2083_2313_2316_
2037,2,木料,N,0,1,1,,
2037,2,舊都,N,0,1,1,,
2037,2,成人,N,0,3,3,,2483_2492_
2037,2,下定決心,Vi,0,1,1,,
2037,2,剩下,Vt,0,4,4,,2607_3418_3458_
2037,2,調羹,N,0,1,1,,
2037,2,犯愁,N,0,1,1,,
2037,2,九牛二虎之力,N,0,1,1,,
2037,2,聞到,Vt,0,4,4,,2636_2734_3443_
2038,2,膠紙,N,0,2,2,,2040_
2038,2,李鵬,N,0,2,2,,2040_
2038,2,迎賓館,N,0,3,3,,2040_2926_
2038,2,剪,Vt,0,2,2,,2040_
2038,2,政要,N,0,2,2,,2040_
2038,2,鴻展樓,N,0,4,4,,2038_2040_2040_
2038,2,牛奶味,N,0,2,2,,2040_
2038,2,昏,Vi,0,2,2,,2040_
2038,2,留念,Vi,0,2,2,,2040_
2038,2,合影,Vi,0,2,2,,2040_
2038,2,原來如此,Vi,0,2,2,,2040_
2038,2,小看,Vt,0,2,2,,2040_
2038,2,叔平,N,0,2,2,,2040_
2038,2,朱容基,N,0,2,2,,2040_
2038,2,畫冊,N,0,2,2,,2040_
2039,2,黃斑,N,0,3,3,,2041_3174_
2039,2,疊起來,Vi,0,2,2,,2041_
2039,2,豈有此理,Vi,0,8,8,,2041_2170_2554_2555_2919_3243_3296_
2039,2,自稱,Vt,0,4,4,,2041_2078_2925_
2039,2,洗乾淨,Vi,0,3,3,,2041_2260_
2039,2,標明,Vt,0,6,6,,2041_3129_3129_3130_3130_
2042,2,躲,Vt,0,2,2,,3341_
2042,2,難受,Vi,0,6,6,,2175_2863_2863_3242_3360_
2042,2,苦惱,Vi,0,1,1,,
2042,2,悶死,Vt,0,1,1,,
2042,2,對流,Vi,0,1,1,,
2043,2,大呼,Vt,0,3,3,,2045_2813_
2043,2,抵擋,Vt,0,2,2,,2045_
2043,2,可笑,Vi,0,12,12,,2043_2045_2045_2232_2421_2631_2761_2762_2767_2842_2843_
2043,2,上當,Vi,0,17,17,,2045_2207_2526_2573_2629_2675_2677_2679_2731_2759_2813_3083_3097_3187_3189_3418_
2044,2,奉勸,Vt,0,15,15,,2208_2231_2287_2288_2497_2748_3015_3043_3185_3316_3413_3443_3446_3478_
2044,2,配給,Vt,0,1,1,,
2044,2,淋浴口,N,0,1,1,,
2044,2,純淨,Vi,0,1,1,,
2047,2,延至,Vt,0,1,1,,
2047,2,摘,Vt,0,1,1,,
2047,2,搬到,Vt,0,9,9,,2183_2445_2445_2446_2446_2606_2790_3413_
2047,2,告示牌,N,0,2,2,,2047_
2047,2,半天房,N,0,1,1,,
2047,2,竟,ADV,0,20,20,,2047_2057_2084_2084_2085_2085_2204_2272_2294_2650_2653_2657_2669_2874_3062_3062_3069_3070_3413_
2048,2,走廊力,N,0,1,1,,
2048,2,寫字樓,N,0,5,5,,2847_3078_3141_3359_
2048,2,結論,N,0,3,3,,2231_3098_
2048,2,走來走去,Vi,0,2,2,,2649_
2048,2,口香糖,N,0,1,1,,
2050,2,安保,N,0,3,3,,2053_2589_
2050,2,樣式,N,0,2,2,,2053_
2050,2,爛,Vi,0,63,63,,2053_2109_2126_2126_2126_2144_2144_2145_2145_2146_2151_2172_2206_2248_2248_2248_2250_2250_2250_2321_2324_2412_2481_2481_2481_2482_2482_2482_2527_2549_2549_2550_2550_2566_2640_2659_2659_2662_2688_2699_2702_2705_2706_2739_2781_2865_2899_2915_3038_3039_3043_3074_3195_3196_3253_3288_3392_3394_3413_3443_3467_3477_
2051,2,聾子,N,0,3,3,,2054_2526_
2051,2,耳朵,N,0,3,3,,2054_3231_
2051,2,給分,Vi,0,2,2,,2054_
2055,2,強悍,Vi,0,1,1,,
2057,2,太陽,N,0,2,2,,2390_
2057,2,轟鳴,N,0,3,3,,3233_3443_
2057,2,堵上,Vt,0,1,1,,
2057,2,俺,N,0,6,6,,2057_2175_2175_2938_3487_
2057,2,運轉,Vt,0,2,2,,3233_
2057,2,惟一,A,0,1,1,,
2057,2,筆誤,N,0,1,1,,
2057,2,拖走,Vt,0,1,1,,
2057,2,內裝,N,0,1,1,,
2057,2,離譜,Vi,0,11,11,,2537_2538_2839_2864_3007_3083_3110_3254_3338_3420_
2057,2,鐵架,N,0,1,1,,
2057,2,壓縮機,N,0,1,1,,
2057,2,標價,N,0,7,7,,2360_2361_3032_3032_3033_3033_
2057,2,來人,N,0,4,4,,2594_2807_3319_
2057,2,童床,N,0,1,1,,
2057,2,居多,Vi,0,2,2,,2322_
2057,2,不可理喻,Vi,0,3,3,,2243_2393_
2057,2,日語,N,0,1,1,,
2057,2,大元,N,0,2,2,,2232_
2057,2,孤陋寡聞,Vi,0,1,1,,
2057,2,機器,N,0,6,6,,2128_2344_2349_3119_3124_
2058,2,惡夢,N,0,2,2,,2945_
2058,2,過分,Vi,0,12,12,,2211_2609_2864_2872_3145_3193_3313_3433_3433_3435_3435_
2058,2,信心,N,0,2,2,,3294_
2058,2,濃濃,Vi,0,2,2,,3030_
2059,2,掛上,Vt,0,2,2,,2922_
2059,2,衣桂,N,0,1,1,,
2059,2,發黃,Vi,0,11,11,,2378_2532_2533_2600_2803_2922_3108_3109_3403_3408_
2059,2,蚌埠,N,0,1,1,,
2059,2,上上,A,0,3,3,,2059_2745_
2059,2,通電,Vi,0,1,1,,
2059,2,保險絲,N,0,1,1,,
2059,2,修理,Vt,0,12,12,,2149_2161_2823_2825_2928_3001_3132_3132_3237_3353_3355_
2059,2,脫掉,Vt,0,1,1,,
2059,2,留有,Vt,0,2,2,,2190_
2059,2,極度,ADV,0,8,8,,2061_2108_2232_2761_2762_2803_2812_
2059,2,開單,N,0,1,1,,
2059,2,瓷,N,0,1,1,,
2059,2,說不定,ADV,0,1,1,,
2059,2,污點,N,0,1,1,,
2060,2,匪夷所思,Vi,0,1,1,,
2060,2,摔下去,Vi,0,1,1,,
2061,2,不堪,ADV,0,11,11,,2196_2267_2267_2335_2412_2610_3168_3169_3249_3258_
2061,2,管用,Vi,0,5,5,,2104_2183_2780_2861_
2061,2,髒兮兮,Vi,0,8,8,,2165_2283_2290_2606_2707_2708_3114_
2061,2,洗手,Vi,0,5,5,,3352_3354_3433_3435_
2061,2,忍,Vt,0,11,11,,2510_2511_2587_3083_3083_3170_3172_3239_3253_3335_
2061,2,電蚊香,N,0,4,4,,2780_3035_3257_
2062,2,馬桶蓋,N,0,3,3,,3451_3456_
2062,2,損壞,Vt,0,6,6,,2232_2680_3132_3431_3432_
2062,2,漆面,N,0,2,2,,2204_
2062,2,癱瘓,Vi,0,1,1,,
2063,2,心痛,Vi,0,4,4,,2067_2095_2097_
2064,2,比例,N,0,4,4,,2624_2997_3345_
2064,2,不成,Vi,0,5,5,,2088_2163_2175_2997_
2065,2,告,Vt,0,8,8,,2101_2101_2102_2102_2276_2968_3296_
2065,2,打馬虎眼,Vi,0,1,1,,
2065,2,為由,Vi,0,2,2,,3388_
2065,2,侄子,N,0,1,1,,
2065,2,洗衣費,N,0,2,2,,2391_
2066,2,餐費,N,0,1,1,,
2066,2,加多,Vi,0,1,1,,
2068,2,市價,N,0,1,1,,
2068,2,頭一天,N,0,2,2,,3472_
2069,2,愛國,Vi,0,1,1,,
2069,2,冒出,Vt,0,2,2,,2946_
2069,2,妄圖,Vt,0,1,1,,
2069,2,鏡頭,N,0,1,1,,
2069,2,住華旗,N,0,1,1,,
2069,2,腦袋,N,0,2,2,,2192_
2069,2,教育,N,0,8,8,,2359_2475_2608_2609_3231_3433_3435_
2069,2,勁,N,0,2,2,,2730_
2069,2,苦思,Vt,0,1,1,,
2069,2,搖,Vt,0,1,1,,
2069,2,企圖,N,0,1,1,,
2069,2,憶,Vt,0,1,1,,
2069,2,捲曲,Vi,0,1,1,,
2069,2,搖到,Vt,0,1,1,,
2069,2,雞生蛋,N,0,1,1,,
2069,2,斑駁,Vi,0,6,6,,2412_2547_2740_3405_3410_
2069,2,典故,N,0,1,1,,
2069,2,未果,Vi,0,2,2,,2674_
2069,2,主義,N,0,1,1,,
2069,2,一角,N,0,1,1,,
2070,2,貨,N,0,3,3,,2162_2744_
2070,2,黑店,N,0,28,28,,2071_2244_2245_2360_2361_2497_2549_2550_2767_2876_2924_3043_3075_3075_3075_3075_3075_3075_3075_3075_3075_3084_3194_3253_3296_3296_3327_
2070,2,衛星,N,0,5,5,,2652_2655_2702_3409_
2070,2,色彩,N,0,1,1,,
2070,2,林立,Vi,0,1,1,,
2070,2,斬人,N,0,1,1,,
2070,2,簽字,Vi,0,9,9,,2229_2391_2609_2739_2846_3083_3083_3397_
2070,2,差價,N,0,5,5,,2312_2315_2639_2740_
2070,2,防,Vt,0,3,3,,3448_3453_
2070,2,報銷,Vt,0,5,5,,3193_3193_3487_3487_
2070,2,斬,Vt,0,7,7,,2071_2071_2167_2463_2465_3074_
2070,2,理解為,Vt,0,1,1,,
2070,2,挨斬,Vi,0,3,3,,2070_2071_
2070,2,無名,A,0,1,1,,
2071,2,整理好,Vt,0,2,2,,2970_
2071,2,草草,ADV,0,1,1,,
2071,2,撤單,N,0,1,1,,
2071,2,渠道,N,0,1,1,,
2071,2,必須,ADV,0,23,23,,2081_2083_2104_2170_2333_2334_2367_2454_2455_2724_2861_2933_3038_3039_3069_3070_3111_3115_3162_3196_3307_3307_
2071,2,甚,ADV,0,11,11,,2198_2322_2426_2725_3119_3124_3331_3359_3433_3435_
2071,2,皺巴巴,Vi,0,2,2,,2247_
2072,2,臭豆腐,N,0,1,1,,
2072,2,簽單,N,0,7,7,,2527_2834_3069_3070_3147_3414_
2072,2,硬是,ADV,0,6,6,,2225_2226_2823_2825_3167_
2072,2,打來,Vt,0,10,10,,2560_2889_2890_3433_3433_3433_3435_3435_3435_
2072,2,突然,ADV,0,14,14,,2081_2083_2225_2226_2272_2290_2671_2691_2731_2857_2858_3231_3308_
2072,2,暫且,ADV,0,1,1,,
2072,2,配不上,Vt,0,4,4,,2919_3243_3466_
2073,2,老四星,N,0,1,1,,
2074,2,語言,N,0,3,3,,2081_2083_
2074,2,表達,Vt,0,3,3,,2924_3253_
2074,2,聲譽,N,0,3,3,,2417_3011_
2076,2,麻將,N,0,1,1,,
2077,2,鼾聲,N,0,2,2,,3333_
2077,2,聽得到,Vt,0,2,2,,2541_
2077,2,院牆,N,0,1,1,,
2078,2,頂多,ADV,0,5,5,,2523_2975_3083_3131_
2079,2,教訓,N,0,5,5,,2284_2473_2530_2881_
2079,2,慘痛,Vi,0,2,2,,2530_
2079,2,太陽神,N,0,1,1,,
2081,2,承擔,Vt,0,2,2,,2083_
2081,2,願,Vt,0,5,5,,2083_2388_2857_2858_
2081,2,轉告,Vt,0,2,2,,2083_
2081,2,值班,Vi,0,17,17,,2081_2083_2083_2229_2273_2333_2334_2463_2465_2579_2671_3257_3281_3341_3448_3453_
2081,2,房錢,N,0,6,6,,2083_2287_2287_2288_2288_
2081,2,義務,N,0,2,2,,2083_
2081,2,你我,N,0,2,2,,2083_
2081,2,保密,Vi,0,2,2,,2083_
2081,2,管好,Vt,0,2,2,,2083_
2081,2,2006年,N,0,12,12,,2083_2108_2197_2322_2450_2453_2464_2466_2565_3117_3316_
2084,2,欠佳,Vi,0,3,3,,2085_2190_
2084,2,理會,Vt,0,4,4,,2085_2919_3308_
2084,2,殘舊,N,0,5,5,,2085_2388_3479_3481_
2084,2,讚美,Vt,0,2,2,,2085_
2084,2,笑容可掬,Vi,0,3,3,,2085_2362_
2086,2,興亞,N,0,1,1,,
2086,2,連四星,N,0,1,1,,
2086,2,02月,N,0,1,1,,
2086,2,建國,Vi,0,3,3,,2318_2319_
2086,2,裂縫,N,0,3,3,,2571_3415_
2089,2,失靈,Vi,0,1,1,,
2089,2,形成,Vt,0,1,1,,
2089,2,事實,N,0,15,15,,2162_2231_2287_2288_2354_2355_2836_2861_2924_2924_2924_3146_3253_3253_
2089,2,省會,N,0,1,1,,
2089,2,延住,Vt,0,2,2,,3227_
2089,2,振,Vi,0,1,1,,
2089,2,搬出,Vt,0,1,1,,
2089,2,世貿,N,0,1,1,,
2089,2,縣,N,0,3,3,,2889_2890_
2089,2,華庭,N,0,1,1,,
2090,2,圓球,N,0,1,1,,
2090,2,櫃子,N,0,6,6,,2240_2945_3222_3389_3390_
2090,2,冬至,N,0,1,1,,
2090,2,寒意,N,0,1,1,,
2090,2,黑色,N,0,9,9,,2090_2380_2572_2584_2584_2748_2971_3253_
2090,2,走出來,Vi,0,1,1,,
2090,2,渾身,N,0,2,2,,2967_
2090,2,盯,Vt,0,5,5,,2946_3233_3431_3432_
2090,2,這天,N,0,1,1,,
2090,2,燈罩,N,0,3,3,,2267_3415_
2091,2,滿意度,N,0,3,3,,2092_2949_
2093,2,曖昧,Vi,0,1,1,,
2093,2,卡啦,ADV,0,1,1,,
2095,2,可見一斑,Vi,0,2,2,,2097_
2095,2,賺,Vt,0,7,7,,2097_2099_2754_2852_3038_3039_
2095,2,喪失,Vt,0,2,2,,2097_
2095,2,久久,ADV,0,4,4,,2097_3288_3443_
2095,2,卡打,Vt,0,2,2,,2097_
2095,2,昨晚,N,0,6,6,,2097_2391_3001_3083_3144_
2095,2,著火,Vi,0,2,2,,2097_
2095,2,中文,N,0,5,5,,2097_2757_2758_3360_
2095,2,理直氣壯,Vi,0,7,7,,2097_2312_2315_2318_2319_2531_
2095,2,號碼,N,0,4,4,,2097_2925_3333_
2095,2,不可思議,Vi,0,6,6,,2097_2298_2301_3423_3424_
2095,2,試撥,Vt,0,4,4,,2095_2097_2097_
2095,2,從小,ADV,0,2,2,,2097_
2095,2,遮羞布,N,0,2,2,,2097_
2095,2,斑斑,Vi,0,9,9,,2097_2190_2683_2686_2714_2976_3035_3203_
2095,2,傳來,Vt,0,4,4,,2097_2510_2511_
2095,2,抬,Vt,0,4,4,,2097_2731_2828_
2095,2,網通,N,0,2,2,,2097_
2095,2,日曆,N,0,2,2,,2097_
2095,2,眼,N,0,15,15,,2097_2161_2161_2190_2360_2361_2703_2828_3043_3108_3109_3170_3172_3347_
2095,2,空號,N,0,2,2,,2097_
2095,2,盜,Vt,0,4,4,,2097_2924_3296_
2095,2,出國,Vi,0,2,2,,2097_
2095,2,油跡,N,0,3,3,,2097_3246_
2095,2,23時,N,0,2,2,,2097_
2095,2,浴簾比,N,0,2,2,,2097_
2098,2,奇,ADV,0,12,12,,2116_2119_2197_2388_2412_2588_2588_2790_2947_3239_3270_
2098,2,無比,Vi,0,12,12,,2116_2119_2197_2775_2976_3085_3237_3352_3354_3418_3499_
2099,2,東北,N,0,1,1,,
2099,2,看似,Vt,0,1,1,,
2099,2,拉到,Vt,0,3,3,,3118_3159_
2099,2,描述,Vt,0,9,9,,2284_2359_2651_2654_3038_3039_3055_3146_
2099,2,進到,Vt,0,4,4,,3020_3253_3363_
2099,2,買不到,Vt,0,1,1,,
2099,2,磕,Vt,0,1,1,,
2101,2,玻璃窗,N,0,3,3,,2102_3239_
2101,2,指南,N,0,6,6,,2102_3101_3101_3194_3333_
2101,2,光不,N,0,2,2,,2102_
2101,2,特貴,N,0,2,2,,2102_
2101,2,采,N,0,2,2,,2102_
2101,2,房客,N,0,10,10,,2102_2180_2388_2576_2599_3032_3033_3288_3351_
2101,2,找來,Vt,0,3,3,,2102_3443_
2101,2,明明白白,Vi,0,2,2,,2102_
2101,2,租出去,Vt,0,2,2,,2102_
2104,2,待,Vt,0,1,1,,
2104,2,冰涼,Vi,0,2,2,,2782_
2104,2,手腳,N,0,3,3,,2258_2259_
2104,2,變更,Vt,0,1,1,,
2106,2,講好,Vt,0,2,2,,3288_
2106,2,趕走,Vt,0,1,1,,
2106,2,差勁,Vi,0,27,27,,2128_2158_2192_2209_2210_2289_2314_2317_2382_2396_2478_2569_2603_2605_2922_2926_2986_3138_3174_3333_3347_3397_3399_3422_3439_3441_
2106,2,堅決,Vi,0,14,14,,2232_2284_2566_2592_2731_2842_2843_2879_2880_3083_3104_3179_3306_
2106,2,故意,Vt,0,5,5,,2977_3253_3467_3467_
2108,2,名譽,N,0,1,1,,
2108,2,公佈,Vt,0,2,2,,3364_
2108,2,登入,Vt,0,1,1,,
2108,2,作出,Vt,0,9,9,,2690_3049_3049_3146_3448_3448_3453_3453_
2108,2,處罰,N,0,2,2,,2609_
2108,2,名不副實,Vi,0,4,4,,2791_2841_3305_
2108,2,污垢,N,0,2,2,,2271_
2108,2,屆時,ADV,0,1,1,,
2108,2,緊急,Vi,0,3,3,,2406_2408_
2109,2,小2,N,0,1,1,,
2109,2,遠離,Vt,0,4,4,,2312_2315_2835_
2110,2,准二星,N,0,2,2,,2112_
2110,2,室外,N,0,3,3,,2769_2770_
2110,2,中央調,N,0,1,1,,
2111,2,東路,N,0,3,3,,2360_2361_
2111,2,給出,Vt,0,2,2,,3363_
2111,2,潯陽,N,0,1,1,,
2111,2,潯陽路,N,0,1,1,,
2112,2,南開,N,0,1,1,,
2112,2,樓房,N,0,1,1,,
2113,2,天宇,N,0,1,1,,
2113,2,消耗品,N,0,1,1,,
2114,2,通道,N,0,6,6,,2117_2198_3239_3239_3243_
2114,2,容下,Vt,0,2,2,,2117_
2114,2,漫出,Vt,0,2,2,,2117_
2114,2,白送,Vt,0,2,2,,2117_
2114,2,大刀,N,0,2,2,,2117_
2114,2,砍,Vt,0,5,5,,2117_3347_3347_3414_
2116,2,驚醒,Vt,0,4,4,,2119_3205_3476_
2116,2,癢,Vi,0,4,4,,2119_2260_2799_
2116,2,酒鬼,N,0,2,2,,2119_
2116,2,聽見,Vt,0,7,7,,2119_2526_2526_2861_3319_3428_
2123,2,立馬騷癢,Vi,0,1,1,,
2123,2,屁股,N,0,8,8,,2260_2523_2707_2708_3150_3150_3360_
2123,2,定價,N,0,1,1,,
2123,2,保,Vt,0,2,2,,3015_
2123,2,數量,N,0,10,10,,2139_2143_2305_2308_2842_2843_3146_3448_3453_
2123,2,消退,Vi,0,1,1,,
2123,2,前天,N,0,3,3,,2439_2959_
2123,2,準吃,Vt,0,1,1,,
2124,2,著店,N,0,1,1,,
2124,2,不著村,N,0,1,1,,
2124,2,準星級,N,0,1,1,,
2124,2,曰,Vt,0,15,15,,2411_2611_2753_3170_3170_3172_3172_3431_3432_3433_3433_3435_3435_3470_
2124,2,涵江區打車,N,0,1,1,,
2124,2,亂爬,Vt,0,1,1,,
2126,2,忍住,Vt,0,1,1,,
2126,2,掉落,Vt,0,1,1,,
2126,2,經理室,N,0,2,2,,2126_
2126,2,發暈,Vi,0,1,1,,
2126,2,值班室,N,0,1,1,,
2126,2,袋子,N,0,3,3,,2450_2453_
2126,2,熱烈,Vi,0,1,1,,
2126,2,巡視,Vt,0,1,1,,
2126,2,結完帳,N,0,2,2,,3167_
2126,2,力氣,N,0,2,2,,3074_
2126,2,限度,N,0,2,2,,3146_
2126,2,頭痛,Vi,0,1,1,,
2126,2,震響,Vt,0,1,1,,
2126,2,隔壁人,N,0,2,2,,2492_
2126,2,手提袋,N,0,2,2,,2126_
2126,2,震驚,Vt,0,3,3,,2746_2862_
2126,2,雨季,N,0,2,2,,2534_
2126,2,皮,N,0,6,6,,2544_2680_2769_2770_2830_
2126,2,手袋,N,0,1,1,,
2126,2,繼而,ADV,0,1,1,,
2126,2,我人,N,0,3,3,,2252_2253_
2126,2,灰,Vi,0,2,2,,2380_
2126,2,波斯特,N,0,1,1,,
2126,2,鼻子,N,0,1,1,,
2127,2,氣死,Vt,0,4,4,,2979_3186_3188_
2127,2,連聲,ADV,0,1,1,,
2127,2,找錢,Vi,0,2,2,,3083_
2127,2,淋巴,N,0,1,1,,
2127,2,跟本,N,0,1,1,,
2127,2,送完,Vt,0,1,1,,
2128,2,大半天,N,0,1,1,,
2129,2,濫,A,0,3,3,,2523_3083_
2129,2,80年代,N,0,6,6,,2254_2256_2584_3013_3195_
2131,2,古鎮,N,0,2,2,,2133_
2131,2,苟同,Vt,0,2,2,,2133_
2131,2,產生,Vt,0,6,6,,2133_2530_2759_3038_3039_
2131,2,開進去,Vt,0,3,3,,2133_3196_
2134,2,肯借,Vt,0,1,1,,
2134,2,高原,N,0,5,5,,3451_3451_3456_3456_
2134,2,軍,N,0,2,2,,2671_
2134,2,拖把,N,0,1,1,,
2134,2,考,Vt,0,2,2,,3087_
2134,2,肯,Vt,0,15,15,,2162_2384_2391_2609_2639_2683_2686_2899_3099_3196_3197_3199_3433_3435_
2134,2,傳真,N,0,8,8,,2229_2494_2495_2739_3032_3033_3329_
2134,2,總而言之,ADV,0,9,9,,2161_2450_2453_2549_2550_2956_2957_3135_
2134,2,積雪,N,0,1,1,,
2134,2,幹什麼,Vi,0,10,10,,2452_2608_2608_2750_2916_3210_3215_3289_3290_
2134,2,傲慢,Vi,0,6,6,,2363_3255_3256_3367_3368_
2134,2,凍,Vt,0,14,14,,2339_2462_2703_2953_3009_3010_3117_3289_3290_3425_3470_3470_3476_
2134,2,剩,Vt,0,4,4,,2630_3007_3331_
2134,2,天壤之別,N,0,2,2,,2917_
2134,2,受罪,Vi,0,4,4,,2411_2517_2519_
2134,2,抬頭,Vi,0,3,3,,2287_2288_
2134,2,車子,N,0,6,6,,2875_3040_3195_3254_3254_
2134,2,敲,Vt,0,6,6,,2383_2523_2746_2987_3341_
2134,2,這一來,ADV,0,1,1,,
2134,2,建塘,N,0,1,1,,
2134,2,大衣,N,0,2,2,,2671_
2134,2,莫名其妙,Vi,0,6,6,,2161_2211_2527_2944_3150_
2134,2,下雪,Vi,0,3,3,,2707_2708_
2135,2,屁股處,N,0,1,1,,
2135,2,劣質貨,N,0,1,1,,
2135,2,凹陷,Vi,0,1,1,,
2136,2,出站口處,N,0,2,2,,2140_
2136,2,抽水馬桶,N,0,7,7,,2140_2740_2861_3300_3303_3466_
2136,2,暴,Vi,0,2,2,,2140_
2136,2,鐵路局,N,0,2,2,,2140_
2136,2,扇壞,N,0,2,2,,2140_
2136,2,脾氣,N,0,6,6,,2140_2464_2466_3108_3109_
2136,2,感情,N,0,3,3,,2140_2175_
2137,2,交費,N,0,3,3,,2141_2208_
2137,2,小宰,N,0,2,2,,2141_
2138,2,鐵軌,N,0,2,2,,3149_
2138,2,汽笛聲,N,0,1,1,,
2139,2,牌取電,N,0,2,2,,2143_
2139,2,攤子,N,0,2,2,,2143_
2139,2,之多,Vi,0,5,5,,2143_2889_2890_3413_
2139,2,靠背,N,0,2,2,,2143_
2139,2,軟墊,N,0,2,2,,2143_
2139,2,加以,ADV,0,3,3,,2143_2227_
2139,2,痕跡,N,0,7,7,,2143_2380_2740_2983_2984_3415_
2139,2,水質,N,0,6,6,,2143_3433_3433_3435_3435_
2139,2,黃河,N,0,4,4,,2143_2450_2453_
2139,2,門插,Vt,0,2,2,,2143_
2139,2,空,N,0,14,14,,2143_2264_2303_2306_2344_2349_2450_2453_2607_2793_2926_2945_3388_
2139,2,斷電,Vi,0,3,3,,2143_2630_
2144,2,讓給,Vt,0,2,2,,2145_
2144,2,推三阻四,Vi,0,2,2,,2145_
2144,2,滲水,Vi,0,2,2,,2145_
2144,2,痕蹟,N,0,2,2,,2145_
2144,2,看機,N,0,2,2,,2145_
2144,2,沒有用,Vi,0,7,7,,2145_2746_2892_2972_3084_3397_
2144,2,綵光,N,0,2,2,,2145_
2144,2,掛上去,Vt,0,4,4,,2145_2961_2963_
2144,2,浴簾,N,0,5,5,,2145_2235_2236_3266_
2146,2,暈死,Vi,0,1,1,,
2147,2,巨,Vi,0,4,4,,2679_3179_3333_
2148,2,有趣,Vi,0,3,3,,2436_3254_
2148,2,囧,Vi,0,1,1,,
2148,2,減,Vt,0,1,1,,
2149,2,國有,A,0,2,2,,2852_
2149,2,儲蓄,N,0,1,1,,
2149,2,當成,Vt,0,2,2,,3319_
2149,2,狂,Vi,0,2,2,,2958_
2151,2,港灣,N,0,2,2,,3347_
2151,2,商家,N,0,2,2,,3308_
2151,2,並排,Vi,0,2,2,,2289_
2151,2,馬哥孛羅,N,0,4,4,,2151_2151_2151_
2151,2,美元,N,0,2,2,,2151_
2151,2,持,Vt,0,1,1,,
2151,2,雙幣,N,0,1,1,,
2153,2,親,Vi,0,1,1,,
2153,2,叫到,Vt,0,3,3,,2276_2544_
2153,2,不停,Vi,0,5,5,,2184_2276_2505_3083_
2153,2,機房,N,0,3,3,,2531_2914_
2153,2,霉,N,0,3,3,,2266_3415_
2153,2,祖國,N,0,1,1,,
2153,2,轟炸機,N,0,3,3,,2993_2994_
2153,2,兩樣,Vi,0,6,6,,2309_2902_2904_3158_3253_
2153,2,爹,N,0,1,1,,
2153,2,瀰漫,Vi,0,5,5,,2247_2267_2367_3397_
2153,2,洋鬼子,N,0,1,1,,
2153,2,盤旋,Vi,0,1,1,,
2153,2,蹩腳,Vi,0,1,1,,
2154,2,二十分鐘,N,0,1,1,,
2154,2,機場線,N,0,1,1,,
2155,2,上網卡,N,0,2,2,,2666_
2155,2,騙,Vt,0,13,13,,2206_2398_2796_2934_3054_3083_3210_3215_3227_3274_3274_3329_
2155,2,大陸人,N,0,2,2,,2385_
2155,2,河邊,N,0,1,1,,
2158,2,冰冷,Vi,0,5,5,,2609_2609_2861_3260_
2158,2,打熱,N,0,1,1,,
2158,2,饅頭,N,0,6,6,,2411_2509_3012_3253_3379_
2158,2,笑,Vi,0,12,12,,2392_2392_2637_2638_2683_2686_2830_2830_3306_3388_3447_
2159,2,明奇秒,N,0,1,1,,
2159,2,素養,N,0,1,1,,
2159,2,接線,Vi,0,10,10,,3399_3433_3433_3433_3433_3435_3435_3435_3435_
2159,2,莫明,N,0,2,2,,2616_
2159,2,安穩,Vi,0,2,2,,3467_
2161,2,黑黑,Vi,0,1,1,,
2161,2,自欺欺人,Vi,0,1,1,,
2161,2,安分,Vi,0,1,1,,
2161,2,軒尼詩道,N,0,1,1,,
2161,2,高額,N,0,1,1,,
2161,2,華美粵海,N,0,1,1,,
2161,2,奇妙,Vi,0,2,2,,2616_
2161,2,驚嚇,Vt,0,1,1,,
2161,2,呃,ADV,0,3,3,,2756_2756_
2161,2,飽受,Vt,0,1,1,,
2161,2,轉到,Vt,0,3,3,,2445_2446_
2161,2,連點,N,0,1,1,,
2161,2,閉,Vt,0,1,1,,
2161,2,臭臉,N,0,2,2,,2270_
2161,2,樂園,N,0,2,2,,2731_
2161,2,心頭,N,0,1,1,,
2161,2,睜,Vt,0,1,1,,
2161,2,國語,N,0,1,1,,
2161,2,倉促,Vi,0,2,2,,2162_
2161,2,評語,N,0,3,3,,2521_2521_
2161,2,繞道,Vi,0,3,3,,2360_2361_
2162,2,女人,N,0,4,4,,2746_2746_3253_
2162,2,雙腳,N,0,1,1,,
2162,2,年代,N,0,4,4,,2731_3479_3481_
2162,2,精神抖擻,Vi,0,1,1,,
2162,2,鬆,Vt,0,1,1,,
2162,2,要緊,Vi,0,4,4,,2360_2361_3202_
2162,2,小刀,N,0,1,1,,
2162,2,酸痛,Vi,0,1,1,,
2162,2,裡間,N,0,1,1,,
2162,2,放上去,Vi,0,1,1,,
2162,2,門簾,N,0,1,1,,
2162,2,一帶,N,0,5,5,,2264_3071_3074_3074_
2162,2,執意,Vt,0,1,1,,
2162,2,撬,Vt,0,1,1,,
2162,2,塞住,Vt,0,1,1,,
2162,2,長久,Vi,0,2,2,,3076_
2162,2,動作,N,0,13,13,,2163_2163_2297_2300_2492_2976_3029_3117_3150_3352_3354_3422_
2162,2,愣,Vi,0,4,4,,3163_3210_3215_
2162,2,寫明,Vt,0,5,5,,2445_2446_3038_3039_
2162,2,塞子,N,0,1,1,,
2162,2,1有,Vt,0,1,1,,
2162,2,許留山歇,N,0,1,1,,
2162,2,還不是,ADV,0,2,2,,2380_
2162,2,歇,Vi,0,1,1,,
2162,2,弄壞,Vt,0,4,4,,2680_3231_3351_
2162,2,掉下來,Vi,0,1,1,,
2162,2,可就,ADV,0,2,2,,3418_
2162,2,坦蕩,Vi,0,1,1,,
2163,2,連貫,Vt,0,1,1,,
2163,2,象紙,N,0,1,1,,
2163,2,席夢思床,N,0,4,4,,2163_2445_2446_
2163,2,鋪,N,0,9,9,,2195_2264_2382_2753_3022_3023_3417_3470_
2163,2,不平,Vi,0,2,2,,3076_
2163,2,浴巾,N,0,25,25,,2211_2391_2419_2419_2517_2519_2748_2796_2796_2796_2813_2867_2892_2967_3062_3071_3119_3124_3141_3458_3495_3495_3497_3497_
2163,2,行李桌,N,0,1,1,,
2163,2,磨損,Vt,0,1,1,,
2163,2,滾,Vi,0,1,1,,
2163,2,躺下,Vi,0,1,1,,
2163,2,一氣呵成,Vi,0,1,1,,
2163,2,致電,Vt,0,37,37,,2406_2408_2776_3213_3218_3388_3433_3433_3433_3433_3433_3433_3433_3433_3433_3433_3433_3433_3433_3433_3433_3435_3435_3435_3435_3435_3435_3435_3435_3435_3435_3435_3435_3435_3435_3435_
2164,2,不全,Vi,0,1,1,,
2164,2,三合一,Vi,0,1,1,,
2164,2,洗手液,N,0,1,1,,
2164,2,十字路口,N,0,1,1,,
2164,2,無故,ADV,0,1,1,,
2164,2,車呼,N,0,1,1,,
2164,2,掛斷,Vt,0,6,6,,3205_3253_3283_3433_3435_
2164,2,沐浴液,N,0,3,3,,2845_2873_
2164,2,洗髮液,N,0,2,2,,2294_
2165,2,服,Vt,0,6,6,,2220_2222_3095_3150_3312_
2165,2,臥具,N,0,2,2,,2335_
2166,2,溫州,N,0,1,1,,
2166,2,陳年,A,0,1,1,,
2166,2,國企,N,0,4,4,,2584_2619_2620_
2166,2,動靜,N,0,2,2,,2492_
2166,2,校,N,0,1,1,,
2167,2,同伴,N,0,3,3,,3367_3368_
2167,2,絕不,ADV,0,7,7,,2264_2426_2442_2477_2478_2873_
2167,2,下文,N,0,4,4,,2776_3170_3172_
2167,2,背後,N,0,2,2,,3072_
2167,2,雄偉,Vi,0,1,1,,
2167,2,損害,Vt,0,1,1,,
2167,2,嚴厲,Vi,0,1,1,,
2167,2,分為,Vt,0,2,2,,2964_
2167,2,狠,Vi,0,2,2,,2848_
2167,2,整頓,Vt,0,1,1,,
2167,2,分開,Vt,0,6,6,,2902_2902_2904_2904_2964_
2168,2,車流,N,0,1,1,,
2168,2,心急,Vi,0,1,1,,
2168,2,密集,Vi,0,1,1,,
2169,2,曲折,Vi,0,1,1,,
2169,2,圖,Vt,0,4,4,,2454_2455_3040_
2169,2,陰暗,Vi,0,8,8,,2235_2236_2479_2601_2699_2808_3205_
2169,2,偽,A,0,1,1,,
2169,2,時期,N,0,1,1,,
2169,2,苛求,Vt,0,1,1,,
2169,2,新樓,N,0,2,2,,2392_
2169,2,文物,N,0,2,2,,2915_
2170,2,活人,N,0,1,1,,
2170,2,掛房帳,N,0,1,1,,
2170,2,急死,Vi,0,1,1,,
2170,2,房頂,N,0,2,2,,2492_
2171,2,成漢庭,N,0,1,1,,
2171,2,鏈,N,0,1,1,,
2171,2,翻修,Vt,0,2,2,,3332_
2171,2,保險,N,0,1,1,,
2174,2,屢屢,ADV,0,1,1,,
2174,2,出錯,Vi,0,2,2,,2751_
2175,2,順德,N,0,1,1,,
2175,2,隨身,ADV,0,6,6,,2816_2818_3296_3427_3462_
2175,2,枕邊,N,0,1,1,,
2175,2,跑上跑下,Vi,0,1,1,,
2175,2,香水,N,0,1,1,,
2175,2,門窗,N,0,2,2,,3083_
2175,2,登門,Vi,0,1,1,,
2175,2,姐姐,N,0,1,1,,
2175,2,不可能,ADV,0,10,10,,2260_2293_2363_2457_3001_3146_3427_3433_3435_
2175,2,進房,N,0,5,5,,2381_2579_2862_2976_
2175,2,濃,Vi,0,11,11,,2190_2477_2928_3083_3120_3125_3174_3186_3188_3270_
2175,2,對不住,Vt,0,2,2,,2192_
2175,2,大打折扣,Vi,0,2,2,,3105_
2175,2,沒人,N,0,2,2,,2175_
2175,2,反感,Vi,0,2,2,,3001_
2177,2,秉承,Vt,0,2,2,,3345_
2177,2,錦,N,0,2,2,,2178_
2178,2,時時,ADV,0,1,1,,
2179,2,涼菜,N,0,1,1,,
2179,2,頂頭,N,0,1,1,,
2179,2,撤餐,N,0,1,1,,
2179,2,鹹菜,N,0,4,4,,2607_2740_3012_
2179,2,熱菜,N,0,3,3,,2305_2308_
2179,2,民族路,N,0,1,1,,
2180,2,性病,N,0,1,1,,
2180,2,傳染,Vt,0,2,2,,3418_
2180,2,大小便,Vi,0,1,1,,
2180,2,換掉,Vt,0,4,4,,3119_3124_3202_
2181,2,亂糟糟,Vi,0,4,4,,2851_3047_3051_
2183,2,確切,Vi,0,1,1,,
2183,2,瘋狂,Vi,0,3,3,,3069_3070_
2183,2,遙控器,N,0,8,8,,2500_2501_2512_2565_2807_3158_3160_
2183,2,龍城,N,0,1,1,,
2184,2,轉來轉去,Vi,0,1,1,,
2186,2,袋,N,0,2,2,,3386_
2186,2,觀音橋,N,0,1,1,,
2186,2,開錯,Vt,0,1,1,,
2186,2,開好,Vt,0,1,1,,
2186,2,十來分鐘,N,0,1,1,,
2186,2,開成,Vt,0,1,1,,
2188,2,老頭,N,0,3,3,,2436_2915_
2189,2,少見,Vi,0,4,4,,2492_2996_3454_
2189,2,飯店界,N,0,1,1,,
2189,2,信用,N,0,3,3,,2604_3227_
2189,2,付錢,Vi,0,9,9,,2209_2210_2229_3101_3253_3254_3254_3462_
2189,2,收押,Vt,0,1,1,,
2189,2,觀念,N,0,1,1,,
2190,2,十年,N,0,1,1,,
2190,2,櫃門,N,0,5,5,,2190_2190_2240_2359_
2190,2,控制台,N,0,1,1,,
2190,2,撲鼻,Vi,0,8,8,,2289_2683_2686_2828_3213_3218_3233_
2190,2,風險,N,0,1,1,,
2190,2,衣帽櫃,N,0,2,2,,2190_
2190,2,空地,N,0,3,3,,2231_2748_
2190,2,貿然,ADV,0,1,1,,
2190,2,木製,A,0,1,1,,
2190,2,預定員,N,0,1,1,,
2190,2,急於,Vt,0,1,1,,
2190,2,塵土,N,0,2,2,,2976_
2190,2,舉動,N,0,3,3,,2842_2843_
2190,2,關閉,Vt,0,6,6,,2296_2671_2959_3181_3466_
2190,2,蜘蛛網,N,0,3,3,,2241_2714_
2190,2,飲料瓶,N,0,1,1,,
2191,2,排煙道,N,0,1,1,,
2191,2,躁,Vi,0,1,1,,
2191,2,不像話,Vi,0,6,6,,2536_2743_2822_2822_3382_
2191,2,6時,N,0,2,2,,2996_
2191,2,推委,N,0,3,3,,2768_3294_
2191,2,隱瞞,Vt,0,1,1,,
2192,2,漏風,Vi,0,3,3,,3405_3410_
2192,2,其次,Vi,0,1,1,,
2192,2,被臥,N,0,1,1,,
2193,2,反映給,Vt,0,2,2,,2737_
2193,2,外線,N,0,1,1,,
2193,2,計入房費,N,0,1,1,,
2193,2,供應,Vt,0,7,7,,2411_2674_2674_2674_2956_2957_
2193,2,上級,N,0,1,1,,
2194,2,桌椅,N,0,2,2,,2976_
2194,2,南戴河,N,0,4,4,,2883_2883_2883_
2195,2,門牙,N,0,1,1,,
2195,2,牙齒,N,0,1,1,,
2195,2,賠償,N,0,11,11,,2244_2245_2252_2253_2680_2680_3101_3289_3290_3341_
2195,2,拒不,ADV,0,3,3,,2616_3193_
2195,2,奈,Vt,0,1,1,,
2195,2,衝涼,Vi,0,1,1,,
2195,2,地上,N,0,22,22,,2340_2341_2450_2453_2631_2649_2730_2769_2770_2845_2872_3001_3150_3266_3327_3389_3390_3392_3394_3433_3435_
2195,2,怎,ADV,0,8,8,,2537_2538_3141_3185_3186_3188_3413_
2195,2,摔倒,Vi,0,1,1,,
2195,2,防滑墊,N,0,1,1,,
2196,2,不清菜,N,0,1,1,,
2197,2,殼兒,N,0,1,1,,
2197,2,傷心,Vi,0,1,1,,
2197,2,忽悠,Vi,0,7,7,,2612_2612_2621_3180_3319_3379_
2197,2,店名,N,0,1,1,,
2197,2,旅館,N,0,36,36,,2276_2276_2417_2417_2419_2457_2458_2458_2532_2532_2533_2533_2584_2702_2871_2874_2879_2880_2934_3085_3094_3112_3123_3159_3159_3159_3159_3159_3159_3159_3236_3274_3274_3275_3305_
2197,2,黑暗,N,0,2,2,,3076_
2198,2,髒髒,Vi,0,3,3,,2969_3363_
2198,2,飲水機,N,0,1,1,,
2198,2,救生門,N,0,1,1,,
2198,2,改建,Vt,0,3,3,,2469_2988_
2198,2,鐵製,A,0,1,1,,
2201,2,連沙拉,N,0,1,1,,
2202,2,快捷式,N,0,1,1,,
2204,2,新舊,N,0,1,1,,
2204,2,逐步,ADV,0,1,1,,
2205,2,泰山石,N,0,1,1,,
2205,2,山景水景,N,0,1,1,,
2205,2,賞,Vt,0,3,3,,2945_3072_
2205,2,色,N,0,1,1,,
2205,2,臉盆,N,0,1,1,,
2205,2,忙不過來,Vi,0,1,1,,
2205,2,滄桑,Vi,0,1,1,,
2205,2,流淚,Vi,0,1,1,,
2205,2,黃河水,N,0,1,1,,
2205,2,濃茶,N,0,1,1,,
2205,2,俯首,ADV,0,1,1,,
2206,2,提箱,N,0,1,1,,
2206,2,左傳,N,0,2,2,,2206_
2206,2,右轉,Vi,0,3,3,,2206_3071_
2206,2,叫出,Vt,0,2,2,,2595_
2206,2,主人,N,0,1,1,,
2206,2,蒼天,N,0,1,1,,
2206,2,崇洋,Vi,0,1,1,,
2206,2,媚外,Vi,0,1,1,,
2206,2,狗,N,0,4,4,,2530_3480_3482_
2207,2,三和板,N,0,1,1,,
2207,2,傳音,N,0,1,1,,
2208,2,而後,ADV,0,1,1,,
2208,2,暈八素,N,0,1,1,,
2208,2,特大,Vi,0,2,2,,3471_
2208,2,發表,Vt,0,3,3,,2571_3443_
2208,2,直犯暈,N,0,1,1,,
2208,2,東都,N,0,1,1,,
2208,2,破口大罵,Vt,0,1,1,,
2208,2,模仿,Vt,0,2,2,,3246_
2208,2,拄,Vt,0,1,1,,
2208,2,純屬,Vt,0,1,1,,
2208,2,懵,Vt,0,3,3,,2936_2937_
2208,2,僥倖,Vi,0,1,1,,
2208,2,一鼓作氣,Vi,0,1,1,,
2208,2,架勢,N,0,1,1,,
2208,2,觀點,N,0,1,1,,
2208,2,當兵,Vi,0,3,3,,2333_2334_
2209,2,武定路,N,0,2,2,,2210_
2209,2,催促,Vt,0,4,4,,2210_2232_2566_
2209,2,黃色,N,0,11,11,,2210_2883_2892_3076_3253_3425_3433_3433_3435_3435_
2209,2,漂白,Vi,0,2,2,,2210_
2209,2,整理,Vt,0,7,7,,2210_2452_2806_2845_3008_3008_
2209,2,辦成,Vt,0,2,2,,2210_
2211,2,開脫,Vt,0,1,1,,
2211,2,進不了,Vt,0,1,1,,
2211,2,卡在,Vt,0,1,1,,
2211,2,幹嘛,Vi,0,2,2,,3232_
2211,2,刮鬍刀,N,0,1,1,,
2211,2,鎖門,Vi,0,1,1,,
2211,2,上衣,N,0,1,1,,
2211,2,惱火,Vi,0,3,3,,2659_3470_
2211,2,消磁,Vi,0,1,1,,
2212,2,搔擾,Vt,0,1,1,,
2219,2,留戀,Vt,0,2,2,,2221_
2220,2,短短,Vi,0,3,3,,2222_2923_
2220,2,質問,Vt,0,5,5,,2222_2759_3433_3435_
2220,2,翻看,Vt,0,2,2,,2222_
2220,2,拿下來,Vi,0,4,4,,2220_2222_2222_
2220,2,密封,Vi,0,4,4,,2220_2222_2222_
2220,2,拆開,Vt,0,2,2,,2222_
2220,2,紙箱子,N,0,6,6,,2220_2220_2222_2222_2222_
2220,2,振振有詞,Vi,0,2,2,,2222_
2220,2,值錢,Vi,0,3,3,,2222_3345_
2223,2,完事,Vi,0,1,1,,
2223,2,蟑螂,N,0,10,10,,2228_2275_2380_2381_2765_3102_3321_3322_3401_
2224,2,天大,A,0,1,1,,
2224,2,溜,Vi,0,1,1,,
2225,2,杜絕,Vt,0,6,6,,2226_2609_3055_3448_3453_
2225,2,交出來,Vt,0,2,2,,2226_
2225,2,天珠,N,0,2,2,,2226_
2225,2,顯靈,Vi,0,2,2,,2226_
2225,2,品德,N,0,2,2,,2226_
2225,2,佛祖,N,0,2,2,,2226_
2225,2,紀念,Vt,0,2,2,,2226_
2225,2,掌握,Vt,0,3,3,,2226_2924_
2225,2,閣下,N,0,11,11,,2225_2225_2226_2226_2226_2862_2862_2862_2862_3371_
2225,2,佛珠,N,0,6,6,,2225_2225_2226_2226_2226_
2228,2,罩,N,0,2,2,,2271_
2228,2,血跡,N,0,8,8,,2228_2549_2549_2550_2550_2669_3035_
2229,2,花錢,Vi,0,4,4,,2229_2899_3347_
2229,2,詫異,Vt,0,1,1,,
2229,2,行為,N,0,8,8,,2417_2565_2565_2582_3001_3079_3226_
2229,2,用於,Vt,0,3,3,,3187_3189_
2229,2,解凍,Vt,0,4,4,,2229_2229_2229_
2231,2,垃圾筒,N,0,1,1,,
2231,2,雲南省,N,0,1,1,,
2231,2,趕下,Vt,0,1,1,,
2231,2,蠻橫,Vi,0,6,6,,2483_2554_2555_3083_3245_
2231,2,蒼山,N,0,1,1,,
2231,2,吃上,Vt,0,1,1,,
2231,2,丑,N,0,1,1,,
2231,2,陳設,N,0,2,2,,3398_
2231,2,親身,ADV,0,3,3,,2525_3443_
2231,2,點餐,N,0,1,1,,
2231,2,轉頭,Vi,0,1,1,,
2231,2,垃圾袋,N,0,1,1,,
2231,2,坑,Vt,0,3,3,,3327_3420_
2231,2,三塔苑,N,0,1,1,,
2231,2,拖到,Vt,0,1,1,,
2231,2,楚雄,N,0,2,2,,2231_
2231,2,衛生紙,N,0,8,8,,2907_3069_3069_3070_3070_3289_3290_
2231,2,加油站,N,0,1,1,,
2231,2,全票,N,0,1,1,,
2231,2,票價,N,0,1,1,,
2231,2,大搖大擺,ADV,0,1,1,,
2231,2,瞭,Vi,0,1,1,,
2231,2,丟進,Vt,0,1,1,,
2231,2,票款,N,0,1,1,,
2231,2,半票,N,0,2,2,,2231_
2231,2,快車,N,0,1,1,,
2231,2,黑漆,Vi,0,1,1,,
2231,2,旅高,N,0,1,1,,
2231,2,麗江,N,0,2,2,,3118_
2231,2,當初,N,0,3,3,,2767_2933_
2232,2,沒準兒,Vi,0,1,1,,
2232,2,原地,N,0,1,1,,
2232,2,報價,Vi,0,5,5,,2871_3308_3488_3490_
2232,2,賠,Vt,0,7,7,,3167_3431_3431_3432_3432_3478_
2232,2,打印機,N,0,1,1,,
2232,2,側牆,N,0,1,1,,
2232,2,背,Vt,0,7,7,,2933_2933_2933_2946_3451_3456_
2232,2,按下,Vt,0,1,1,,
2232,2,低價團,N,0,1,1,,
2232,2,爭取到,Vt,0,1,1,,
2232,2,手柄,N,0,1,1,,
2232,2,裂開,Vi,0,1,1,,
2232,2,原話,N,0,3,3,,2803_3073_
2232,2,30分鐘車,N,0,1,1,,
2232,2,老總,N,0,5,5,,2398_2561_2562_3443_
2232,2,話機,N,0,1,1,,
2232,2,問道,Vt,0,3,3,,2445_2446_
2232,2,打印,Vt,0,10,10,,2232_2365_2445_2445_2446_2446_2534_3289_3290_
2232,2,加倍,Vi,0,1,1,,
2232,2,水單,N,0,4,4,,2232_2232_3264_
2232,2,低價,N,0,1,1,,
2232,2,詳單,N,0,1,1,,
2232,2,球鎖,N,0,1,1,,
2232,2,份兒飯,N,0,1,1,,
2232,2,一小時,N,0,1,1,,
2232,2,簽約,Vi,0,5,5,,2549_2550_2748_2996_
2232,2,客務部,N,0,2,2,,2232_
2232,2,獎勵,Vt,0,2,2,,3416_
2232,2,桌餐,N,0,1,1,,
2232,2,這樣子,Vi,0,1,1,,
2232,2,數額,N,0,1,1,,
2232,2,罰,Vt,0,1,1,,
2232,2,夜遊,Vi,0,1,1,,
2233,2,水流,N,0,4,4,,2547_3047_3051_
2233,2,設計好,Vt,0,1,1,,
2235,2,登封,N,0,2,2,,2236_
2235,2,極端,ADV,0,6,6,,2236_2521_2554_2555_3342_
2235,2,黑燈瞎火,N,0,2,2,,2236_
2239,2,貪污,Vi,0,3,3,,2517_2519_
2239,2,蹤影,N,0,1,1,,
2239,2,當夜,N,0,1,1,,
2239,2,一點鐘,N,0,1,1,,
2240,2,家居,A,0,1,1,,
2240,2,飲用,Vt,0,1,1,,
2241,2,團,N,0,3,3,,3185_3226_
2241,2,疑似,Vt,0,4,4,,2258_2259_2337_
2243,2,窄小,Vi,0,3,3,,2717_2720_
2243,2,低檔,N,0,3,3,,2335_3385_
2243,2,現代化,Vt,0,1,1,,
2244,2,認,Vt,0,2,2,,2245_
2244,2,長途費,N,0,2,2,,2245_
2244,2,弄污,Vt,0,2,2,,2245_
2244,2,說法,N,0,9,9,,2245_2671_3105_3132_3142_3193_3288_3296_
2244,2,降到,Vt,0,3,3,,2245_3099_
2244,2,成本價,N,0,2,2,,2245_
2244,2,被告,N,0,4,4,,2245_3013_3296_
2244,2,強硬,Vi,0,5,5,,2245_2914_3146_3282_
2244,2,罷休,Vi,0,2,2,,2245_
2244,2,鐘點房,N,0,4,4,,2245_3049_3416_
2244,2,賠不起,Vt,0,2,2,,2245_
2244,2,無能為力,Vi,0,2,2,,2245_
2244,2,打給,Vt,0,6,6,,2245_2767_2809_3244_3257_
2244,2,例假,N,0,2,2,,2245_
2246,2,百姓,N,0,1,1,,
2246,2,點肉,N,0,1,1,,
2246,2,公安局,N,0,3,3,,2246_2925_
2247,2,發展,N,0,2,2,,2827_
2247,2,差強人意,Vi,0,2,2,,2541_
2247,2,拉平,Vt,0,1,1,,
2247,2,油煙,N,0,1,1,,
2247,2,髒東西,N,0,1,1,,
2247,2,中級,N,0,1,1,,
2248,2,絕望,Vi,0,2,2,,2250_
2249,2,升上,Vt,0,2,2,,2251_
2249,2,升,Vt,0,2,2,,2251_
2249,2,旅遊局,N,0,9,9,,2251_2417_2417_2417_2759_2824_2826_2967_
2249,2,評估,Vt,0,3,3,,2251_2915_
2252,2,丟失,Vi,0,2,2,,2253_
2252,2,托盤,N,0,2,2,,2253_
2252,2,擔憂,Vt,0,4,4,,2253_2363_3203_
2252,2,慎重,Vi,0,6,6,,2253_2309_2382_3118_3296_
2252,2,啞巴,N,0,2,2,,2253_
2252,2,大理石,N,0,5,5,,2253_3253_3385_3417_
2252,2,北齊,N,0,2,2,,2253_
2252,2,黃連,N,0,2,2,,2253_
2252,2,管家部,N,0,6,6,,2253_2775_2775_3131_3483_
2252,2,動,Vt,0,11,11,,2253_2338_2338_2553_2754_2954_2993_2994_3184_3446_
2252,2,罪名,N,0,2,2,,2253_
2252,2,搜,Vt,0,2,2,,2253_
2252,2,莫須有,A,0,2,2,,2253_
2252,2,聲稱,Vt,0,5,5,,2253_2535_2947_3246_
2252,2,考證,Vt,0,2,2,,2253_
2252,2,宴會,N,0,2,2,,2253_
2252,2,無從,ADV,0,2,2,,2253_
2252,2,臺面,N,0,2,2,,2253_
2252,2,盡,Vi,0,9,9,,2253_2310_2311_2647_2671_2747_2759_3253_
2252,2,減少,Vt,0,5,5,,2253_2747_2769_2770_
2252,2,桃源路,N,0,2,2,,2253_
2252,2,才能,N,0,5,5,,2253_2454_2455_3097_
2252,2,出面,Vi,0,3,3,,2253_3282_
2252,2,房務員,N,0,4,4,,2252_2253_2253_
2252,2,推卸,Vt,0,5,5,,2253_2731_3433_3435_
2252,2,方巾,N,0,11,11,,2252_2252_2252_2253_2253_2253_2253_2274_3478_3478_
2255,2,奇型怪狀,N,0,2,2,,2257_
2258,2,紅色,N,0,4,4,,2259_2748_3333_
2258,2,抱枕,N,0,2,2,,2259_
2258,2,號,N,0,5,5,,2259_2364_3044_3048_
2258,2,足足,ADV,0,12,12,,2259_2458_2836_3185_3213_3218_3253_3253_3253_3433_3435_
2258,2,嚴格,Vi,0,8,8,,2259_2671_2759_2798_2800_3193_3193_
2258,2,把關,Vi,0,2,2,,2259_
2258,2,區塊,N,0,4,4,,2258_2259_2259_
2258,2,責令,Vt,0,2,2,,2259_
2258,2,月經,N,0,2,2,,2259_
2258,2,人手,N,0,4,4,,2258_2259_2259_
2258,2,不盡,Vi,0,2,2,,2259_
2258,2,調配,Vt,0,2,2,,2259_
2258,2,面貌,N,0,2,2,,2259_
2258,2,精液,N,0,2,2,,2259_
2258,2,附贈,Vt,0,3,3,,2259_2322_
2258,2,責任心,N,0,2,2,,2259_
2260,2,細菌,N,0,1,1,,
2260,2,海悅,N,0,4,4,,2260_2318_2319_
2260,2,咱們,N,0,1,1,,
2260,2,3星4星,N,0,1,1,,
2260,2,貪便宜,Vi,0,1,1,,
2264,2,打領帶,Vi,0,1,1,,
2264,2,陪同,Vt,0,1,1,,
2264,2,北方,N,0,4,4,,2391_2483_3347_
2264,2,老幹部,N,0,4,4,,2264_2264_2264_
2264,2,欺負,Vt,0,2,2,,2416_
2264,2,逗,Vt,0,3,3,,2936_2937_
2264,2,住錯,Vt,0,1,1,,
2264,2,廣東話,N,0,3,3,,2264_2384_
2264,2,美女,N,0,1,1,,
2264,2,受氣,Vi,0,3,3,,3083_3184_
2264,2,掏腰包,Vi,0,1,1,,
2264,2,北京人,N,0,1,1,,
2264,2,療養所,N,0,1,1,,
2264,2,兩口子,N,0,1,1,,
2264,2,公款,N,0,2,2,,2544_
2264,2,大老遠,ADV,0,1,1,,
2264,2,了不起,Vi,0,1,1,,
2264,2,西服,N,0,1,1,,
2266,2,像樣,Vi,0,1,1,,
2266,2,茶單點,N,0,1,1,,
2266,2,政府稅,N,0,1,1,,
2266,2,是是,Vi,0,1,1,,
2266,2,找好,Vt,0,1,1,,
2266,2,廣東式,N,0,1,1,,
2266,2,信任,Vt,0,5,5,,2747_3043_3220_3221_
2267,2,髒臭,Vi,0,1,1,,
2267,2,誤導,Vt,0,5,5,,2516_2518_2779_3202_
2267,2,零亂,Vi,0,1,1,,
2267,2,腐霉,N,0,1,1,,
2267,2,非人,A,0,1,1,,
2267,2,不翼而飛,Vi,0,1,1,,
2267,2,一陣,N,0,7,7,,2391_2917_3047_3051_3233_3233_
2269,2,不定,Vi,0,3,3,,3187_3189_
2269,2,相去,Vt,0,5,5,,2426_2725_3433_3435_
2269,2,趕著,ADV,0,2,2,,2458_
2269,2,電信,N,0,4,4,,2972_2972_3281_
2269,2,原處,N,0,1,1,,
2269,2,委婉,Vi,0,1,1,,
2269,2,湊,Vt,0,1,1,,
2269,2,風筒,N,0,1,1,,
2271,2,吐,Vt,0,10,10,,2798_2800_2863_2911_3150_3150_3150_3360_3443_
2271,2,刷牙,Vi,0,2,2,,2492_
2271,2,露出來,Vt,0,1,1,,
2272,2,上好,A,0,1,1,,
2272,2,取電,Vt,0,1,1,,
2272,2,炒飯,N,0,2,2,,3074_
2272,2,飢餓,Vi,0,1,1,,
2272,2,桂林,N,0,4,4,,2933_2933_2933_
2272,2,手續費,N,0,11,11,,3175_3176_3255_3255_3255_3256_3256_3256_3313_3313_
2272,2,轟隆,ADV,0,1,1,,
2272,2,耐不住,Vt,0,1,1,,
2272,2,電鈕,N,0,1,1,,
2272,2,傘,N,0,2,2,,3470_
2272,2,撲面,Vi,0,2,2,,3443_
2272,2,懇求,Vt,0,1,1,,
2272,2,鄭重,ADV,0,1,1,,
2272,2,噴出來,Vt,0,1,1,,
2272,2,持續,Vt,0,4,4,,2771_3146_3341_
2272,2,部位,N,0,1,1,,
2272,2,餐巾紙,N,0,1,1,,
2272,2,施捨,Vt,0,3,3,,2669_2803_
2272,2,斷裂成,Vt,0,1,1,,
2272,2,淋浴器,N,0,2,2,,3103_
2272,2,膠布,N,0,1,1,,
2272,2,慢吞吞,Vi,0,1,1,,
2272,2,俺們,N,0,1,1,,
2272,2,漏雨,Vi,0,2,2,,3467_
2272,2,插卡,N,0,1,1,,
2272,2,二星級,N,0,5,5,,2603_2605_2649_3029_
2272,2,管子,N,0,3,3,,2272_2522_
2272,2,灘水,N,0,1,1,,
2272,2,綁,Vt,0,1,1,,
2272,2,大作,N,0,2,2,,2967_
2272,2,開房,N,0,5,5,,2294_2516_2518_3099_
2273,2,發飆,Vi,0,1,1,,
2273,2,搬動,Vt,0,1,1,,
2273,2,住附樓,N,0,1,1,,
2274,2,離江,N,0,1,1,,
2276,2,４星,N,0,1,1,,
2276,2,雞婆,Vi,0,1,1,,
2276,2,台會,N,0,1,1,,
2276,2,公母,N,0,1,1,,
2276,2,辦事處,N,0,1,1,,
2277,2,喜劇,N,0,1,1,,
2278,2,敘府,N,0,1,1,,
2279,2,發誓,Vt,0,5,5,,2464_2466_2680_3184_
2280,2,破損,Vi,0,3,3,,2680_3012_
2280,2,易,Vi,0,3,3,,3451_3456_
2283,2,如家,Vi,0,5,5,,2283_2283_2283_2283_
2283,2,走過來,Vi,0,1,1,,
2284,2,10.5日,N,0,1,1,,
2284,2,險些,ADV,0,1,1,,
2284,2,原定,Vt,0,2,2,,2284_
2284,2,遭遇,N,0,14,14,,2391_2394_2589_2669_2750_2771_2798_2800_3146_3146_3150_3163_3443_
2284,2,超定,N,0,1,1,,
2284,2,上清寺店,N,0,1,1,,
2284,2,露宿,Vt,0,3,3,,3083_3366_
2284,2,長假,N,0,2,2,,2883_
2284,2,誠信,N,0,5,5,,2342_3308_3308_3458_
2284,2,權,N,0,1,1,,
2284,2,入住單,N,0,2,2,,2691_
2284,2,只得,ADV,0,5,5,,2388_2609_2873_3111_
2284,2,仍舊,ADV,0,2,2,,2534_
2287,2,中和,Vt,0,2,2,,2288_
2287,2,行不行,ADV,0,2,2,,2288_
2287,2,就是說,ADV,0,7,7,,2288_2647_2933_3119_3124_3360_
2287,2,國內外,N,0,4,4,,2288_3423_3424_
2287,2,趕時間,Vi,0,4,4,,2288_2691_3341_
2287,2,合約,N,0,2,2,,2288_
2287,2,性子,N,0,2,2,,2288_
2287,2,親耳,ADV,0,2,2,,2288_
2287,2,問住,Vi,0,2,2,,2288_
2287,2,陳,N,0,4,4,,2288_2388_3329_
2287,2,說來說去,Vi,0,2,2,,2288_
2287,2,戴,Vt,0,3,3,,2288_2609_
2287,2,眼鏡,N,0,8,8,,2288_2609_2751_2917_3000_3062_3071_
2287,2,請示,Vt,0,5,5,,2287_2288_2288_2522_
2287,2,住房,N,0,5,5,,2288_2791_2954_3499_
2287,2,否定,Vt,0,3,3,,2288_2976_
2287,2,簽訂,Vt,0,6,6,,2288_2494_2495_3255_3256_
2287,2,16日晚,Vi,0,6,6,,2287_2287_2288_2288_2288_
2287,2,為敵,Vi,0,2,2,,2288_
2287,2,20樓,N,0,2,2,,2288_
2287,2,鎖定,Vt,0,2,2,,2288_
2289,2,擋水條,N,0,1,1,,
2289,2,冷冰冰,Vi,0,13,13,,2345_2350_2452_2500_2501_2516_2518_2571_2740_2742_3090_3306_
2289,2,農家樂,N,0,2,2,,2975_
2289,2,掃完,Vt,0,2,2,,3308_
2290,2,同層空置,Vt,0,1,1,,
2290,2,看去,Vi,0,1,1,,
2290,2,2時,N,0,1,1,,
2290,2,美國式,A,0,1,1,,
2290,2,衝去,Vi,0,1,1,,
2290,2,黑乎乎,Vi,0,7,7,,2335_2625_2987_3013_3013_3174_
2290,2,實物,N,0,1,1,,
2291,2,反過來,Vi,0,1,1,,
2291,2,訂掉,Vt,0,1,1,,
2291,2,看完,Vt,0,3,3,,2650_2653_
2291,2,觀察,Vt,0,2,2,,2452_
2291,2,何在,Vi,0,1,1,,
2293,2,收半,N,0,1,1,,
2295,2,邏輯,N,0,1,1,,
2295,2,恰好,ADV,0,1,1,,
2295,2,制定,Vt,0,1,1,,
2296,2,順暢,Vi,0,1,1,,
2296,2,房間門,N,0,5,5,,2322_2707_2708_3339_
2296,2,用力,Vi,0,1,1,,
2297,2,凶,Vi,0,3,3,,2300_2827_
2297,2,沒空調,N,0,2,2,,2300_
2297,2,臉色,N,0,5,5,,2300_2745_3360_3471_
2297,2,公營,Vi,0,2,2,,2300_
2298,2,譜,N,0,2,2,,2301_
2298,2,圈椅,N,0,4,4,,2298_2301_2301_
2298,2,茶几,N,0,2,2,,2301_
2298,2,搬進,Vt,0,2,2,,2301_
2298,2,靠背椅,N,0,2,2,,2301_
2298,2,單人房,N,0,2,2,,2301_
2298,2,換出,Vt,0,2,2,,2301_
2299,2,魚丸,N,0,2,2,,2302_
2299,2,好笑,Vi,0,4,4,,2302_2584_3478_
2303,2,購物袋,N,0,2,2,,2306_
2303,2,盒子,N,0,10,10,,2303_2306_2306_2553_2662_2902_2904_3321_3322_
2303,2,包天,N,0,2,2,,2306_
2303,2,話費,N,0,2,2,,2306_
2304,2,頭暈,Vi,0,3,3,,2307_3417_
2304,2,不著,Vi,0,2,2,,2307_
2305,2,隨之,ADV,0,3,3,,2308_2671_
2305,2,針對,Vt,0,2,2,,2308_
2305,2,巨資,N,0,2,2,,2308_
2305,2,小菜,N,0,5,5,,2308_2509_3289_3290_
2305,2,幹線,N,0,2,2,,2308_
2305,2,沙拉,N,0,2,2,,2308_
2305,2,完工,Vi,0,3,3,,2308_2695_
2305,2,糕點,N,0,2,2,,2308_
2305,2,珍惜,Vt,0,4,4,,2305_2308_2308_
2305,2,西段,N,0,2,2,,2308_
2305,2,聯發,N,0,2,2,,2308_
2309,2,撤掉,Vt,0,1,1,,
2309,2,圖片,N,0,12,12,,2426_2718_2718_2721_2721_2744_3295_3363_3363_3458_3458_
2309,2,稍後,ADV,0,7,7,,3129_3130_3433_3433_3435_3435_
2309,2,隨後,N,0,5,5,,2510_2511_2609_3184_
2309,2,專員,N,0,1,1,,
2309,2,徐州,N,0,1,1,,
2309,2,本,ADV,0,17,17,,2344_2349_2378_2388_2454_2455_2510_2511_2534_2740_2791_2869_3101_3305_3423_3424_
2309,2,九十年代,N,0,2,2,,2544_
2309,2,疏忽,Vt,0,3,3,,2824_2826_
2309,2,稍稍,ADV,0,1,1,,
2309,2,早早,ADV,0,2,2,,3242_
2309,2,出完差,N,0,1,1,,
2309,2,睡下,Vi,0,2,2,,2544_
2309,2,得體,Vi,0,1,1,,
2309,2,假道,Vt,0,1,1,,
2309,2,衣著,N,0,2,2,,2691_
2310,2,完整,Vi,0,3,3,,2311_3332_
2310,2,包裝,Vt,0,9,9,,2311_2318_2319_2649_3139_3139_3332_3446_
2313,2,準時,Vi,0,8,8,,2316_3129_3129_3130_3130_3253_3308_
2313,2,招,N,0,5,5,,2313_2316_2316_2322_
2313,2,和尚,N,0,2,2,,2316_
2313,2,掂,Vt,0,2,2,,2316_
2313,2,尼姑,N,0,2,2,,2316_
2313,2,幹嗎,Vi,0,6,6,,2316_2745_3202_3213_3218_
2313,2,米蘭,N,0,2,2,,2316_
2313,2,響起,Vi,0,2,2,,2316_
2314,2,如一,Vi,0,3,3,,2317_3141_
2314,2,上司,N,0,2,2,,2317_
2314,2,模樣,N,0,3,3,,2317_2571_
2314,2,位評友,N,0,2,2,,2317_
2314,2,不吐不快,Vi,0,4,4,,2317_3040_3231_
2314,2,逼,Vt,0,2,2,,2317_
2314,2,夠爛,Vi,0,2,2,,2317_
2314,2,大小姐,N,0,2,2,,2317_
2314,2,愛搭,Vt,0,2,2,,2317_
2318,2,遵華,N,0,2,2,,2319_
2318,2,華美達,N,0,5,5,,2319_2388_2388_2688_
2318,2,據稱,ADV,0,2,2,,2319_
2318,2,顯著,Vi,0,2,2,,2319_
2318,2,稱道,Vi,0,3,3,,2319_3365_
2320,2,冰雪,N,0,1,1,,
2320,2,哈,ADV,0,1,1,,
2320,2,牌牌,N,0,1,1,,
2320,2,汗味,N,0,3,3,,2517_2519_
2322,2,家庭房,N,0,4,4,,2731_2731_3013_
2322,2,禮物,N,0,1,1,,
2322,2,入駐,Vt,0,1,1,,
2322,2,胡,N,0,3,3,,2902_2904_
2322,2,啟,Vt,0,1,1,,
2322,2,工,N,0,1,1,,
2322,2,再見,Vi,0,2,2,,3076_
2322,2,事務,N,0,1,1,,
2322,2,分期,ADV,0,1,1,,
2322,2,期盼,Vt,0,1,1,,
2322,2,自行,ADV,0,5,5,,2933_2933_3257_3294_
2322,2,減免,Vt,0,2,2,,2776_
2322,2,著稱,Vi,0,3,3,,3448_3453_
2322,2,至今,ADV,0,7,7,,2356_2417_2798_2800_3231_3296_
2322,2,盤子,N,0,5,5,,2607_3014_3331_3331_
2322,2,鑽石,N,0,6,6,,2621_2621_2621_2621_3397_
2322,2,湯勺,N,0,1,1,,
2322,2,不顧,Vt,0,1,1,,
2323,2,弧度,N,0,2,2,,2703_
2324,2,刷房卡,N,0,1,1,,
2324,2,足球場,N,0,1,1,,
2324,2,檯燈,N,0,3,3,,2714_3395_
2324,2,恢復,Vt,0,4,4,,2616_3433_3435_
2324,2,灣路,N,0,1,1,,
2324,2,有空房,N,0,1,1,,
2324,2,西江,N,0,1,1,,
2324,2,不清,Vi,0,5,5,,2532_2533_3448_3453_
2324,2,電視劇,N,0,1,1,,
2324,2,畫面,N,0,2,2,,3076_
2326,2,木屋,N,0,1,1,,
2326,2,走開,Vi,0,1,1,,
2326,2,呱,ADV,0,1,1,,
2326,2,嘰,ADV,0,1,1,,
2326,2,識趣,Vi,0,1,1,,
2326,2,公共,A,0,7,7,,2600_2922_3239_3239_3448_3453_
2326,2,跑出來,Vi,0,1,1,,
2326,2,作息,N,0,1,1,,
2326,2,干擾,Vt,0,2,2,,2547_
2333,2,大壩,N,0,3,3,,2334_3319_
2333,2,透頂,ADV,0,4,4,,2334_3022_3023_
2333,2,盤問,Vt,0,2,2,,2334_
2333,2,攔截,Vt,0,2,2,,2334_
2333,2,武警,N,0,2,2,,2334_
2333,2,出示,Vt,0,5,5,,2334_2784_2861_2861_
2333,2,通行證,N,0,4,4,,2333_2334_2334_
2333,2,證件,N,0,10,10,,2334_2454_2454_2455_2455_2582_2582_2869_3001_
2333,2,高速路,N,0,2,2,,2334_
2333,2,辦完,Vt,0,9,9,,2334_2561_2562_2790_3083_3388_3433_3435_
2335,2,品味,N,0,1,1,,
2335,2,沮喪,Vi,0,2,2,,2873_
2337,2,廢棄,Vt,0,3,3,,3433_3435_
2337,2,老掉牙,Vi,0,1,1,,
2337,2,堆放,Vt,0,1,1,,
2337,2,棉被,N,0,2,2,,3202_
2338,2,迎,Vt,0,2,2,,3347_
2338,2,充,Vt,0,1,1,,
2338,2,果,N,0,1,1,,
2338,2,以次,ADV,0,1,1,,
2338,2,級,N,0,8,8,,3100_3119_3124_3289_3290_3319_3331_
2340,2,衡水,N,0,2,2,,2341_
2340,2,瓜子皮,N,0,2,2,,2341_
2342,2,標的,N,0,4,4,,2949_3119_3124_
2342,2,指點,Vt,0,3,3,,3170_3172_
2342,2,大幅,ADV,0,2,2,,3146_
2342,2,應當,ADV,0,2,2,,2342_
2342,2,前燈,N,0,1,1,,
2342,2,休閒房,N,0,1,1,,
2342,2,報館,N,0,1,1,,
2342,2,總統,N,0,2,2,,2997_
2342,2,軟硬件,N,0,1,1,,
2342,2,摸索,Vt,0,1,1,,
2342,2,氣度,N,0,1,1,,
2342,2,有無,Vt,0,2,2,,2342_
2342,2,高標,N,0,3,3,,2342_2949_
2343,2,鋼絲,N,0,1,1,,
2343,2,一無是處,Vi,0,1,1,,
2343,2,單號,N,0,1,1,,
2344,2,作響,Vi,0,4,4,,2349_3405_3410_
2344,2,難聞,Vi,0,5,5,,2349_3087_3289_3290_
2344,2,尚且,ADV,0,2,2,,2349_
2344,2,浴帽,N,0,3,3,,2349_3204_
2344,2,羽毛盒,N,0,2,2,,2349_
2344,2,齊齊哈爾,N,0,3,3,,2347_2349_
2344,2,吱吱,ADV,0,2,2,,2349_
2347,2,湖濱,N,0,1,1,,
2353,2,標兵,N,0,1,1,,
2354,2,掉色,Vi,0,2,2,,2355_
2354,2,特性,N,0,2,2,,2355_
2354,2,黑心店,N,0,2,2,,2355_
2354,2,染紅,Vt,0,2,2,,2355_
2354,2,河南人,N,0,2,2,,2355_
2354,2,想開,Vi,0,3,3,,2355_2815_
2354,2,洗掉,Vt,0,2,2,,2355_
2354,2,決,ADV,0,2,2,,2355_
2354,2,展現出來,Vi,0,2,2,,2355_
2354,2,作罷,Vi,0,4,4,,2355_2916_3117_
2354,2,稅務,N,0,2,2,,2355_
2356,2,撲來,Vi,0,1,1,,
2359,2,銀處,N,0,1,1,,
2359,2,高價,N,0,4,4,,2564_3423_3424_
2359,2,不勝,ADV,0,1,1,,
2359,2,具備,Vt,0,5,5,,2671_2671_2750_2988_
2359,2,全力,ADV,0,1,1,,
2359,2,煩死,Vi,0,1,1,,
2359,2,針對性,N,0,1,1,,
2359,2,清閒,Vi,0,1,1,,
2359,2,迎接到館,N,0,1,1,,
2360,2,明碼,N,0,2,2,,2361_
2360,2,正事,N,0,2,2,,2361_
2360,2,改名,Vt,0,3,3,,2361_2522_
2360,2,金鷹,N,0,10,10,,2360_2360_2360_2360_2361_2361_2361_2361_2361_
2360,2,稀鬆,Vi,0,2,2,,2361_
2360,2,碰見,Vt,0,2,2,,2361_
2360,2,點車,N,0,2,2,,2361_
2360,2,背面,N,0,6,6,,2361_2855_2856_3040_3231_
2360,2,寧可,Vt,0,5,5,,2361_3076_3489_3491_
2360,2,卷,N,0,3,3,,2361_3184_
2360,2,收費員,N,0,4,4,,2360_2361_2361_
2360,2,屁,N,0,4,4,,2361_2445_2446_
2360,2,寧,ADV,0,3,3,,2361_3083_
2360,2,停車卡,N,0,2,2,,2361_
2360,2,停車處,N,0,2,2,,2361_
2360,2,捲,Vt,0,2,2,,2361_
2360,2,轉過來,Vi,0,2,2,,2361_
2360,2,等一下,ADV,0,2,2,,2361_
2360,2,滬,N,0,2,2,,2361_
2360,2,可樂,N,0,6,6,,2361_3038_3038_3039_3039_
2360,2,雪碧,N,0,2,2,,2361_
2360,2,交接班,N,0,5,5,,2361_3360_3373_3374_
2360,2,密密麻麻,Vi,0,2,2,,2361_
2360,2,外地車,N,0,2,2,,2361_
2360,2,開幕,Vi,0,2,2,,2361_
2360,2,維景,N,0,10,10,,2360_2360_2360_2360_2361_2361_2361_2361_2361_
2360,2,結,Vt,0,5,5,,2361_2516_2518_3462_
2360,2,章,N,0,3,3,,2361_3193_
2362,2,特,ADV,0,16,16,,2480_2481_2482_2522_2604_2609_2630_2879_2880_2995_3270_3276_3293_3293_3331_
2362,2,大叔,N,0,1,1,,
2363,2,紅腫,Vi,0,2,2,,2636_
2363,2,有關,Vt,0,1,1,,
2363,2,堅稱,Vt,0,1,1,,
2363,2,呆,Vt,0,3,3,,2486_2946_
2363,2,在即,Vi,0,1,1,,
2363,2,調房,N,0,1,1,,
2363,2,國宏,N,0,1,1,,
2363,2,刺激性,N,0,1,1,,
2363,2,店方,N,0,4,4,,2517_2519_3296_
2363,2,呼吸,Vt,0,1,1,,
2364,2,堂堂,Vi,0,3,3,,2874_3180_
2365,2,貢獻,Vt,0,1,1,,
2365,2,找不著,Vt,0,1,1,,
2367,2,足以,Vt,0,4,4,,2756_3448_3453_
2367,2,嘲雜,A,0,1,1,,
2367,2,過往,N,0,1,1,,
2367,2,至多,ADV,0,1,1,,
2367,2,懶覺,N,0,3,3,,2767_3242_
2368,2,優悅,N,0,2,2,,2369_
2368,2,積分,N,0,6,6,,2369_2536_2559_3119_3124_
2370,2,鬼,N,0,6,6,,2373_2459_2587_2915_3194_
2371,2,搖頭,Vi,0,5,5,,2371_2374_2374_2731_
2372,2,快快,Vi,0,2,2,,2375_
2372,2,疲憊不堪,Vi,0,2,2,,2375_
2372,2,篇幅,N,0,2,2,,2375_
2372,2,快速,Vi,0,3,3,,2375_2872_
2372,2,機制,N,0,2,2,,2375_
2376,2,辯論,Vt,0,1,1,,
2376,2,裡邊,N,0,2,2,,2933_
2376,2,鐵,N,0,4,4,,2391_3159_3333_
2376,2,犄角,N,0,1,1,,
2376,2,拆,Vt,0,1,1,,
2376,2,架子,N,0,1,1,,
2376,2,廣告牌,N,0,1,1,,
2378,2,不如人意,Vi,0,1,1,,
2378,2,貴陽,N,0,9,9,,2378_2383_2794_2794_2868_3458_3458_3458_
2378,2,洞,N,0,3,3,,2380_3288_
2378,2,退掉,Vt,0,2,2,,2527_
2378,2,將就,Vi,0,3,3,,2809_3056_
2380,2,圈圈,N,0,1,1,,
2380,2,坦然,Vi,0,1,1,,
2380,2,爬過去,Vi,0,1,1,,
2380,2,液體,N,0,5,5,,2382_2908_3325_3409_
2381,2,凹下去,Vi,0,1,1,,
2381,2,佈景,N,0,1,1,,
2381,2,按下去,Vi,0,2,2,,3466_
2382,2,夾雜,Vt,0,3,3,,2728_2729_
2382,2,時常,ADV,0,1,1,,
2382,2,德,N,0,1,1,,
2382,2,印記,N,0,2,2,,2908_
2382,2,會兒,N,0,1,1,,
2382,2,黑鞋印,N,0,1,1,,
2382,2,小強,N,0,2,2,,2845_
2382,2,淹七軍,N,0,1,1,,
2382,2,環境級,N,0,1,1,,
2383,2,瑞金,N,0,1,1,,
2383,2,上輩子,N,0,1,1,,
2383,2,一下門,N,0,1,1,,
2384,2,遊記,N,0,1,1,,
2384,2,高點,N,0,1,1,,
2384,2,寧願,Vt,0,7,7,,2483_2829_2881_3373_3374_3385_
2384,2,買好,Vt,0,1,1,,
2384,2,午覺,N,0,1,1,,
2384,2,交談,Vi,0,1,1,,
2384,2,銅羅灣,N,0,1,1,,
2384,2,延弛,Vi,0,1,1,,
2384,2,住珀寧,N,0,1,1,,
2384,2,崇光,N,0,1,1,,
2384,2,紅眼,N,0,1,1,,
2385,2,翻白眼,Vi,0,3,3,,3373_3374_
2385,2,小巷,N,0,1,1,,
2386,2,衛,N,0,1,1,,
2386,2,漲到,Vi,0,1,1,,
2386,2,烏魯木齊,N,0,2,2,,2386_
2386,2,零下,A,0,1,1,,
2387,2,對付,Vt,0,3,3,,2861_3159_
2387,2,毛,N,0,4,4,,2756_2791_2864_
2388,2,新融,N,0,1,1,,
2388,2,好辯,Vi,0,1,1,,
2388,2,潔具,N,0,4,4,,2544_3352_3354_
2388,2,向來,ADV,0,2,2,,3194_
2388,2,接線生,N,0,1,1,,
2388,2,思想,N,0,3,3,,2756_3249_
2388,2,清冷,Vi,0,1,1,,
2388,2,生手,N,0,1,1,,
2388,2,浴,Vi,0,3,3,,2986_3253_
2388,2,答非所問,Vi,0,1,1,,
2388,2,屯河,N,0,1,1,,
2388,2,睨,Vt,0,1,1,,
2388,2,空蕩,Vi,0,2,2,,2414_
2388,2,調研,Vt,0,1,1,,
2388,2,宛若,Vt,0,1,1,,
2388,2,前來,Vt,0,1,1,,
2388,2,暗舊,Vi,0,1,1,,
2390,2,拉箱抬上,Vt,0,1,1,,
2390,2,和暖水,N,0,1,1,,
2390,2,平安府,N,0,1,1,,
2391,2,告誡,Vt,0,1,1,,
2391,2,本該,ADV,0,1,1,,
2391,2,放出,Vt,0,1,1,,
2391,2,陳述,Vt,0,1,1,,
2391,2,手巾,N,0,2,2,,2528_
2391,2,飲料券,N,0,2,2,,2502_
2391,2,抖動,Vt,0,2,2,,2946_
2391,2,尚未,ADV,0,1,1,,
2391,2,擦,Vt,0,5,5,,2888_3205_3289_3290_
2391,2,退款,Vi,0,2,2,,2947_
2391,2,環節,N,0,1,1,,
2391,2,接通,Vt,0,4,4,,2606_3170_3172_
2391,2,期望,Vt,0,6,6,,2761_2762_2771_3255_3256_
2391,2,異議,N,0,3,3,,3038_3039_
2391,2,10樓,N,0,6,6,,3024_3026_3038_3039_3260_
2391,2,答應,Vt,0,8,8,,2816_2818_3065_3067_3227_3329_3337_
2392,2,巨大,Vi,0,6,6,,2639_2742_3451_3456_3467_
2392,2,不自覺,Vt,0,3,3,,2769_2770_
2394,2,定下,Vt,0,3,3,,3119_3124_
2394,2,定好,Vt,0,1,1,,
2394,2,巧,Vi,0,2,2,,3454_
2394,2,灰泥,N,0,1,1,,
2397,2,混子,N,0,1,1,,
2398,2,皮鞋,N,0,7,7,,2902_2902_2902_2904_2904_2904_
2398,2,暗淡,Vi,0,1,1,,
2398,2,辭職,Vi,0,1,1,,
2398,2,再下來,ADV,0,1,1,,
2399,2,剃鬚刀,N,0,6,6,,2401_3213_3213_3218_3218_
2400,2,攜程訂,Vt,0,5,5,,2402_3029_3222_3487_
2404,2,倉庫,N,0,1,1,,
2405,2,無理,Vi,0,6,6,,2407_2454_2455_3268_3327_
2405,2,期,N,0,2,2,,2407_
2405,2,殘,Vi,0,3,3,,2407_3078_
2406,2,坐起來,Vi,0,2,2,,2408_
2406,2,逃跑,Vi,0,2,2,,2408_
2406,2,中南海,N,0,2,2,,2408_
2406,2,鍛煉,Vt,0,4,4,,2408_3108_3109_
2406,2,隆隆,Vi,0,2,2,,2408_
2406,2,枕,N,0,4,4,,2408_2600_3184_
2406,2,濱大,N,0,2,2,,2408_
2406,2,挨,Vt,0,5,5,,2408_3345_3443_3476_
2406,2,搶修,Vt,0,6,6,,2408_3433_3433_3435_3435_
2409,2,安徽省,N,0,2,2,,2410_
2409,2,比低,Vi,0,4,4,,2410_2840_3091_
2409,2,水聲,N,0,4,4,,2410_3428_3471_
2411,2,煎蛋,N,0,5,5,,2450_2453_2968_2968_
2411,2,酒會,N,0,1,1,,
2411,2,展銷會,N,0,1,1,,
2411,2,9點鐘,N,0,7,7,,2494_2495_2554_2555_2767_2782_
2411,2,做生意,Vi,0,1,1,,
2411,2,糖,N,0,1,1,,
2411,2,應付,Vt,0,1,1,,
2412,2,秦發,N,0,1,1,,
2412,2,海岳,N,0,1,1,,
2412,2,報業,N,0,1,1,,
2412,2,變態,Vi,0,4,4,,2412_3059_3333_
2412,2,昂貴,Vi,0,1,1,,
2413,2,零星級,N,0,1,1,,
2414,2,週六,N,0,3,3,,3463_3463_
2416,2,網民,N,0,1,1,,
2416,2,留給,Vt,0,3,3,,3253_3338_
2416,2,表態,Vi,0,1,1,,
2416,2,午夜,N,0,4,4,,2857_2858_2996_
2416,2,鐘,N,0,5,5,,2565_2862_3253_3253_
2416,2,說給,Vt,0,10,10,,3001_3054_3186_3188_3210_3215_3227_3367_3368_
2416,2,忌諱,N,0,2,2,,2416_
2417,2,欺詐,Vt,0,5,5,,2463_2465_2675_2677_
2417,2,精品,N,0,2,2,,2742_
2417,2,擁有,Vt,0,2,2,,2571_
2417,2,1996年,N,0,1,1,,
2417,2,輕鬆,Vi,0,5,5,,2750_3105_3480_3482_
2417,2,欺害,Vt,0,2,2,,2417_
2417,2,有利,Vt,0,1,1,,
2417,2,天津市,N,0,1,1,,
2417,2,人來人往,Vi,0,2,2,,3239_
2417,2,物價局,N,0,1,1,,
2417,2,認同,Vt,0,1,1,,
2417,2,頒發,Vt,0,2,2,,2417_
2417,2,有別於,Vt,0,1,1,,
2417,2,缺欠,Vt,0,1,1,,
2417,2,證書,N,0,2,2,,2417_
2417,2,歐美,N,0,1,1,,
2417,2,熙熙攘攘,Vi,0,1,1,,
2417,2,按此,ADV,0,1,1,,
2417,2,思考,Vt,0,1,1,,
2417,2,消費者,N,0,11,11,,2417_2417_2463_2465_2516_2518_2771_2842_2843_3246_
2418,2,單布,N,0,1,1,,
2418,2,浴衣,N,0,3,3,,2528_2571_
2418,2,速溶,Vt,0,1,1,,
2418,2,新洗,Vt,0,1,1,,
2419,2,踢,Vt,0,4,4,,2731_3052_3053_
2419,2,標榜,Vt,0,6,6,,3287_3352_3354_3433_3435_
2419,2,轉門,N,0,1,1,,
2419,2,浴巾架,N,0,1,1,,
2419,2,門轉,N,0,1,1,,
2419,2,疊,Vt,0,2,2,,2631_
2421,2,喇叭,N,0,7,7,,2795_3375_3376_3377_3378_3476_
2421,2,小區,N,0,3,3,,3293_3487_
2421,2,淌,Vt,0,1,1,,
2424,2,免,Vt,0,8,8,,2616_2688_2872_3187_3189_3213_3218_
2424,2,天河,N,0,2,2,,2426_
2425,2,讀,Vt,0,2,2,,2428_
2425,2,平安無事,Vi,0,2,2,,2428_
2425,2,靈異,Vi,0,2,2,,2428_
2425,2,失敗,Vi,0,2,2,,2428_
2425,2,拔,Vt,0,4,4,,2428_2571_2812_
2425,2,台式機,N,0,4,4,,2425_2428_2428_
2425,2,散發,Vt,0,2,2,,2428_
2425,2,光盤,N,0,2,2,,2428_
2426,2,皇家,N,0,3,3,,2426_3418_
2426,2,旅社,N,0,4,4,,2514_3031_3031_
2426,2,市郊,N,0,1,1,,
2426,2,發佈,Vt,0,1,1,,
2426,2,悔,Vi,0,2,2,,3335_
2432,2,綠綠,Vi,0,2,2,,2435_
2432,2,哄,Vt,0,6,6,,2432_2432_2435_2435_2435_
2432,2,吵死,Vi,0,4,4,,2435_2855_2856_
2432,2,貨車,N,0,2,2,,2435_
2433,2,08年,N,0,5,5,,2530_2816_2818_3049_
2434,2,梳化,Vt,0,1,1,,
2434,2,小企缸,N,0,1,1,,
2434,2,坐位,N,0,1,1,,
2434,2,廁,N,0,3,3,,3352_3354_
2434,2,廳,N,0,13,13,,2434_2516_2517_2518_2519_2872_2872_2923_3433_3433_3435_3435_
2434,2,闊,Vi,0,1,1,,
2434,2,煮食,Vt,0,2,2,,2434_
2434,2,洗手盤,N,0,1,1,,
2434,2,爐灶,N,0,1,1,,
2434,2,開放式,A,0,1,1,,
2434,2,31樓,N,0,1,1,,
2436,2,冒雨,Vi,0,2,2,,2815_
2436,2,粗魯,Vi,0,1,1,,
2436,2,李矛,N,0,1,1,,
2436,2,灰暗,Vi,0,3,3,,2579_3305_
2438,2,認帳,Vi,0,2,2,,2440_
2438,2,頭目,N,0,2,2,,2440_
2438,2,劃傷,Vt,0,2,2,,2440_
2444,2,七點鐘,N,0,2,2,,2527_
2444,2,涮漆,N,0,1,1,,
2444,2,地下層,N,0,1,1,,
2445,2,外地,N,0,3,3,,2446_3136_
2445,2,搬下來,Vt,0,2,2,,2446_
2445,2,馬,N,0,5,5,,2446_2907_3078_3184_
2445,2,哭,Vi,0,2,2,,2446_
2445,2,哭鬧,Vi,0,2,2,,2446_
2445,2,鮑翅館,N,0,6,6,,2445_2445_2446_2446_2446_
2445,2,墊,Vt,0,3,3,,2446_3443_
2445,2,端午節,N,0,2,2,,2446_
2445,2,菜單,N,0,12,12,,2445_2445_2445_2446_2446_2446_2446_2742_2754_2976_3347_
2445,2,接線員,N,0,5,5,,2446_2651_2654_2793_
2445,2,分機,N,0,2,2,,2446_
2445,2,猴年,N,0,2,2,,2446_
2445,2,入住卡,N,0,2,2,,2446_
2445,2,瞟,Vt,0,2,2,,2446_
2445,2,婚房,N,0,2,2,,2446_
2445,2,席夢思,N,0,4,4,,2446_3470_3470_
2445,2,不肯,N,0,2,2,,2446_
2445,2,來去,Vi,0,2,2,,2446_
2445,2,積分卡,N,0,4,4,,2445_2446_2446_
2447,2,賜教,Vi,0,1,1,,
2447,2,良大,N,0,1,1,,
2447,2,邀請,Vt,0,3,3,,3146_3231_
2450,2,復原,Vi,0,2,2,,2453_
2450,2,收拾好,Vt,0,3,3,,2453_3253_
2450,2,差多了,Vi,0,3,3,,2453_2621_
2450,2,飛天大,N,0,6,6,,2450_2450_2453_2453_2453_
2450,2,參見,Vt,0,2,2,,2453_
2450,2,驚奇,Vt,0,3,3,,2453_2815_
2450,2,絕大,A,0,2,2,,2453_
2450,2,軍人,N,0,3,3,,2453_2862_
2450,2,閒人,N,0,2,2,,2453_
2450,2,連棉簽,N,0,2,2,,2453_
2450,2,不知去向,Vi,0,2,2,,2453_
2450,2,聯網,Vi,0,2,2,,2453_
2450,2,客梯,N,0,4,4,,2450_2453_2453_
2450,2,廚師,N,0,7,7,,2453_2742_2861_3175_3176_3333_
2450,2,開夜,N,0,2,2,,2453_
2450,2,辦公樓,N,0,6,6,,2453_2624_2624_2857_2858_
2450,2,快遞,N,0,5,5,,2453_2806_2902_2904_
2450,2,紐,N,0,2,2,,2453_
2450,2,政治,N,0,2,2,,2453_
2450,2,公然,ADV,0,2,2,,2453_
2452,2,男女,N,0,1,1,,
2454,2,句,N,0,2,2,,2455_
2454,2,市長,N,0,4,4,,2454_2455_2455_
2458,2,周莊,N,0,1,1,,
2458,2,索性,ADV,0,2,2,,3413_
2458,2,水鄉,N,0,2,2,,3118_
2460,2,碗筷,N,0,2,2,,2461_
2462,2,有名無實,Vi,0,1,1,,
2463,2,酒廊,N,0,7,7,,2465_2698_2698_2754_2754_3111_
2463,2,專項,N,0,2,2,,2465_
2463,2,正巧,ADV,0,4,4,,2465_3433_3435_
2463,2,變相,ADV,0,2,2,,2465_
2464,2,瑞安,N,0,2,2,,2466_
2464,2,拒載,Vt,0,2,2,,2466_
2467,2,地氈,N,0,2,2,,2468_
2467,2,布,N,0,3,3,,2468_2753_
2467,2,差劣,N,0,2,2,,2468_
2467,2,恐,Vt,0,2,2,,2468_
2469,2,開設,Vt,0,1,1,,
2471,2,高貴,Vi,0,1,1,,
2471,2,白眼,N,0,1,1,,
2473,2,評為,Vt,0,3,3,,2551_2869_
2473,2,返點,Vi,0,2,2,,2851_
2475,2,登出來,Vi,0,1,1,,
2475,2,世道,N,0,1,1,,
2475,2,改正,Vt,0,3,3,,3163_3163_
2476,2,在在,ADV,0,1,1,,
2477,2,甚至於,ADV,0,1,1,,
2477,2,暖意,N,0,1,1,,
2477,2,消毒水味,N,0,1,1,,
2480,2,寬貸,Vt,0,1,1,,
2480,2,獲取,Vt,0,1,1,,
2481,2,攜程別,N,0,2,2,,2482_
2481,2,回扣,N,0,4,4,,2482_3076_3118_
2483,2,有失身份,Vi,0,1,1,,
2483,2,住非星級,N,0,1,1,,
2483,2,滿以為,Vt,0,1,1,,
2483,2,巷子,N,0,3,3,,2889_2890_
2483,2,先轉,N,0,1,1,,
2483,2,轉去,Vt,0,3,3,,2731_2964_
2483,2,行禮,Vi,0,2,2,,2756_
2483,2,佳苑,N,0,2,2,,3347_
2483,2,兩可,Vi,0,1,1,,
2483,2,模凌,N,0,1,1,,
2483,2,歇歇,Vi,0,1,1,,
2483,2,無床,N,0,1,1,,
2483,2,三人間,N,0,8,8,,2483_2483_2483_3308_3308_3308_3308_
2483,2,大人,N,0,3,3,,2742_2869_
2483,2,修完,Vt,0,1,1,,
2484,2,王府井大街,N,0,1,1,,
2484,2,看錯,Vi,0,2,2,,3409_
2484,2,和平,Vi,0,1,1,,
2485,2,極點,N,0,3,3,,3115_3184_
2486,2,惡言,ADV,0,1,1,,
2486,2,石金林,N,0,1,1,,
2489,2,對講機,N,0,1,1,,
2489,2,不涼,Vi,0,1,1,,
2490,2,金山,N,0,6,6,,2679_2730_3223_3391_3393_
2490,2,定住,Vt,0,1,1,,
2490,2,水漫,N,0,4,4,,2679_3391_3393_
2490,2,接電,N,0,1,1,,
2490,2,涼水,N,0,2,2,,2509_
2490,2,退定,Vt,0,1,1,,
2491,2,標有,Vt,0,3,3,,2893_3274_
2491,2,普,Vi,0,1,1,,
2492,2,茶葉,N,0,4,4,,2695_2847_3386_
2492,2,兄弟,N,0,7,7,,2608_2608_2717_2720_3076_3103_
2492,2,體重,N,0,1,1,,
2492,2,陽劑,N,0,1,1,,
2492,2,統統,ADV,0,2,2,,3458_
2492,2,林林總總,Vi,0,1,1,,
2492,2,用品店,N,0,1,1,,
2492,2,內褲,N,0,2,2,,3071_
2492,2,售品,N,0,1,1,,
2492,2,姐妹,N,0,3,3,,2608_2608_
2492,2,身高,N,0,1,1,,
2492,2,壯,Vi,0,1,1,,
2492,2,撲克牌,N,0,1,1,,
2492,2,快樂,Vi,0,1,1,,
2492,2,幅度,N,0,1,1,,
2492,2,女用,A,0,1,1,,
2492,2,入耳,Vi,0,2,2,,2908_
2492,2,分享到,Vt,0,1,1,,
2493,2,自主餐,N,0,1,1,,
2494,2,廢話,N,0,2,2,,2495_
2497,2,美發,Vi,0,2,2,,3071_
2497,2,色情,N,0,1,1,,
2497,2,賣部,N,0,1,1,,
2497,2,深夜,N,0,5,5,,2671_3001_3001_3058_
2497,2,白水,N,0,1,1,,
2498,2,接送費,N,0,1,1,,
2498,2,客室,N,0,1,1,,
2498,2,借用,Vt,0,1,1,,
2498,2,空港,N,0,2,2,,2498_
2498,2,正理,N,0,1,1,,
2498,2,首都,N,0,3,3,,2972_3236_
2500,2,古詩,N,0,2,2,,2501_
2500,2,詞意,N,0,2,2,,2501_
2500,2,古,Vi,0,2,2,,2501_
2500,2,運河,N,0,2,2,,2501_
2500,2,望出去,Vi,0,2,2,,2501_
2500,2,臉蛋,N,0,2,2,,2501_
2500,2,韻,N,0,2,2,,2501_
2500,2,用起來,ADV,0,3,3,,2501_2919_
2500,2,胖胖,Vi,0,2,2,,2501_
2500,2,過糨糊,N,0,2,2,,2501_
2502,2,訛詐,Vt,0,3,3,,2680_3462_
2502,2,特級房,N,0,1,1,,
2502,2,虛假,Vi,0,3,3,,3187_3189_
2503,2,萬里路,N,0,1,1,,
2503,2,兌現,Vt,0,3,3,,2725_2945_
2503,2,青年,N,0,4,4,,2514_3011_3013_
2504,2,領教,Vt,0,2,2,,3132_
2504,2,去掉,Vt,0,1,1,,
2509,2,秦堰樓,N,0,1,1,,
2509,2,米飯,N,0,1,1,,
2509,2,溫溫水,N,0,1,1,,
2509,2,鍋爐房,N,0,5,5,,3448_3448_3453_3453_
2509,2,開開,Vt,0,1,1,,
2509,2,碟,N,0,3,3,,2893_3253_
2510,2,照舊,Vi,0,2,2,,2511_
2510,2,不一會兒,ADV,0,2,2,,2511_
2510,2,底下,N,0,3,3,,2511_2988_
2510,2,衝過去,Vi,0,2,2,,2511_
2510,2,嬉笑聲,N,0,2,2,,2511_
2510,2,男男女女,N,0,2,2,,2511_
2510,2,迪廳,N,0,2,2,,2511_
2510,2,難眠,Vi,0,2,2,,2511_
2510,2,收斂,Vi,0,2,2,,2511_
2510,2,臥仙樓,N,0,2,2,,2511_
2510,2,不三不四,Vi,0,2,2,,2511_
2510,2,狀態,N,0,4,4,,2511_2671_2690_
2510,2,縫隙,N,0,2,2,,2511_
2512,2,自備,Vt,0,2,2,,2746_
2513,2,噩夢,N,0,4,4,,2516_2518_2946_
2516,2,返還,Vt,0,2,2,,2518_
2516,2,特定,A,0,2,2,,2518_
2516,2,玩牌,Vi,0,2,2,,2518_
2516,2,手段,N,0,6,6,,2518_2846_3226_3324_3397_
2516,2,也就是說,ADV,0,6,6,,2518_2698_3246_3431_3432_
2516,2,欺騙,Vt,0,18,18,,2516_2518_2518_2675_2677_2698_2698_2871_3043_3076_3226_3317_3345_3363_3433_3435_3470_
2516,2,防止,Vt,0,3,3,,2518_2861_
2516,2,低劣,Vi,0,4,4,,2518_3069_3070_
2516,2,平均,Vi,0,2,2,,2518_
2516,2,所有人,N,0,3,3,,2518_3421_
2516,2,留放,Vt,0,2,2,,2518_
2516,2,到齊,Vi,0,2,2,,2518_
2516,2,吩咐,Vt,0,2,2,,2518_
2516,2,扯皮,N,0,2,2,,2518_
2517,2,洗衣房,N,0,2,2,,2519_
2517,2,大和,N,0,2,2,,2519_
2517,2,解決不了,Vt,0,2,2,,2519_
2517,2,過濾,Vt,0,2,2,,2519_
2517,2,冷熱風,N,0,2,2,,2519_
2517,2,混雜,Vt,0,3,3,,2519_3344_
2517,2,混,Vi,0,4,4,,2519_2578_3205_
2517,2,清除,Vt,0,4,4,,2519_2949_3150_
2517,2,選中,Vt,0,2,2,,2519_
2517,2,池子,N,0,3,3,,2519_3159_
2517,2,酒店式,N,0,4,4,,2519_2872_3345_
2517,2,睡不著覺,Vi,0,3,3,,2519_3472_
2520,2,分有,Vt,0,3,3,,3044_3048_
2521,2,裂,Vi,0,1,1,,
2521,2,水杯,N,0,2,2,,2521_
2521,2,骯髒,Vi,0,7,7,,2683_2683_2686_2686_3022_3023_
2521,2,反鎖,Vt,0,6,6,,2521_3448_3448_3453_3453_
2521,2,壺水,N,0,1,1,,
2521,2,托,Vt,0,2,2,,2776_
2521,2,倒入,Vt,0,1,1,,
2521,2,蒙蔽,Vt,0,1,1,,
2522,2,豬,N,0,2,2,,2563_
2522,2,狂叫,Vt,0,1,1,,
2522,2,上去,Vi,0,3,3,,2534_3475_
2522,2,鬧鐘,N,0,1,1,,
2522,2,日益,ADV,0,1,1,,
2522,2,拔下,Vt,0,1,1,,
2522,2,了事,Vi,0,2,2,,3132_
2522,2,殺,Vt,0,2,2,,2563_
2522,2,泡腳,N,0,1,1,,
2522,2,玩藝,N,0,1,1,,
2522,2,小病,N,0,1,1,,
2522,2,細,Vi,0,2,2,,2529_
2522,2,迷迷糊糊,Vi,0,1,1,,
2522,2,小毛,N,0,1,1,,
2523,2,老款,N,0,1,1,,
2523,2,征性,N,0,1,1,,
2523,2,幾下門,N,0,1,1,,
2525,2,閣樓,N,0,1,1,,
2525,2,比富藍特,N,0,1,1,,
2525,2,木,N,0,2,2,,2928_
2525,2,富藍特,N,0,1,1,,
2525,2,會水,N,0,1,1,,
2525,2,終點站,N,0,1,1,,
2526,2,傻子,N,0,1,1,,
2526,2,電轉,N,0,1,1,,
2527,2,蹭,Vt,0,1,1,,
2527,2,人名,N,0,1,1,,
2527,2,磨蹭,Vi,0,1,1,,
2527,2,火大,Vi,0,3,3,,3433_3435_
2527,2,碗,N,0,6,6,,3014_3289_3290_3331_3360_
2528,2,角,N,0,8,8,,2528_2528_3052_3053_3119_3124_3371_
2528,2,走回來,Vi,0,1,1,,
2528,2,逃離,Vt,0,1,1,,
2528,2,這一晚,N,0,1,1,,
2528,2,挨到,Vt,0,1,1,,
2528,2,倒胃口,Vi,0,1,1,,
2528,2,走過去,Vi,0,4,4,,2534_2609_3233_
2528,2,黃跡,N,0,1,1,,
2528,2,過敏,Vi,0,2,2,,3418_
2528,2,我們倆,N,0,1,1,,
2528,2,紙巾,N,0,1,1,,
2528,2,英明,Vi,0,1,1,,
2528,2,疹子,N,0,2,2,,3418_
2528,2,光腳,Vi,0,2,2,,2781_
2528,2,修不了,Vt,0,1,1,,
2528,2,媒子,N,0,1,1,,
2530,2,平移,Vt,0,1,1,,
2530,2,竊賊,N,0,1,1,,
2530,2,威脅,N,0,2,2,,2740_
2530,2,遲遲,ADV,0,2,2,,2946_
2530,2,挎包,N,0,1,1,,
2530,2,苑大,N,0,1,1,,
2530,2,武夷山,N,0,2,2,,3308_
2530,2,小偷,N,0,1,1,,
2530,2,跳牆,Vi,0,1,1,,
2530,2,自負,Vt,0,2,2,,2861_
2530,2,人身,N,0,1,1,,
2530,2,由此可見,ADV,0,1,1,,
2530,2,手錶,N,0,1,1,,
2530,2,失竊,Vi,0,2,2,,2530_
2530,2,立案,Vi,0,1,1,,
2530,2,遭受,Vt,0,1,1,,
2530,2,石堆,N,0,1,1,,
2530,2,垃圾堆,N,0,2,2,,2750_
2530,2,登堂入室,Vi,0,1,1,,
2530,2,民風,N,0,3,3,,3385_3385_
2530,2,武夷茶,N,0,1,1,,
2531,2,單子,N,0,4,4,,2739_2846_2846_
2531,2,寫上,Vt,0,1,1,,
2531,2,改說,Vt,0,1,1,,
2531,2,照樣,ADV,0,2,2,,3115_
2531,2,電路,N,0,2,2,,2616_
2531,2,香鴨,N,0,2,2,,2531_
2531,2,玩好,Vt,0,1,1,,
2531,2,山雞,N,0,1,1,,
2531,2,言辭,N,0,1,1,,
2531,2,離景區,N,0,1,1,,
2531,2,回音,N,0,3,3,,3433_3435_
2531,2,雞湯,N,0,3,3,,2531_2975_
2532,2,被套,N,0,4,4,,2533_3184_3293_
2532,2,體,N,0,2,2,,2533_
2532,2,換洗,Vt,0,2,2,,2533_
2532,2,失職,Vi,0,2,2,,2533_
2534,2,翻找,Vt,0,1,1,,
2534,2,陰冷,Vi,0,1,1,,
2534,2,落座,Vi,0,1,1,,
2534,2,聯想到,Vt,0,1,1,,
2534,2,心不在焉,Vi,0,1,1,,
2534,2,史,N,0,1,1,,
2534,2,己,N,0,1,1,,
2534,2,自顧自,Vt,0,2,2,,3115_
2534,2,睡醒,Vi,0,2,2,,2767_
2534,2,找出來,Vi,0,1,1,,
2534,2,霉霉,N,0,1,1,,
2534,2,懂得,Vt,0,1,1,,
2534,2,嫌疑犯,N,0,1,1,,
2534,2,度人,Vi,0,1,1,,
2534,2,領到,Vt,0,1,1,,
2534,2,票據,N,0,1,1,,
2534,2,頭號,A,0,1,1,,
2534,2,腳氣,N,0,1,1,,
2534,2,年終獎,N,0,1,1,,
2535,2,臨,ADV,0,2,2,,3293_
2536,2,小心眼,Vi,0,1,1,,
2537,2,亂字,N,0,2,2,,2538_
2537,2,尾隨,Vt,0,2,2,,2538_
2537,2,了得,Vi,0,2,2,,2538_
2537,2,出頭,Vi,0,2,2,,2538_
2540,2,鬧到,Vt,0,1,1,,
2540,2,抄家,Vi,0,1,1,,
2540,2,雞犬不寧,Vi,0,1,1,,
2541,2,防滑,Vi,0,1,1,,
2541,2,瓜子殼,N,0,1,1,,
2541,2,扎,Vt,0,1,1,,
2541,2,談話,N,0,1,1,,
2541,2,莫泰,N,0,4,4,,2640_2647_2647_
2541,2,人腳,N,0,1,1,,
2541,2,外人,N,0,1,1,,
2543,2,怎麼著,Vi,0,1,1,,
2544,2,蓋子,N,0,3,3,,3353_3355_
2544,2,一塵不染,Vi,0,1,1,,
2544,2,代,N,0,2,2,,3195_
2544,2,可嘉,Vi,0,1,1,,
2544,2,想通,Vi,0,1,1,,
2544,2,原色,N,0,1,1,,
2544,2,八十年代,N,0,2,2,,3409_
2544,2,綱要,N,0,1,1,,
2544,2,洗手盆,N,0,3,3,,2987_2987_
2544,2,三點鐘,N,0,1,1,,
2544,2,光澤,N,0,1,1,,
2544,2,興建,Vt,0,1,1,,
2544,2,體毛,N,0,1,1,,
2544,2,石油人,N,0,1,1,,
2547,2,鍋爐,N,0,2,2,,2946_
2547,2,花香,N,0,1,1,,
2547,2,烏語,N,0,1,1,,
2547,2,負責任,Vi,0,4,4,,2824_2826_3163_
2547,2,經濟房,N,0,3,3,,2936_2937_
2547,2,從,Vt,0,2,2,,3414_
2547,2,四處,ADV,0,1,1,,
2547,2,盆池,N,0,1,1,,
2548,2,會議室,N,0,2,2,,3040_
2549,2,包月,N,0,2,2,,2550_
2549,2,弄破,Vt,0,2,2,,2550_
2549,2,言過其實,Vi,0,2,2,,2550_
2549,2,索賠,Vi,0,2,2,,2550_
2549,2,玩意,N,0,2,2,,2550_
2549,2,張,Vt,0,6,6,,2550_2608_2608_2812_3245_
2549,2,對質,Vi,0,2,2,,2550_
2549,2,上海話,N,0,2,2,,2550_
2549,2,跟前台,N,0,5,5,,2549_2550_2550_3288_
2549,2,散客,N,0,5,5,,2550_2822_2881_3265_
2549,2,逮住,Vt,0,2,2,,2550_
2549,2,逃出,Vt,0,3,3,,2550_2790_
2549,2,窮,Vi,0,2,2,,2550_
2551,2,習慣於,Vt,0,1,1,,
2551,2,狡辯,Vt,0,3,3,,2553_2582_
2551,2,志向,N,0,1,1,,
2551,2,拉客,Vi,0,2,2,,3013_
2551,2,淪落,Vi,0,1,1,,
2551,2,自來水,N,0,7,7,,2552_2553_2647_2883_3495_3497_
2551,2,等號,N,0,1,1,,
2551,2,上市,Vi,0,1,1,,
2551,2,評價文,N,0,1,1,,
2551,2,貓膩,N,0,1,1,,
2552,2,心寒,Vi,0,3,3,,2830_3071_
2553,2,冊子,N,0,1,1,,
2553,2,襪子,N,0,3,3,,3201_3234_
2553,2,平價,N,0,1,1,,
2553,2,南方人,N,0,1,1,,
2553,2,文字,N,0,2,2,,2738_
2554,2,無禮,Vi,0,4,4,,2555_3255_3256_
2554,2,一陣子,N,0,3,3,,2555_3294_
2554,2,找去,Vi,0,4,4,,2555_3289_3290_
2554,2,入主,Vt,0,5,5,,2555_2582_2582_2582_
2554,2,設定,Vt,0,2,2,,2555_
2554,2,豈不,ADV,0,2,2,,2555_
2557,2,九樓,N,0,2,2,,2795_
2559,2,不予,Vt,0,3,3,,2746_2806_
2559,2,累計,Vt,0,2,2,,2559_
2559,2,濃味,N,0,1,1,,
2559,2,借口,N,0,8,8,,2715_2716_2739_2816_2818_3373_3374_
2560,2,擺平,Vt,0,1,1,,
2560,2,響4,N,0,1,1,,
2560,2,男客,N,0,1,1,,
2561,2,丟人,Vi,0,3,3,,2562_3085_
2561,2,西蘭,N,0,2,2,,2562_
2561,2,半天,N,0,4,4,,2562_2784_2828_
2561,2,疲倦,Vi,0,2,2,,2562_
2561,2,再一次,ADV,0,2,2,,2562_
2561,2,前前後後,ADV,0,2,2,,2562_
2561,2,金輪,N,0,2,2,,2562_
2564,2,承德,N,0,5,5,,2740_2742_2869_2869_
2565,2,藥水,N,0,2,2,,3087_
2565,2,趕去,Vt,0,1,1,,
2565,2,怪不得,ADV,0,2,2,,2822_
2565,2,八卦,N,0,1,1,,
2565,2,坑人,Vi,0,1,1,,
2565,2,包廂,N,0,2,2,,3072_
2565,2,討論,Vt,0,1,1,,
2565,2,頭部,N,0,2,2,,2565_
2565,2,交通局,N,0,2,2,,3252_
2565,2,筵席,N,0,1,1,,
2565,2,趕出來,Vi,0,1,1,,
2566,2,護身符,N,0,1,1,,
2566,2,高香,N,0,1,1,,
2566,2,騙子,N,0,2,2,,2925_
2566,2,燒香,Vi,0,1,1,,
2566,2,算命,Vi,0,1,1,,
2566,2,快點,ADV,0,3,3,,3451_3456_
2566,2,動輒,ADV,0,1,1,,
2566,2,開光,Vi,0,1,1,,
2567,2,果凍,N,0,1,1,,
2567,2,西瓜子,N,0,1,1,,
2567,2,吃剩,Vi,0,1,1,,
2567,2,空盒,N,0,1,1,,
2568,2,夥伴,N,0,6,6,,2827_3345_3371_3373_3374_
2569,2,釘子,N,0,1,1,,
2569,2,髒字,N,0,1,1,,
2569,2,國人,N,0,1,1,,
2571,2,倉,N,0,3,3,,2572_3426_
2571,2,領班,N,0,7,7,,2742_2742_2742_2742_3146_3245_
2571,2,飛蟲,N,0,2,2,,2946_
2571,2,鞋,N,0,3,3,,2902_2904_
2571,2,主業,N,0,1,1,,
2572,2,轉彎,Vi,0,1,1,,
2572,2,走去,Vi,0,2,2,,2917_
2573,2,冤,Vi,0,3,3,,2603_2605_
2573,2,懶,Vi,0,4,4,,2907_3040_3184_
2575,2,雙面,A,0,1,1,,
2575,2,吵鬧聲,N,0,1,1,,
2575,2,高架,N,0,4,4,,2724_3493_3493_
2576,2,打牌,Vi,0,1,1,,
2576,2,雜,Vi,0,3,3,,2624_3267_
2576,2,七八點鐘,N,0,1,1,,
2576,2,液態,N,0,1,1,,
2576,2,媽咪,N,0,1,1,,
2576,2,變得,Vt,0,1,1,,
2576,2,髮廊,N,0,1,1,,
2576,2,場所,N,0,3,3,,2831_2832_
2578,2,面盆,N,0,3,3,,3321_3322_
2578,2,沒有星,N,0,1,1,,
2579,2,開不出,Vt,0,1,1,,
2579,2,明亮度,N,0,1,1,,
2579,2,柳,N,0,1,1,,
2582,2,公安,N,0,2,2,,2924_
2582,2,限制,Vt,0,2,2,,3319_
2582,2,自由,Vi,0,2,2,,2748_
2582,2,霧都,N,0,1,1,,
2582,2,違法,Vi,0,2,2,,2864_
2582,2,可能性,N,0,1,1,,
2582,2,合法,Vi,0,1,1,,
2582,2,按時,ADV,0,1,1,,
2584,2,污水,N,0,4,4,,2987_2987_3203_
2584,2,茶葉包,N,0,1,1,,
2584,2,連電,N,0,1,1,,
2584,2,橫流,Vi,0,1,1,,
2584,2,通往,Vt,0,1,1,,
2585,2,任,Vt,0,2,2,,2840_
2585,2,滿滿,Vi,0,2,2,,2987_
2585,2,塞,Vt,0,1,1,,
2585,2,測,Vt,0,1,1,,
2585,2,自出,Vt,0,1,1,,
2585,2,自如,Vi,0,1,1,,
2585,2,半夜三更,N,0,3,3,,3141_3247_
2587,2,有始以來,ADV,0,2,2,,3146_
2587,2,忍不住,Vt,0,5,5,,2691_2731_2775_3360_
2587,2,地標,N,0,1,1,,
2587,2,窩火,N,0,2,2,,2593_
2587,2,翹,Vt,0,1,1,,
2587,2,賓部人,N,0,1,1,,
2588,2,非凡,Vi,0,1,1,,
2589,2,怕怕,Vi,0,1,1,,
2589,2,留出,Vt,0,1,1,,
2590,2,用詞,N,0,1,1,,
2590,2,地域,N,0,1,1,,
2590,2,度過,Vt,0,1,1,,
2590,2,文明,Vi,0,2,2,,3253_
2590,2,排憂,Vi,0,1,1,,
2590,2,接觸到,Vt,0,1,1,,
2590,2,第,Vi,0,1,1,,
2590,2,解難,Vi,0,1,1,,
2594,2,煙缸,N,0,1,1,,
2594,2,點完,Vt,0,2,2,,3360_
2594,2,哭笑不得,Vi,0,1,1,,
2594,2,紀實,Vi,0,1,1,,
2594,2,煙房,N,0,1,1,,
2594,2,新鄉,N,0,1,1,,
2595,2,不止,Vi,0,1,1,,
2595,2,急事,N,0,1,1,,
2596,2,相提並論,Vi,0,2,2,,2597_
2596,2,冬瓜,N,0,2,2,,2597_
2596,2,鮮搾,Vi,0,2,2,,2597_
2596,2,蘇州,N,0,3,3,,2597_3049_
2596,2,萬麗,N,0,4,4,,2596_2597_2597_
2598,2,寄到,Vt,0,1,1,,
2598,2,寄去,Vt,0,1,1,,
2598,2,漫不經心,Vi,0,1,1,,
2598,2,外地人,N,0,1,1,,
2599,2,普標,N,0,2,2,,2744_
2599,2,可圈可點,Vi,0,2,2,,2607_
2600,2,迫不得已,Vi,0,2,2,,2600_
2600,2,不用說,ADV,0,8,8,,2903_2905_2945_3038_3039_3353_3355_
2601,2,離考點近,Vt,0,1,1,,
2601,2,房非,N,0,1,1,,
2601,2,考試,N,0,2,2,,3261_
2603,2,房租,N,0,6,6,,2605_2641_2645_3232_3385_
2603,2,趕到,Vt,0,6,6,,2605_2680_2956_2957_3195_
2603,2,挨凍,Vi,0,3,3,,2605_3162_
2603,2,結分,N,0,2,2,,2605_
2603,2,透,ADV,0,9,9,,2605_2731_2909_2910_2956_2957_3392_3394_
2604,2,皇冠車,N,0,1,1,,
2604,2,助理,N,0,3,3,,2889_2890_
2604,2,花冠,N,0,1,1,,
2604,2,抬高,Vt,0,1,1,,
2604,2,車隊,N,0,3,3,,3255_3256_
2604,2,花冠車,N,0,1,1,,
2604,2,君悅,N,0,6,6,,2604_2604_2604_2941_2941_
2604,2,訂下,Vt,0,1,1,,
2604,2,凱悅,N,0,3,3,,2659_2669_
2606,2,斷然,ADV,0,1,1,,
2606,2,臭臭,Vi,0,1,1,,
2606,2,無力,ADV,0,2,2,,2946_
2607,2,包含,Vt,0,5,5,,2761_2762_2945_2945_
2608,2,鎮江,N,0,5,5,,2609_2609_2609_2609_
2608,2,紅梅,N,0,2,2,,2608_
2608,2,當事,Vi,0,2,2,,2609_
2608,2,深仇大恨,N,0,1,1,,
2609,2,冷冷,Vi,0,3,3,,3119_3124_
2609,2,趴,Vi,0,3,3,,3049_3415_
2609,2,和氣生財,Vi,0,1,1,,
2609,2,存單,N,0,2,2,,2609_
2609,2,辦公室,N,0,2,2,,3103_
2609,2,認識到,Vt,0,1,1,,
2609,2,走回去,Vi,0,1,1,,
2609,2,叫過來,Vi,0,2,2,,2838_
2609,2,人力,N,0,1,1,,
2609,2,拍到,Vt,0,1,1,,
2609,2,貴姓,Vi,0,1,1,,
2609,2,手指,N,0,2,2,,3246_
2609,2,片刻,N,0,2,2,,2828_
2609,2,用無,Vt,0,1,1,,
2609,2,冷言,N,0,1,1,,
2609,2,劃卡,N,0,1,1,,
2609,2,刷完,Vt,0,1,1,,
2609,2,扔到,Vt,0,1,1,,
2609,2,把,Vt,0,1,1,,
2609,2,當是,Vt,0,1,1,,
2609,2,生財者,N,0,1,1,,
2609,2,欲,Vt,0,1,1,,
2609,2,少少,Vi,0,1,1,,
2609,2,機能,N,0,3,3,,2609_2609_
2609,2,桌面,N,0,1,1,,
2609,2,話語,N,0,2,2,,2803_
2609,2,卡機,N,0,1,1,,
2610,2,霉變,Vi,0,1,1,,
2611,2,舞廳,N,0,1,1,,
2611,2,電風扇,N,0,3,3,,3105_3180_
2611,2,悶熱,Vi,0,4,4,,3034_3133_3180_
2613,2,脫離,Vt,0,1,1,,
2613,2,大河,N,0,1,1,,
2613,2,河南省,N,0,1,1,,
2615,2,興,Vi,0,3,3,,2637_2638_
2615,2,封死,Vt,0,1,1,,
2615,2,霸道,Vi,0,1,1,,
2616,2,下嚥,Vi,0,2,2,,2740_
2616,2,心理話,N,0,1,1,,
2616,2,下位,N,0,1,1,,
2616,2,四月,N,0,1,1,,
2616,2,冷笑,Vi,0,1,1,,
2616,2,買回,Vt,0,1,1,,
2616,2,手提,A,0,1,1,,
2616,2,影片,N,0,3,3,,3353_3355_
2616,2,切換,Vt,0,1,1,,
2616,2,突發,Vi,0,1,1,,
2616,2,酒店人,N,0,1,1,,
2616,2,點播費,N,0,1,1,,
2616,2,應急,Vi,0,1,1,,
2616,2,視頻,N,0,2,2,,2616_
2616,2,應急燈,N,0,2,2,,2616_
2616,2,點播,Vt,0,3,3,,2616_2616_
2621,2,不妨,ADV,0,1,1,,
2621,2,上旬,N,0,1,1,,
2621,2,人房,N,0,4,4,,2974_2974_2974_
2623,2,最少,ADV,0,3,3,,2671_2698_
2623,2,花上,Vt,0,1,1,,
2623,2,37樓,N,0,1,1,,
2623,2,更正,Vt,0,1,1,,
2623,2,27樓,N,0,1,1,,
2625,2,車把,N,0,1,1,,
2625,2,程還,N,0,1,1,,
2626,2,好多,Vi,0,1,1,,
2626,2,星海,N,0,1,1,,
2626,2,聖亞,N,0,1,1,,
2629,2,1號樓,N,0,3,3,,2629_2629_
2629,2,將來,N,0,1,1,,
2630,2,團餐,N,0,1,1,,
2631,2,紙屑,N,0,1,1,,
2632,2,總台拿,N,0,2,2,,2633_
2634,2,節日,N,0,3,3,,2946_3132_
2636,2,錢塘江,N,0,1,1,,
2636,2,跳蚤,N,0,3,3,,3257_3257_
2636,2,舉目,ADV,0,1,1,,
2636,2,不時,ADV,0,4,4,,3233_3433_3435_
2636,2,景標房,N,0,1,1,,
2636,2,帶好,Vt,0,1,1,,
2636,2,長褲,N,0,1,1,,
2636,2,野草,N,0,1,1,,
2636,2,開元,N,0,1,1,,
2636,2,長衣,N,0,1,1,,
2636,2,帽子,N,0,1,1,,
2636,2,瘙癢,Vi,0,1,1,,
2637,2,災樂禍,N,0,2,2,,2638_
2637,2,空房,N,0,4,4,,2638_2743_3226_
2637,2,躲避,Vt,0,2,2,,2638_
2637,2,小脾氣,N,0,2,2,,2638_
2639,2,聲響,N,0,1,1,,
2639,2,樁機,N,0,1,1,,
2639,2,見停,Vi,0,1,1,,
2639,2,停工,Vi,0,1,1,,
2639,2,7樓,N,0,2,2,,3239_
2639,2,苦苦,Vi,0,1,1,,
2640,2,打包盒,N,0,1,1,,
2640,2,包煙,N,0,1,1,,
2640,2,相反,Vi,0,3,3,,3083_3282_
2640,2,自營,Vt,0,1,1,,
2640,2,男生,N,0,1,1,,
2640,2,暫,ADV,0,1,1,,
2640,2,打包,Vi,0,1,1,,
2640,2,鮑魚,N,0,1,1,,
2640,2,須知,N,0,1,1,,
2640,2,小廚,N,0,1,1,,
2640,2,翻邊,N,0,1,1,,
2640,2,寄放,Vt,0,1,1,,
2640,2,美林,N,0,1,1,,
2641,2,虧,Vt,0,4,4,,2645_2956_2957_
2641,2,一段年,N,0,2,2,,2645_
2642,2,例子,N,0,4,4,,2646_3119_3124_
2642,2,小疵,N,0,2,2,,2646_
2647,2,連鎖型,N,0,1,1,,
2647,2,檯面,N,0,3,3,,3253_3478_
2647,2,整潔度,N,0,1,1,,
2647,2,相形見絀,Vi,0,1,1,,
2647,2,平庸,Vi,0,1,1,,
2647,2,省略號,N,0,1,1,,
2647,2,排序,N,0,1,1,,
2648,2,離天,N,0,1,1,,
2649,2,折掉,Vt,0,1,1,,
2649,2,高幫鞋,N,0,1,1,,
2649,2,穿著,Vt,0,2,2,,2656_
2649,2,黑點點,N,0,1,1,,
2651,2,按鍵,N,0,2,2,,2654_
2651,2,保衛,Vt,0,2,2,,2654_
2651,2,適處,N,0,2,2,,2654_
2651,2,雙語,N,0,2,2,,2654_
2651,2,獨出心裁,ADV,0,2,2,,2654_
2651,2,鬆動,Vi,0,2,2,,2654_
2651,2,消防法,N,0,2,2,,2654_
2651,2,鋪設,Vt,0,5,5,,2651_2654_2654_2872_
2651,2,盡職,Vi,0,2,2,,2654_
2651,2,四形,N,0,2,2,,2654_
2651,2,日子,N,0,7,7,,2654_2923_2956_2957_3392_3394_
2651,2,追求,Vt,0,3,3,,2654_3345_
2651,2,綜述,Vt,0,2,2,,2654_
2651,2,床具,N,0,2,2,,2654_
2651,2,火災,N,0,3,3,,2654_3371_
2651,2,餐檯,N,0,3,3,,2654_3388_
2657,2,取走,Vt,0,1,1,,
2659,2,南陽,N,0,3,3,,2659_2659_
2659,2,角料,N,0,1,1,,
2659,2,獨,ADV,0,1,1,,
2662,2,油條,N,0,1,1,,
2662,2,豬油,N,0,1,1,,
2662,2,截,Vt,0,1,1,,
2662,2,黃瓜,N,0,1,1,,
2662,2,機頂,N,0,1,1,,
2662,2,稱號,N,0,2,2,,2919_
2669,2,改到,Vt,0,2,2,,2846_
2669,2,恩惠,N,0,1,1,,
2669,2,查到,Vt,0,4,4,,2731_3367_3368_
2669,2,使得,Vt,0,1,1,,
2670,2,華苑,N,0,1,1,,
2670,2,園區,N,0,1,1,,
2670,2,產業,N,0,1,1,,
2671,2,蒸品,N,0,1,1,,
2671,2,指導,Vt,0,1,1,,
2671,2,國營,Vi,0,13,13,,2830_2938_3002_3069_3070_3083_3160_3163_3163_3184_3184_3316_
2671,2,．一會,N,0,1,1,,
2671,2,南昌,N,0,2,2,,2671_
2671,2,犯人,N,0,1,1,,
2671,2,連續,ADV,0,5,5,,3141_3150_3170_3172_
2671,2,綵燈,N,0,1,1,,
2671,2,鞭策,Vt,0,1,1,,
2671,2,劃掉,Vt,0,2,2,,2846_
2671,2,南昌市,N,0,1,1,,
2671,2,外牆燈,N,0,1,1,,
2671,2,忘掉,Vt,0,1,1,,
2671,2,睡眼,N,0,1,1,,
2671,2,隔間,N,0,1,1,,
2671,2,熱點,N,0,1,1,,
2671,2,熱忱,Vi,0,1,1,,
2671,2,2小時,N,0,1,1,,
2671,2,熱度,N,0,1,1,,
2671,2,燈瞎伙,N,0,1,1,,
2671,2,單薄,Vi,0,1,1,,
2671,2,審,Vt,0,1,1,,
2671,2,春,N,0,1,1,,
2671,2,專業化,Vt,0,1,1,,
2671,2,哥兒,N,0,2,2,,2671_
2671,2,營銷,Vt,0,1,1,,
2671,2,前廳,N,0,3,3,,2671_3341_
2671,2,著裝,Vi,0,1,1,,
2671,2,江西,N,0,1,1,,
2671,2,演,Vt,0,1,1,,
2671,2,電影,N,0,1,1,,
2671,2,好2,Vi,0,1,1,,
2671,2,晏艷,N,0,1,1,,
2671,2,錦昌,N,0,5,5,,2671_2671_2671_2671_
2671,2,主菜,N,0,1,1,,
2671,2,著重,Vt,0,1,1,,
2671,2,推遲,Vi,0,1,1,,
2671,2,朦朧,Vi,0,1,1,,
2671,2,安靜房,N,0,1,1,,
2671,2,全權,ADV,0,1,1,,
2671,2,提及,Vt,0,1,1,,
2671,2,改回來,Vi,0,1,1,,
2671,2,銷售部,N,0,3,3,,2671_2671_
2671,2,指望,Vt,0,2,2,,3409_
2671,2,責任制,N,0,1,1,,
2671,2,詞語,N,0,1,1,,
2671,2,上門,Vi,0,2,2,,2776_
2671,2,同類,N,0,1,1,,
2672,2,黃同金,N,0,1,1,,
2672,2,錦昌大,N,0,2,2,,2672_
2672,2,妹妹,N,0,3,3,,2933_2976_
2674,2,蒸,Vt,0,1,1,,
2674,2,字樣,N,0,2,2,,3319_
2674,2,小妹,N,0,1,1,,
2674,2,門鎖,N,0,5,5,,2747_2828_2873_3413_
2675,2,攜程地,N,0,2,2,,2677_
2675,2,有意,Vt,0,3,3,,2677_2836_
2675,2,徐,N,0,2,2,,2677_
2678,2,優勝,Vi,0,1,1,,
2679,2,檯子,N,0,2,2,,2968_
2679,2,漏巨,N,0,1,1,,
2679,2,純一,Vi,0,1,1,,
2679,2,縣級,N,0,1,1,,
2679,2,尋常,Vi,0,1,1,,
2679,2,切勿,ADV,0,1,1,,
2680,2,櫥櫃門,N,0,1,1,,
2680,2,耍,Vt,0,1,1,,
2680,2,口供,N,0,1,1,,
2680,2,體察,Vt,0,1,1,,
2680,2,邪氣,N,0,1,1,,
2680,2,帶回,Vt,0,2,2,,3274_
2680,2,膠粘回,N,0,1,1,,
2680,2,入,Vt,0,13,13,,2731_2761_2762_2970_3001_3185_3186_3188_3196_3213_3218_3329_
2680,2,歪風,N,0,1,1,,
2680,2,衣物,N,0,1,1,,
2680,2,焚燬,Vt,0,1,1,,
2680,2,窩囊,Vi,0,1,1,,
2680,2,在場,Vi,0,1,1,,
2680,2,壁,N,0,1,1,,
2680,2,肅清,Vt,0,1,1,,
2680,2,察,Vt,0,1,1,,
2680,2,票離,N,0,1,1,,
2680,2,民警,N,0,1,1,,
2680,2,洗清,Vt,0,1,1,,
2680,2,栽贓,Vt,0,3,3,,3446_3446_
2680,2,指紋,N,0,1,1,,
2680,2,部長,N,0,2,2,,3471_
2680,2,心目中,N,0,2,2,,3062_
2680,2,原狀,N,0,1,1,,
2680,2,派出所,N,0,3,3,,2869_2869_
2680,2,冤情,N,0,1,1,,
2680,2,處長,N,0,1,1,,
2680,2,意欲,Vt,0,1,1,,
2680,2,野蠻,Vi,0,1,1,,
2680,2,何必,ADV,0,2,2,,2967_
2680,2,保安部,N,0,2,2,,2746_
2680,2,駕到,Vi,0,1,1,,
2680,2,吉林省,N,0,4,4,,2680_2680_2680_
2680,2,老天,N,0,2,2,,3085_
2680,2,有史以來,ADV,0,1,1,,
2680,2,樂府,N,0,2,2,,2680_
2680,2,亞泰,N,0,4,4,,2680_2680_2680_
2681,2,分明,Vi,0,1,1,,
2682,2,攜程拍,Vt,0,2,2,,2685_
2683,2,印尼,N,0,2,2,,2686_
2683,2,污斑,N,0,2,2,,2686_
2683,2,累積,Vt,0,2,2,,2686_
2683,2,倒貼,Vt,0,2,2,,2686_
2683,2,觸目驚心,Vi,0,2,2,,2686_
2683,2,如廁,Vi,0,3,3,,2686_2899_
2683,2,郊外,N,0,3,3,,2686_2794_
2683,2,雅加達,N,0,2,2,,2686_
2683,2,長年,ADV,0,2,2,,2686_
2683,2,有生以來,ADV,0,4,4,,2686_3035_3363_
2684,2,入宿,Vi,0,2,2,,2687_
2684,2,一廂情願,Vi,0,2,2,,2687_
2684,2,邪,Vi,0,2,2,,2687_
2684,2,查閱,Vt,0,2,2,,2687_
2688,2,斷,Vt,0,3,3,,2809_2809_
2690,2,無可奈何,Vi,0,3,3,,3069_3070_
2690,2,無可厚非,Vi,0,1,1,,
2690,2,撇,Vt,0,1,1,,
2690,2,回國,Vi,0,1,1,,
2690,2,一清二楚,Vi,0,3,3,,2862_2926_
2690,2,妥當,Vi,0,1,1,,
2690,2,成交,Vi,0,2,2,,2690_
2690,2,過份,Vi,0,3,3,,2968_3350_
2690,2,聽任,Vt,0,1,1,,
2691,2,光鮮,Vi,0,1,1,,
2691,2,放到,Vt,0,1,1,,
2691,2,目中無人,Vi,0,1,1,,
2691,2,填,Vt,0,2,2,,2846_
2695,2,造,Vt,0,1,1,,
2695,2,灰塵,N,0,6,6,,2923_3207_3246_3479_3481_
2698,2,搭理,Vt,0,2,2,,3487_
2698,2,早知如此,Vi,0,1,1,,
2698,2,實事,N,0,1,1,,
2698,2,激活,Vt,0,1,1,,
2698,2,並非,ADV,0,3,3,,2746_3163_
2699,2,干鍋,N,0,1,1,,
2700,2,近來,ADV,0,2,2,,2701_
2700,2,無濟於事,Vi,0,2,2,,2701_
2700,2,1.5天,N,0,2,2,,2701_
2700,2,結算,Vt,0,7,7,,2701_2964_2996_3049_3327_3397_
2700,2,1點鐘,N,0,2,2,,2701_
2700,2,上漲,Vi,0,2,2,,2701_
2700,2,連2星,N,0,3,3,,2701_3239_
2702,2,影視劇,N,0,1,1,,
2702,2,比賽,N,0,1,1,,
2702,2,徐家匯店,N,0,1,1,,
2702,2,錯過,Vt,0,5,5,,2702_2702_3434_3436_
2702,2,階段,N,0,1,1,,
2702,2,等同,Vt,0,1,1,,
2702,2,點撥,Vt,0,1,1,,
2703,2,落荒而逃,Vi,0,1,1,,
2703,2,化,Vi,0,3,3,,2775_2946_
2703,2,芙蓉路,N,0,1,1,,
2703,2,應收,Vt,0,1,1,,
2703,2,止,Vi,0,1,1,,
2703,2,初住,Vt,0,1,1,,
2703,2,五華,N,0,2,2,,2703_
2703,2,河西,N,0,1,1,,
2704,2,主幹道,N,0,1,1,,
2705,2,前衛,Vi,0,2,2,,2706_
2705,2,咕,ADV,0,4,4,,2706_2997_3131_
2705,2,咚,ADV,0,4,4,,2706_2997_3131_
2705,2,隆,ADV,0,4,4,,2706_2997_3131_
2705,2,商務部,N,0,2,2,,2706_
2705,2,華而不實,Vi,0,2,2,,2706_
2705,2,吵雜,Vi,0,2,2,,2706_
2705,2,杭州,N,0,3,3,,2706_3223_
2705,2,凳子,N,0,3,3,,2706_2946_
2707,2,騰騰,Vi,0,2,2,,2708_
2707,2,蒸汽,N,0,2,2,,2708_
2707,2,破破爛爛,Vi,0,2,2,,2708_
2707,2,坐上去,Vi,0,4,4,,2708_3120_3125_
2707,2,騙錢,Vi,0,2,2,,2708_
2707,2,話務員,N,0,2,2,,2708_
2707,2,星級好,Vt,0,2,2,,2708_
2707,2,牙,N,0,2,2,,2708_
2707,2,濕濕,Vi,0,2,2,,2708_
2709,2,連如家,N,0,2,2,,2711_
2709,2,趕不上,Vt,0,2,2,,2711_
2710,2,有理,Vi,0,3,3,,2712_3181_
2710,2,吵死人,N,0,2,2,,2712_
2714,2,遊蕩,Vi,0,1,1,,
2714,2,加料,Vi,0,1,1,,
2714,2,舒適性,N,0,1,1,,
2714,2,荔枝,N,0,1,1,,
2714,2,車行,N,0,1,1,,
2714,2,核,N,0,1,1,,
2714,2,收款,Vi,0,3,3,,2767_2987_
2714,2,更為,ADV,0,2,2,,2759_
2715,2,風聲,N,0,2,2,,2716_
2717,2,老老實實,Vi,0,2,2,,2720_
2717,2,彈丸之地,N,0,2,2,,2720_
2717,2,直立,Vi,0,2,2,,2720_
2717,2,姊妹,N,0,2,2,,2720_
2717,2,季,N,0,3,3,,2720_3483_
2717,2,平安,Vi,0,2,2,,2720_
2717,2,浴室地,N,0,2,2,,2720_
2717,2,香港人,N,0,4,4,,2720_2731_2731_
2717,2,新春,N,0,2,2,,2720_
2717,2,同水廁,N,0,2,2,,2720_
2717,2,未曾,ADV,0,2,2,,2720_
2717,2,肥胖,Vi,0,2,2,,2720_
2717,2,大吉,Vi,0,2,2,,2720_
2718,2,放不下,Vt,0,3,3,,2721_2968_
2718,2,詞,N,0,2,2,,2721_
2718,2,辭,N,0,2,2,,2721_
2718,2,千里眼,N,0,2,2,,2721_
2718,2,壓根,ADV,0,3,3,,2721_2828_
2718,2,小於,Vt,0,2,2,,2721_
2718,2,苗條,Vi,0,2,2,,2721_
2718,2,歐洲,N,0,2,2,,2721_
2718,2,漂,Vi,0,2,2,,2721_
2718,2,極盡,Vt,0,2,2,,2721_
2718,2,連坐,Vi,0,2,2,,2721_
2718,2,帶過來,Vi,0,2,2,,2721_
2718,2,翹起來,Vi,0,2,2,,2721_
2718,2,查點,Vt,0,2,2,,2721_
2723,2,步態,N,0,1,1,,
2725,2,閃爍,Vi,0,1,1,,
2725,2,綠燈,N,0,2,2,,2747_
2728,2,復合,Vi,0,2,2,,2729_
2728,2,生存,Vi,0,5,5,,2729_2824_2826_3282_
2730,2,研究出來,Vt,0,1,1,,
2730,2,流到,Vt,0,3,3,,2730_3295_
2730,2,商務區,N,0,1,1,,
2730,2,啃雞,Vt,0,1,1,,
2730,2,北國,N,0,2,2,,2730_
2730,2,傾斜,Vi,0,1,1,,
2730,2,順流,ADV,0,1,1,,
2730,2,平面,N,0,2,2,,2730_
2730,2,漫,Vi,0,1,1,,
2730,2,燕山差,N,0,1,1,,
2730,2,老大,N,0,2,2,,3063_
2731,2,解,Vt,0,1,1,,
2731,2,游泳衣,N,0,1,1,,
2731,2,待客,Vi,0,1,1,,
2731,2,腦筋,N,0,1,1,,
2731,2,肥,Vt,0,1,1,,
2731,2,與人方便,Vi,0,1,1,,
2731,2,顧,Vt,0,1,1,,
2731,2,更衣室,N,0,2,2,,3231_
2731,2,4人房,N,0,4,4,,2731_2731_2731_
2731,2,任選,Vt,0,3,3,,3038_3039_
2731,2,歸還,Vt,0,3,3,,2806_2806_
2731,2,僅有,Vt,0,6,6,,2828_2893_3239_3488_3490_
2731,2,釋,Vt,0,1,1,,
2731,2,金牌,N,0,1,1,,
2731,2,長隆,N,0,2,2,,2731_
2731,2,扣住,Vt,0,1,1,,
2731,2,皮球,N,0,7,7,,3052_3053_3373_3373_3374_3374_
2731,2,大陸人金,N,0,1,1,,
2731,2,揚,Vt,0,2,2,,2731_
2731,2,歡樂,Vi,0,2,2,,2731_
2731,2,修改,Vt,0,1,1,,
2731,2,昨天,N,0,4,4,,2746_3337_3425_
2731,2,每,ADV,0,1,1,,
2731,2,露出,Vt,0,3,3,,3451_3456_
2731,2,玻璃門,N,0,4,4,,3056_3111_3111_
2731,2,烈日,N,0,1,1,,
2731,2,當下,N,0,1,1,,
2731,2,馬戲,N,0,1,1,,
2731,2,互相,ADV,0,4,4,,2768_3007_3334_
2731,2,送過去,Vi,0,1,1,,
2731,2,落實,Vt,0,4,4,,2857_2858_3447_
2735,2,單點,N,0,2,2,,2736_
2738,2,簽名,Vi,0,1,1,,
2739,2,掛來,Vt,0,1,1,,
2739,2,他人,N,0,2,2,,3386_
2739,2,升經,N,0,1,1,,
2740,2,返京,N,0,1,1,,
2740,2,紗窗,N,0,1,1,,
2740,2,服裝,N,0,1,1,,
2740,2,村莊,N,0,1,1,,
2740,2,圍攏,Vi,0,1,1,,
2740,2,冒,Vt,0,5,5,,3392_3394_3431_3432_
2740,2,現房,N,0,1,1,,
2740,2,櫃櫥,N,0,1,1,,
2740,2,菲薄,Vi,0,1,1,,
2740,2,包子,N,0,2,2,,3012_
2740,2,縮短,Vt,0,1,1,,
2740,2,不得,ADV,0,2,2,,3040_
2740,2,緊緊,Vi,0,1,1,,
2740,2,容,Vt,0,1,1,,
2740,2,通氣,Vi,0,1,1,,
2740,2,鞠躬,Vi,0,1,1,,
2740,2,估計為,Vt,0,1,1,,
2740,2,施工場,N,0,1,1,,
2740,2,且說,Vt,0,1,1,,
2740,2,身著,Vt,0,1,1,,
2740,2,發不出,Vt,0,1,1,,
2740,2,即為,Vt,0,1,1,,
2740,2,書桌,N,0,1,1,,
2740,2,豆包,N,0,1,1,,
2740,2,變樣,Vi,0,1,1,,
2740,2,哈腰,Vi,0,1,1,,
2740,2,分配,Vt,0,3,3,,3170_3172_
2740,2,訊問,Vt,0,2,2,,3327_
2742,2,無言,Vi,0,4,4,,2775_2824_2826_
2742,2,默念,Vt,0,1,1,,
2742,2,乖乖,Vi,0,2,2,,3470_
2742,2,糖醋,N,0,1,1,,
2742,2,一口,ADV,0,2,2,,3253_
2742,2,千呼萬喚,Vi,0,1,1,,
2742,2,苦,Vi,0,1,1,,
2742,2,斷言,Vt,0,1,1,,
2742,2,端回,Vt,0,1,1,,
2742,2,撤回,Vt,0,1,1,,
2742,2,斬釘截鐵,Vi,0,1,1,,
2742,2,木門,N,0,1,1,,
2742,2,廚,N,0,1,1,,
2742,2,著生,Vt,0,1,1,,
2742,2,掉漆,Vi,0,1,1,,
2742,2,糖擱,Vt,0,1,1,,
2742,2,素齋,N,0,4,4,,2742_2742_2742_
2742,2,裡脊,N,0,1,1,,
2742,2,葷菜,N,0,3,3,,3286_3286_
2742,2,雜七雜八,Vi,0,1,1,,
2742,2,產,Vt,0,2,2,,3136_
2742,2,變形,Vi,0,1,1,,
2742,2,沒轍,Vi,0,2,2,,2919_
2742,2,擾民,Vi,0,1,1,,
2742,2,媳婦,N,0,2,2,,2742_
2742,2,使勁兒,Vi,0,1,1,,
2742,2,味兒,N,0,1,1,,
2742,2,重複,Vt,0,4,4,,2882_2964_3253_
2742,2,原樣,N,0,1,1,,
2744,2,如今,N,0,2,2,,2976_
2744,2,燈瞎火,N,0,1,1,,
2744,2,致,Vt,0,1,1,,
2744,2,補丁,N,0,1,1,,
2744,2,股子,N,0,1,1,,
2744,2,拉錯,Vt,0,1,1,,
2744,2,標雙,N,0,1,1,,
2744,2,爛尾樓,N,0,1,1,,
2744,2,前門,N,0,2,2,,3112_
2745,2,撲克臉,N,0,1,1,,
2745,2,培訓課,N,0,1,1,,
2745,2,思,Vt,0,1,1,,
2745,2,新協通,N,0,1,1,,
2745,2,上進,Vi,0,1,1,,
2745,2,有用,Vi,0,1,1,,
2746,2,透露,Vt,0,1,1,,
2746,2,規程,N,0,1,1,,
2746,2,姓陸,N,0,1,1,,
2746,2,監視,Vt,0,1,1,,
2746,2,有事,Vi,0,4,4,,2747_3032_3033_
2746,2,眼線,N,0,1,1,,
2746,2,瓜葛,N,0,1,1,,
2746,2,外灘,N,0,4,4,,2746_3108_3109_
2746,2,承包給,Vt,0,2,2,,2746_
2746,2,掙,Vt,0,1,1,,
2746,2,爭論,N,0,2,2,,3279_
2746,2,男友,N,0,12,12,,2746_2746_2746_2746_2746_2746_2746_2746_2746_2746_3204_
2746,2,女朋友,N,0,4,4,,2746_2746_2775_
2746,2,瘦瘦,Vi,0,1,1,,
2746,2,隱私,N,0,1,1,,
2747,2,何時,N,0,2,2,,2828_
2747,2,插進,Vt,0,1,1,,
2747,2,插入,Vt,0,1,1,,
2748,2,扔進,Vt,0,1,1,,
2748,2,地下室,N,0,3,3,,2750_3267_
2749,2,懶散,Vi,0,1,1,,
2750,2,公開,Vt,0,1,1,,
2750,2,家住,Vt,0,1,1,,
2750,2,出遊,Vi,0,2,2,,2918_
2750,2,談判,Vt,0,2,2,,2750_
2750,2,敗筆,N,0,1,1,,
2750,2,家局,N,0,1,1,,
2750,2,州,N,0,1,1,,
2750,2,複式,A,0,1,1,,
2750,2,灰綠色,N,0,1,1,,
2750,2,依稀,ADV,0,1,1,,
2750,2,檢出,Vt,0,1,1,,
2750,2,門市,N,0,1,1,,
2750,2,拍死,Vt,0,1,1,,
2750,2,門市價,N,0,2,2,,2750_
2751,2,大跌,Vi,0,4,4,,2917_3000_3062_
2752,2,變為,Vt,0,1,1,,
2753,2,水槽,N,0,1,1,,
2753,2,踩,Vt,0,3,3,,2781_3204_
2753,2,輪到,Vt,0,1,1,,
2753,2,洗潔精,N,0,1,1,,
2753,2,難以置信,Vi,0,1,1,,
2753,2,摔跤,Vi,0,1,1,,
2753,2,標記,N,0,1,1,,
2753,2,清潔員,N,0,1,1,,
2753,2,鋪滿,Vt,0,1,1,,
2753,2,清洗,Vt,0,3,3,,3095_3223_
2754,2,地步,N,0,2,2,,3237_
2754,2,定額,N,0,1,1,,
2754,2,遞給,Vt,0,1,1,,
2754,2,一連串,A,0,2,2,,3397_
2754,2,耗時,Vi,0,1,1,,
2754,2,珠海,N,0,5,5,,2761_2762_2775_3185_
2754,2,小錢,N,0,1,1,,
2754,2,金環,N,0,1,1,,
2754,2,行政級,N,0,1,1,,
2754,2,徵求,Vt,0,1,1,,
2754,2,低級,Vi,0,3,3,,2775_2803_
2754,2,墮落,Vi,0,2,2,,2754_
2754,2,囑咐,Vt,0,1,1,,
2754,2,撕票,Vi,0,1,1,,
2756,2,聯動,Vi,0,1,1,,
2756,2,金屬,N,0,1,1,,
2756,2,裝好,Vt,0,1,1,,
2756,2,目送,Vt,0,1,1,,
2756,2,入店,Vi,0,1,1,,
2756,2,上桌,Vi,0,2,2,,2976_
2756,2,風口,N,0,2,2,,2926_
2756,2,開浴霸,N,0,1,1,,
2756,2,分散,Vt,0,1,1,,
2756,2,捆,Vt,0,1,1,,
2756,2,碰撞,Vi,0,1,1,,
2756,2,肥腸,N,0,1,1,,
2756,2,繩,N,0,1,1,,
2756,2,亮堂點,N,0,1,1,,
2757,2,拼寫,Vt,0,2,2,,2758_
2757,2,好壞,N,0,2,2,,2758_
2757,2,眼白,N,0,2,2,,2758_
2757,2,潮州,N,0,3,3,,2758_2926_
2757,2,過房,Vt,0,2,2,,2758_
2757,2,翻譯,N,0,2,2,,2758_
2759,2,夏季,N,0,1,1,,
2759,2,響應,Vt,0,3,3,,3181_3293_
2759,2,舉措,N,0,1,1,,
2759,2,矛盾,Vi,0,1,1,,
2759,2,會把,N,0,1,1,,
2759,2,節能,Vi,0,3,3,,2759_2759_
2759,2,中將,N,0,1,1,,
2759,2,銀葉級,N,0,1,1,,
2759,2,倡導卡,N,0,1,1,,
2759,2,倡導,Vt,0,1,1,,
2759,2,視為,Vt,0,2,2,,3139_
2759,2,房內,N,0,1,1,,
2759,2,高於,Vt,0,2,2,,3147_
2759,2,東山,N,0,1,1,,
2759,2,行動,N,0,4,4,,2908_2918_2924_
2759,2,社會,N,0,3,3,,2852_3253_
2759,2,評選為,Vt,0,1,1,,
2759,2,開展,Vt,0,1,1,,
2759,2,個體,N,0,1,1,,
2760,2,瓷磚,N,0,3,3,,3403_3408_
2761,2,重點,N,0,3,3,,2762_3347_
2761,2,高爾夫券,N,0,2,2,,2762_
2761,2,女友,N,0,3,3,,2762_3413_
2761,2,保齡球票,N,0,2,2,,2762_
2761,2,補辦,Vt,0,2,2,,2762_
2761,2,贈券,N,0,8,8,,2761_2761_2761_2762_2762_2762_2762_
2761,2,日用,A,0,2,2,,2762_
2761,2,公寓式,A,0,5,5,,2762_3055_3187_3189_
2761,2,案例,N,0,2,2,,2762_
2761,2,星期五,N,0,3,3,,2762_3115_
2761,2,套票,N,0,4,4,,2761_2762_2762_
2761,2,保齡球館,N,0,2,2,,2762_
2761,2,保齡球券,N,0,2,2,,2762_
2761,2,南油,N,0,4,4,,2761_2762_2762_
2761,2,跑去,Vt,0,3,3,,2762_2933_
2761,2,保齡,N,0,2,2,,2762_
2761,2,白白,ADV,0,3,3,,2762_3253_
2761,2,平日,N,0,4,4,,2761_2762_2762_
2764,2,養眼,Vi,0,1,1,,
2765,2,成堆,Vi,0,1,1,,
2766,2,涮肉,N,0,1,1,,
2766,2,現實,N,0,2,2,,3463_
2766,2,選址,Vi,0,1,1,,
2766,2,搬走,Vt,0,2,2,,2809_
2767,2,改動,Vt,0,3,3,,2769_2770_
2767,2,私自,ADV,0,1,1,,
2767,2,追問,Vt,0,1,1,,
2767,2,睡夢,N,0,1,1,,
2768,2,大眾,N,0,1,1,,
2768,2,怎能,ADV,0,1,1,,
2769,2,弄清,Vt,0,2,2,,2770_
2769,2,聚,Vi,0,3,3,,2770_3308_
2769,2,站起來,Vi,0,2,2,,2770_
2769,2,逃,Vi,0,2,2,,2770_
2769,2,巴台,N,0,2,2,,2770_
2769,2,弄濕,Vt,0,3,3,,2770_3111_
2769,2,足療,N,0,6,6,,2769_2770_2770_3391_3393_
2769,2,南苑,N,0,2,2,,2770_
2769,2,療,Vt,0,2,2,,2770_
2769,2,弄清楚,Vt,0,2,2,,2770_
2769,2,跑開,Vi,0,2,2,,2770_
2771,2,補償,Vt,0,4,4,,3049_3163_3296_
2771,2,偶然,Vi,0,1,1,,
2771,2,電弧,N,0,1,1,,
2771,2,偏要,ADV,0,1,1,,
2771,2,開店,Vi,0,1,1,,
2772,2,講話聲,N,0,1,1,,
2772,2,外環線,N,0,1,1,,
2773,2,看出來,Vt,0,1,1,,
2773,2,洗出,Vt,0,1,1,,
2773,2,燙板,N,0,1,1,,
2773,2,熨斗,N,0,1,1,,
2773,2,溫,Vt,0,3,3,,3448_3453_
2775,2,打消,Vt,0,1,1,,
2775,2,鳳凰城,N,0,2,2,,2775_
2775,2,頓,ADV,0,1,1,,
2775,2,帶到,Vt,0,1,1,,
2775,2,安,N,0,1,1,,
2775,2,鄉下,N,0,1,1,,
2775,2,興致,N,0,1,1,,
2775,2,昆山,N,0,3,3,,2839_3104_
2775,2,打通,Vt,0,2,2,,3333_
2775,2,霎時間,ADV,0,1,1,,
2775,2,增城,N,0,1,1,,
2775,2,漫長,Vi,0,4,4,,3360_3433_3435_
2775,2,原有,Vt,0,1,1,,
2775,2,降級,Vi,0,2,2,,2775_
2776,2,奔去,Vi,0,1,1,,
2776,2,奔來,Vi,0,1,1,,
2776,2,行李箱,N,0,1,1,,
2776,2,邊遠,A,0,1,1,,
2776,2,討飯,Vi,0,1,1,,
2776,2,豪客,N,0,1,1,,
2776,2,傷腳,N,0,1,1,,
2777,2,副,A,0,1,1,,
2777,2,樓連,N,0,1,1,,
2779,2,肉包,N,0,2,2,,3253_
2779,2,信價,N,0,1,1,,
2780,2,聯合,ADV,0,1,1,,
2780,2,沖浴,N,0,1,1,,
2780,2,失,Vt,0,1,1,,
2780,2,遭到,Vt,0,1,1,,
2780,2,攻擊,Vt,0,1,1,,
2781,2,油黑,Vi,0,2,2,,2781_
2782,2,仇,N,0,1,1,,
2782,2,點中,Vt,0,1,1,,
2784,2,炒河粉,N,0,1,1,,
2784,2,風吹,N,0,1,1,,
2784,2,座墊,N,0,1,1,,
2784,2,偏貴,N,0,1,1,,
2784,2,火柴,N,0,1,1,,
2784,2,火機,N,0,1,1,,
2785,2,穿堂,N,0,1,1,,
2785,2,續房,N,0,1,1,,
2786,2,搖動,Vt,0,2,2,,2788_
2787,2,豪華單,N,0,2,2,,2789_
2790,2,時空,N,0,1,1,,
2790,2,燈泡,N,0,1,1,,
2790,2,平衡,Vt,0,2,2,,3443_
2790,2,中大感,N,0,1,1,,
2790,2,食廳,N,0,1,1,,
2790,2,日貨,N,0,1,1,,
2790,2,康年,N,0,2,2,,3364_
2791,2,君逸康年,N,0,3,3,,2791_2791_
2791,2,掉出,Vt,0,1,1,,
2791,2,長沙,N,0,3,3,,2924_2925_
2791,2,漱口,Vi,0,2,2,,3246_
2791,2,找不出,Vt,0,2,2,,2893_
2791,2,掉毛,N,0,1,1,,
2791,2,璽,N,0,1,1,,
2791,2,舌頭,N,0,1,1,,
2791,2,訂上,Vt,0,1,1,,
2791,2,粘,Vt,0,4,4,,3321_3322_3446_
2792,2,糊塗,Vi,0,1,1,,
2792,2,蕭條,Vi,0,2,2,,2976_
2793,2,引領,Vt,0,1,1,,
2793,2,一問三不知,Vi,0,4,4,,2947_3245_3246_
2793,2,土,N,0,4,4,,2883_2953_2975_
2793,2,拿起,Vt,0,1,1,,
2793,2,塵,N,0,1,1,,
2793,2,遙控,Vt,0,1,1,,
2793,2,菜館,N,0,1,1,,
2793,2,烹飪,Vt,0,1,1,,
2794,2,願望,N,0,1,1,,
2794,2,冷冷清清,Vi,0,1,1,,
2794,2,跑掉,Vi,0,1,1,,
2795,2,星半,N,0,1,1,,
2795,2,級數,N,0,1,1,,
2795,2,僅僅,ADV,0,2,2,,2968_
2795,2,小食攤,N,0,1,1,,
2796,2,外境,N,0,1,1,,
2796,2,說起來,ADV,0,1,1,,
2797,2,或,ADV,0,1,1,,
2797,2,得不到,Vt,0,3,3,,3083_3243_
2797,2,春圓,N,0,1,1,,
2797,2,亞龍灣,N,0,3,3,,2797_3273_
2797,2,四星1,N,0,1,1,,
2798,2,入境,Vi,0,2,2,,2800_
2798,2,水土不服,Vi,0,2,2,,2800_
2798,2,腸胃,N,0,2,2,,2800_
2798,2,曼谷,N,0,4,4,,2798_2800_2800_
2798,2,飛到,Vt,0,2,2,,2800_
2798,2,涉外,Vi,0,2,2,,2800_
2798,2,內疚,Vi,0,2,2,,2800_
2798,2,休息室,N,0,2,2,,2800_
2798,2,注,Vt,0,4,4,,2800_2983_2984_
2798,2,加工,Vi,0,2,2,,2800_
2798,2,早日,ADV,0,4,4,,2800_2816_2818_
2798,2,舉目無親,Vi,0,2,2,,2800_
2798,2,不適,Vi,0,5,5,,2798_2800_2800_2928_
2798,2,瀉,Vi,0,2,2,,2800_
2798,2,原料,N,0,3,3,,2800_2864_
2798,2,吃壞,Vt,0,2,2,,2800_
2798,2,康復,Vi,0,2,2,,2800_
2798,2,偏偏,ADV,0,2,2,,2800_
2802,2,營業期,N,0,1,1,,
2802,2,報修,N,0,2,2,,2986_
2802,2,科技,N,0,2,2,,3308_
2802,2,友誼路,N,0,1,1,,
2802,2,承包,Vt,0,3,3,,2824_2826_
2802,2,金融街,N,0,1,1,,
2802,2,搪塞,Vt,0,1,1,,
2803,2,出租給,Vt,0,1,1,,
2803,2,辦公,Vi,0,2,2,,3078_
2803,2,說不過,Vt,0,1,1,,
2803,2,可靠,Vi,0,1,1,,
2806,2,賣掉,Vt,0,1,1,,
2807,2,臨睡,ADV,0,1,1,,
2807,2,肯德基,N,0,1,1,,
2809,2,林,N,0,1,1,,
2809,2,鼓搗,Vt,0,2,2,,2809_
2809,2,秋,N,0,1,1,,
2812,2,零錢,N,0,1,1,,
2812,2,找回,Vt,0,1,1,,
2812,2,囂張,Vi,0,2,2,,3226_
2812,2,電話線,N,0,2,2,,3245_
2813,2,艱難,Vi,0,1,1,,
2813,2,雨天,N,0,1,1,,
2813,2,無車,N,0,1,1,,
2814,2,皇嘉,N,0,2,2,,2814_
2814,2,淋浴區,N,0,1,1,,
2815,2,水暖,Vi,0,1,1,,
2815,2,大坡,N,0,2,2,,2815_
2815,2,花灑管,N,0,1,1,,
2815,2,采光不,N,0,1,1,,
2815,2,跑下,Vt,0,1,1,,
2815,2,說好,Vt,0,2,2,,2846_
2815,2,製造,Vt,0,1,1,,
2815,2,手巧,N,0,1,1,,
2815,2,鄙人,N,0,1,1,,
2815,2,四川話,N,0,1,1,,
2815,2,攝氏度,N,0,1,1,,
2815,2,花灑,Vt,0,2,2,,3111_
2815,2,開眼界,Vi,0,1,1,,
2815,2,剪掉,Vt,0,1,1,,
2815,2,軟管,N,0,1,1,,
2815,2,三級片,N,0,1,1,,
2816,2,大大小小,Vi,0,2,2,,2818_
2816,2,官宦,N,0,2,2,,2818_
2816,2,在建,Vi,0,2,2,,2818_
2816,2,濃厚,Vi,0,2,2,,2818_
2816,2,發冷,Vi,0,2,2,,2818_
2816,2,黃蓮,N,0,2,2,,2818_
2816,2,藥品,N,0,6,6,,2816_2816_2818_2818_2818_
2816,2,中毒,Vi,0,3,3,,2818_2828_
2816,2,開藥,Vi,0,2,2,,2818_
2816,2,拉肚子,Vi,0,4,4,,2816_2818_2818_
2816,2,伴有,Vt,0,2,2,,2818_
2816,2,大副,N,0,2,2,,2818_
2816,2,嘔吐,Vi,0,2,2,,2818_
2816,2,開張,Vi,0,4,4,,2818_3391_3393_
2816,2,素片,N,0,2,2,,2818_
2816,2,吃驚,Vi,0,3,3,,2818_2954_
2817,2,東大,N,0,2,2,,2819_
2817,2,普通單,N,0,4,4,,2817_2819_2819_
2817,2,匯,Vt,0,2,2,,2819_
2822,2,光顧,Vt,0,1,1,,
2822,2,國大,N,0,1,1,,
2822,2,富春,N,0,2,2,,3132_
2823,2,請求,Vt,0,2,2,,2825_
2823,2,憋,Vt,0,3,3,,2825_3184_
2823,2,修理好,Vt,0,2,2,,2825_
2824,2,默默,ADV,0,2,2,,2826_
2824,2,複查,Vt,0,2,2,,2826_
2824,2,粉末,N,0,2,2,,2826_
2824,2,婺源住,Vt,0,2,2,,2826_
2824,2,項目,N,0,9,9,,2826_2956_2957_3246_3246_3254_3391_3393_
2824,2,漸漸,ADV,0,2,2,,2826_
2824,2,不經意,ADV,0,2,2,,2826_
2824,2,性質,N,0,3,3,,2826_2872_
2824,2,牆紙,N,0,3,3,,2826_3114_
2824,2,不僅僅,ADV,0,5,5,,2824_2826_2826_3029_
2824,2,門子,N,0,2,2,,2826_
2824,2,景德鎮,N,0,4,4,,2826_3289_3290_
2824,2,致命傷,N,0,2,2,,2826_
2824,2,激烈,Vi,0,2,2,,2826_
2827,2,億龍網定,N,0,1,1,,
2828,2,良心,N,0,1,1,,
2828,2,櫃檯面,N,0,1,1,,
2828,2,趕路,Vi,0,1,1,,
2828,2,丟下,Vt,0,1,1,,
2828,2,叩,Vt,0,1,1,,
2828,2,不旺,N,0,1,1,,
2828,2,鼓,Vt,0,1,1,,
2828,2,手工,N,0,2,2,,3002_
2828,2,搗,Vt,0,1,1,,
2828,2,死機,N,0,1,1,,
2828,2,流溢,Vi,0,1,1,,
2828,2,位居,Vt,0,1,1,,
2828,2,意識到,Vt,0,2,2,,2828_
2828,2,滔滔不絕,Vi,0,1,1,,
2829,2,老掉線,N,0,1,1,,
2829,2,徐家匯,N,0,3,3,,3405_3410_
2831,2,冷清,Vi,0,3,3,,2832_2835_
2834,2,明細,N,0,1,1,,
2834,2,如,N,0,1,1,,
2834,2,週期,N,0,1,1,,
2834,2,總金額,N,0,1,1,,
2834,2,分清,Vt,0,1,1,,
2834,2,劃賬,Vi,0,1,1,,
2835,2,訓示,Vt,0,1,1,,
2835,2,擠到,Vt,0,1,1,,
2835,2,忙完,Vi,0,1,1,,
2835,2,大聲,Vi,0,2,2,,3058_
2835,2,相幫,Vi,0,1,1,,
2835,2,吆喝,Vt,0,1,1,,
2836,2,同一,N,0,1,1,,
2836,2,一樓層,N,0,1,1,,
2836,2,14日網,N,0,1,1,,
2836,2,刁難,Vt,0,1,1,,
2837,2,拜拜,Vi,0,1,1,,
2838,2,台灣人,N,0,1,1,,
2839,2,臨時房,N,0,1,1,,
2840,2,設立,Vt,0,1,1,,
2840,2,規格,N,0,1,1,,
2840,2,監獄,N,0,1,1,,
2840,2,自身,N,0,2,2,,3231_
2841,2,混到,Vt,0,1,1,,
2841,2,暗無天日,Vi,0,1,1,,
2841,2,換得,Vt,0,1,1,,
2842,2,開心果,N,0,2,2,,2843_
2842,2,埋,Vt,0,2,2,,2843_
2842,2,請問,Vt,0,2,2,,2843_
2842,2,愚蠢,Vi,0,3,3,,2843_3443_
2842,2,日照,N,0,4,4,,2842_2843_2843_
2842,2,評分,Vi,0,2,2,,2843_
2842,2,清,Vt,0,7,7,,2843_2915_3333_3388_3433_3435_
2842,2,竟是,Vt,0,2,2,,2843_
2844,2,公認,Vt,0,1,1,,
2845,2,辦生續,Vt,0,1,1,,
2845,2,用光,Vt,0,1,1,,
2846,2,矢口否認,Vt,0,1,1,,
2846,2,推說,Vt,0,1,1,,
2846,2,留心,Vt,0,1,1,,
2846,2,平和,Vi,0,1,1,,
2846,2,耍賴,Vi,0,1,1,,
2846,2,高明,Vi,0,2,2,,3001_
2846,2,保存,Vt,0,1,1,,
2846,2,證據,N,0,1,1,,
2846,2,換房單,N,0,3,3,,2846_2846_
2846,2,練,Vt,0,1,1,,
2846,2,親手,ADV,0,1,1,,
2847,2,混用,A,0,1,1,,
2847,2,另行,ADV,0,1,1,,
2847,2,誤認為,Vt,0,1,1,,
2847,2,茶杯,N,0,1,1,,
2847,2,甜點,N,0,1,1,,
2847,2,袋裝茶,N,0,2,2,,2847_
2848,2,背包客,N,0,1,1,,
2850,2,心疼,Vt,0,1,1,,
2850,2,大洋,N,0,2,2,,3167_
2850,2,超爛,Vi,0,2,2,,3477_
2851,2,優先,ADV,0,5,5,,3243_3243_3243_3308_
2852,2,有錢,Vi,0,1,1,,
2852,2,不和,Vi,0,3,3,,2956_2957_
2852,2,簽定,Vt,0,1,1,,
2852,2,持有,Vt,0,1,1,,
2853,2,因故,ADV,0,1,1,,
2853,2,領餐票,N,0,1,1,,
2854,2,不安,Vi,0,1,1,,
2854,2,女子,N,0,1,1,,
2854,2,歡場,N,0,1,1,,
2855,2,高價橋,N,0,2,2,,2856_
2857,2,失去,Vt,0,3,3,,2858_3294_
2857,2,柵欄,N,0,2,2,,2858_
2857,2,下雨天,N,0,2,2,,2858_
2857,2,專場,N,0,2,2,,2858_
2857,2,確保,Vt,0,5,5,,2858_2862_3364_3371_
2857,2,共用,Vt,0,3,3,,2858_3327_
2857,2,蒞臨,Vt,0,2,2,,2858_
2857,2,發火,Vi,0,2,2,,2858_
2857,2,吹到,Vt,0,2,2,,2858_
2859,2,跟住,Vt,0,1,1,,
2861,2,大順,N,0,1,1,,
2861,2,嗖嗖,A,0,2,2,,3040_
2861,2,叫醒,Vt,0,7,7,,2862_2862_2862_3044_3048_3049_
2861,2,長途車,N,0,1,1,,
2861,2,鋼筋,N,0,1,1,,
2861,2,辣,Vi,0,1,1,,
2861,2,安置好,Vt,0,1,1,,
2861,2,傻眼,Vi,0,1,1,,
2861,2,醒來,Vi,0,2,2,,3001_
2861,2,蝦,N,0,2,2,,2861_
2861,2,陽台門,N,0,2,2,,3164_
2861,2,沒有證,N,0,1,1,,
2861,2,海螺,N,0,1,1,,
2861,2,鬆口,Vi,0,1,1,,
2861,2,清蒸,Vt,0,1,1,,
2861,2,翻牆,Vi,0,1,1,,
2861,2,搭建,Vt,0,1,1,,
2861,2,安慰,Vt,0,1,1,,
2861,2,海參,N,0,1,1,,
2861,2,細語,Vi,0,1,1,,
2861,2,光光光,N,0,1,1,,
2861,2,電視機聲,N,0,1,1,,
2861,2,吹散,Vt,0,1,1,,
2861,2,當場,ADV,0,3,3,,3433_3435_
2861,2,皮皮,N,0,1,1,,
2861,2,結婚證,N,0,4,4,,2861_2861_2861_
2861,2,單人椅,N,0,1,1,,
2861,2,念頭,N,0,2,2,,2954_
2861,2,熟人,N,0,1,1,,
2861,2,潮汐,N,0,1,1,,
2861,2,海浪,N,0,1,1,,
2861,2,弄好,Vt,0,4,4,,3260_3337_3419_
2861,2,琵琶,N,0,1,1,,
2861,2,時刻表,N,0,1,1,,
2861,2,猶,ADV,0,1,1,,
2861,2,頂住,Vt,0,2,2,,3164_
2861,2,蔥爆,Vi,0,1,1,,
2861,2,夾克,N,0,1,1,,
2861,2,夢遊,Vt,0,1,1,,
2861,2,純生,Vi,0,1,1,,
2861,2,天亮,Vi,0,3,3,,2875_3443_
2861,2,花蛤,N,0,1,1,,
2862,2,大喊,Vt,0,4,4,,2862_2862_3144_
2862,2,操操,N,0,1,1,,
2862,2,安寧,Vi,0,3,3,,3187_3189_
2862,2,怪事,N,0,1,1,,
2862,2,音,N,0,3,3,,3170_3172_
2862,2,操,Vt,0,1,1,,
2862,2,部隊,N,0,1,1,,
2862,2,擴音器,N,0,4,4,,2862_2862_2862_
2862,2,早操,N,0,1,1,,
2862,2,上線,Vi,0,1,1,,
2863,2,消失,Vi,0,2,2,,3413_
2863,2,頭疼,Vi,0,3,3,,3431_3432_
2863,2,暈車,Vi,0,1,1,,
2863,2,地溝油,N,0,1,1,,
2863,2,昏昏沉沉,Vi,0,2,2,,3476_
2863,2,呆久,N,0,1,1,,
2864,2,好事,N,0,2,2,,3418_
2864,2,質,N,0,1,1,,
2864,2,發黑,Vi,0,3,3,,2864_3415_
2864,2,番茄,N,0,1,1,,
2864,2,工作量,N,0,1,1,,
2864,2,領,Vt,0,2,2,,3253_
2864,2,回收,Vt,0,2,2,,3331_
2864,2,手捏,Vt,0,1,1,,
2864,2,桔子,N,0,1,1,,
2864,2,瓶子,N,0,2,2,,2864_
2864,2,痰,N,0,3,3,,3150_3150_
2864,2,材料,N,0,2,2,,2975_
2865,2,巨高,N,0,1,1,,
2866,2,虛,Vi,0,1,1,,
2867,2,載,Vt,0,2,2,,3163_
2867,2,正規,A,0,6,6,,2967_3288_3365_3487_3487_
2867,2,巨多,N,0,2,2,,3205_
2867,2,坑坑窪窪,Vi,0,1,1,,
2867,2,拒,Vt,0,2,2,,3364_
2867,2,印痕,N,0,1,1,,
2867,2,繞路,Vi,0,1,1,,
2869,2,適得其反,Vi,0,1,1,,
2869,2,機械,N,0,1,1,,
2869,2,列表,Vi,0,1,1,,
2869,2,爭辯,Vi,0,1,1,,
2869,2,坐下,Vi,0,1,1,,
2869,2,試問,Vt,0,2,2,,3193_
2869,2,攜成,Vt,0,4,4,,2869_2869_2967_
2869,2,小時車,N,0,1,1,,
2870,2,盛華,N,0,1,1,,
2871,2,說清楚,Vt,0,1,1,,
2871,2,擺明,Vt,0,2,2,,3347_
2871,2,掛羊頭賣狗肉,Vi,0,1,1,,
2872,2,必備,A,0,1,1,,
2872,2,等等,Vt,0,1,1,,
2872,2,破洞,N,0,3,3,,3289_3290_
2872,2,閉路電視,N,0,1,1,,
2872,2,牌價,N,0,1,1,,
2872,2,床鋪,N,0,2,2,,2941_
2872,2,環視,Vt,0,1,1,,
2872,2,手冊,N,0,1,1,,
2872,2,價目表,N,0,2,2,,3194_
2872,2,戒,Vt,0,2,2,,3296_
2872,2,控,Vt,0,2,2,,2948_
2872,2,分數,N,0,3,3,,3431_3432_
2872,2,評定,Vt,0,2,2,,3415_
2872,2,選台,N,0,1,1,,
2872,2,昏倒,Vi,0,1,1,,
2872,2,定義,N,0,2,2,,3364_
2872,2,平整,Vi,0,2,2,,2976_
2872,2,前1天,N,0,1,1,,
2873,2,冒險,Vi,0,1,1,,
2873,2,停用,Vi,0,1,1,,
2873,2,忽滅,Vi,0,1,1,,
2873,2,水箱,N,0,4,4,,2928_3433_3435_
2873,2,送上來,Vt,0,1,1,,
2873,2,新房,N,0,1,1,,
2873,2,牙刷盒,N,0,1,1,,
2873,2,自取,Vt,0,1,1,,
2873,2,想盡,Vt,0,1,1,,
2873,2,盒,N,0,1,1,,
2874,2,調去,Vt,0,1,1,,
2874,2,調來,Vt,0,1,1,,
2876,2,橫,A,0,1,1,,
2879,2,房拼,N,0,2,2,,2880_
2879,2,譴責,Vt,0,2,2,,2880_
2881,2,梁姓,N,0,1,1,,
2881,2,閘坡,N,0,6,6,,2881_2881_2881_2881_2881_
2881,2,單晚,N,0,1,1,,
2882,2,清淨,Vi,0,1,1,,
2882,2,時有,Vt,0,1,1,,
2882,2,水草,N,0,1,1,,
2882,2,帆板,N,0,2,2,,2883_
2882,2,清洗費,N,0,1,1,,
2882,2,夫人,N,0,2,2,,2976_
2883,2,水溝,N,0,2,2,,3358_
2883,2,一緯,N,0,1,1,,
2883,2,碧海,N,0,3,3,,2883_2883_
2883,2,動員,Vt,0,1,1,,
2885,2,上星級,N,0,3,3,,2887_3207_
2888,2,橫檔,N,0,1,1,,
2888,2,跡,N,0,3,3,,2938_2976_
2888,2,擦掉,Vt,0,1,1,,
2888,2,下邊,N,0,1,1,,
2889,2,接聽,Vt,0,5,5,,2890_2972_3159_3205_
2889,2,圈子,N,0,2,2,,2890_
2892,2,元大,N,0,3,3,,2897_3141_
2892,2,曲阜路,N,0,1,1,,
2892,2,國慶路,N,0,1,1,,
2892,2,晉,N,0,2,2,,2897_
2893,2,接收到,Vt,0,1,1,,
2893,2,無線路,N,0,1,1,,
2897,2,限額,N,0,1,1,,
2898,2,洗好,Vt,0,3,3,,2988_3396_
2898,2,離別,Vi,0,1,1,,
2898,2,制止,Vt,0,1,1,,
2899,2,改裝,Vt,0,3,3,,3055_3098_
2899,2,尾樓,N,0,1,1,,
2899,2,民工,N,0,1,1,,
2902,2,馮,N,0,4,4,,2904_3032_3033_
2902,2,儀器,N,0,2,2,,2904_
2902,2,配件,N,0,6,6,,2902_2902_2904_2904_2904_
2902,2,姓,Vt,0,5,5,,2904_3032_3033_3329_
2902,2,順豐,N,0,2,2,,2904_
2903,2,真空,N,0,2,2,,2905_
2906,2,無論如何,ADV,0,2,2,,3000_
2907,2,冷水檔,N,0,1,1,,
2907,2,燙壞,Vt,0,1,1,,
2907,2,馬乎乎,N,0,2,2,,3078_
2907,2,指揮,N,0,1,1,,
2908,2,內院,N,0,1,1,,
2908,2,土雞,N,0,1,1,,
2908,2,停歇,Vi,0,1,1,,
2908,2,機組,N,0,1,1,,
2908,2,看樣子,ADV,0,1,1,,
2908,2,嘔吐物,N,0,1,1,,
2908,2,關門聲,N,0,1,1,,
2908,2,蟠龍,N,0,1,1,,
2908,2,豪頂,N,0,1,1,,
2908,2,野菜,N,0,1,1,,
2908,2,交談聲,N,0,1,1,,
2908,2,出奇,Vi,0,4,4,,3031_3326_3357_
2908,2,臨安,N,0,4,4,,3152_3153_3153_
2908,2,雪碧才,N,0,1,1,,
2908,2,拖拉機,N,0,4,4,,3098_3204_3443_
2908,2,錢王街,N,0,1,1,,
2908,2,電話聲,N,0,1,1,,
2909,2,贓,N,0,2,2,,2910_
2909,2,凸出,Vi,0,2,2,,2910_
2911,2,油耗味,N,0,1,1,,
2911,2,晚娘,N,0,1,1,,
2911,2,臉孔,N,0,1,1,,
2912,2,講話,Vi,0,1,1,,
2914,2,蟊賊,N,0,1,1,,
2914,2,規矩,N,0,1,1,,
2914,2,後樓,N,0,3,3,,2914_2914_
2914,2,金條,N,0,2,2,,2914_
2914,2,退還給,Vt,0,1,1,,
2914,2,爬進,Vt,0,2,2,,2931_
2914,2,適應,Vt,0,4,4,,3037_3085_3158_
2914,2,氣呼呼,Vi,0,1,1,,
2914,2,押,Vt,0,2,2,,2914_
2914,2,腳手架,N,0,2,2,,2914_
2914,2,面前,N,0,3,3,,3231_3243_
2915,2,人像,N,0,1,1,,
2915,2,有線,A,0,4,4,,3103_3153_3409_
2915,2,暈過去,Vi,0,1,1,,
2915,2,難民營,N,0,1,1,,
2915,2,出土,Vi,0,1,1,,
2915,2,狼狽為奸,Vi,0,1,1,,
2917,2,苦等,Vt,0,4,4,,3281_3434_3436_
2919,2,分機號,N,0,1,1,,
2919,2,客棧,N,0,7,7,,3118_3118_3118_3118_3118_3118_
2919,2,肆無忌憚,Vi,0,1,1,,
2921,2,閣樓房,N,0,1,1,,
2921,2,擔負,Vt,0,1,1,,
2921,2,在線,Vi,0,1,1,,
2921,2,程網,N,0,2,2,,3107_
2922,2,海路,N,0,1,1,,
2922,2,糊弄,Vt,0,4,4,,2922_3405_3410_
2922,2,摘掉,Vt,0,1,1,,
2922,2,一弄,N,0,1,1,,
2922,2,看齊,Vi,0,1,1,,
2922,2,江陰,N,0,3,3,,3392_3394_
2922,2,連上,Vt,0,1,1,,
2923,2,亭,N,0,1,1,,
2923,2,鑰匙牌,N,0,2,2,,2923_
2923,2,掃興,Vi,0,1,1,,
2923,2,罩上,Vt,0,2,2,,2951_
2923,2,塑料紙,N,0,1,1,,
2923,2,景觀房,N,0,5,5,,2933_3088_3146_3146_
2923,2,嘔心,ADV,0,1,1,,
2923,2,湯圓,N,0,1,1,,
2923,2,聞所未聞,Vi,0,3,3,,3009_3010_
2924,2,輕易,ADV,0,1,1,,
2924,2,先後,N,0,1,1,,
2924,2,賴掉,Vt,0,1,1,,
2924,2,偵破,Vt,0,1,1,,
2924,2,法院,N,0,1,1,,
2924,2,跟蹤,Vt,0,3,3,,3182_3183_
2924,2,職守,N,0,1,1,,
2924,2,引狼入室,Vi,0,1,1,,
2924,2,警官,N,0,1,1,,
2924,2,財物,N,0,2,2,,3296_
2924,2,為證,Vi,0,1,1,,
2924,2,錄像,Vi,0,2,2,,3296_
2924,2,除害,Vi,0,1,1,,
2924,2,驚魂,N,0,1,1,,
2924,2,筆錄,N,0,2,2,,2924_
2924,2,疑點,N,0,1,1,,
2924,2,王,N,0,2,2,,3462_
2924,2,反思,Vt,0,1,1,,
2924,2,陌生人,N,0,2,2,,3076_
2924,2,監控,Vt,0,2,2,,3296_
2925,2,洩露,Vt,0,1,1,,
2925,2,合一,Vi,0,2,2,,2925_
2925,2,打進,Vt,0,1,1,,
2926,2,盡然,Vi,0,2,2,,3268_
2926,2,調出,Vt,0,1,1,,
2926,2,搗亂,Vi,0,1,1,,
2926,2,按餐牌,N,0,1,1,,
2926,2,劃價,N,0,1,1,,
2928,2,散出,Vi,0,1,1,,
2928,2,水渠,N,0,1,1,,
2928,2,出不,N,0,1,1,,
2928,2,用水,N,0,3,3,,3433_3435_
2928,2,滲透,Vi,0,1,1,,
2930,2,禿山,N,0,1,1,,
2931,2,病毒,N,0,1,1,,
2931,2,螞蟻,N,0,1,1,,
2931,2,爬出,Vt,0,1,1,,
2932,2,說話聲,N,0,4,4,,2969_3341_3428_
2932,2,共鳴,N,0,1,1,,
2932,2,三更半夜,N,0,1,1,,
2933,2,上岸,Vi,0,1,1,,
2933,2,陽朔城,N,0,1,1,,
2933,2,興坪鎮,N,0,1,1,,
2933,2,本意,N,0,1,1,,
2933,2,厚道,Vi,0,2,2,,2933_
2933,2,楊堤,N,0,4,4,,2933_2933_2933_
2933,2,隨性,Vi,0,1,1,,
2933,2,漓江,N,0,4,4,,2933_2933_2933_
2933,2,逆流,Vi,0,1,1,,
2933,2,摩,Vt,0,1,1,,
2933,2,店主,N,0,1,1,,
2933,2,山山水水,N,0,1,1,,
2933,2,收益,N,0,1,1,,
2933,2,黎阿姨,N,0,3,3,,2933_2933_
2933,2,畫,N,0,2,2,,3246_
2933,2,竹筏,N,0,2,2,,2933_
2933,2,興坪,N,0,3,3,,2933_2933_
2933,2,精華,N,0,2,2,,2933_
2933,2,淳樸,Vi,0,1,1,,
2933,2,機動,A,0,1,1,,
2933,2,重重,Vi,0,1,1,,
2934,2,刻薄,Vi,0,1,1,,
2934,2,叨嘮,Vt,0,1,1,,
2934,2,周定房,N,0,1,1,,
2934,2,廣州車,N,0,1,1,,
2934,2,調皮,Vi,0,1,1,,
2934,2,泥路,N,0,1,1,,
2934,2,繳費,Vi,0,1,1,,
2936,2,叫做,Vt,0,5,5,,2936_2937_2937_3223_
2936,2,雅士,N,0,2,2,,2937_
2936,2,白來,Vi,0,2,2,,2937_
2936,2,濟源,N,0,2,2,,2937_
2938,2,次會,N,0,1,1,,
2939,2,清淡,Vi,0,2,2,,2940_
2939,2,檯球,N,0,2,2,,2940_
2939,2,老街,N,0,2,2,,2940_
2939,2,灰濛濛,Vi,0,4,4,,2940_3479_3481_
2941,2,中招,N,0,1,1,,
2941,2,平,Vi,0,2,2,,2941_
2941,2,多得是,Vi,0,1,1,,
2942,2,申請,Vt,0,3,3,,3197_3199_
2945,2,打發,Vt,0,1,1,,
2945,2,長滿,Vi,0,1,1,,
2945,2,荒草,N,0,1,1,,
2945,2,還四星,N,0,1,1,,
2945,2,黃土,N,0,1,1,,
2945,2,發送,Vt,0,1,1,,
2945,2,帖,N,0,1,1,,
2945,2,靶紙,N,0,1,1,,
2945,2,歪歪,Vi,0,1,1,,
2945,2,檯球桌,N,0,1,1,,
2945,2,點綴,Vt,0,1,1,,
2945,2,實景,N,0,1,1,,
2945,2,乒乓球桌,N,0,1,1,,
2945,2,渾水塘,N,0,1,1,,
2945,2,挖掘機,N,0,2,2,,2945_
2945,2,作業,N,0,1,1,,
2945,2,黃沙,N,0,1,1,,
2945,2,麵條,N,0,2,2,,3379_
2945,2,金錢,N,0,1,1,,
2946,2,釣到,Vt,0,1,1,,
2946,2,迷路,Vi,0,1,1,,
2946,2,屋簷,N,0,1,1,,
2946,2,去電,Vt,0,1,1,,
2946,2,粉塵,N,0,1,1,,
2946,2,抗著童車,N,0,1,1,,
2946,2,關心,Vt,0,1,1,,
2946,2,穿越,Vt,0,1,1,,
2946,2,坡,N,0,1,1,,
2946,2,營養,N,0,2,2,,3146_
2946,2,幹,Vt,0,4,4,,3038_3039_3295_
2946,2,鑽,Vt,0,1,1,,
2946,2,承受,Vt,0,1,1,,
2946,2,工程部,N,0,3,3,,3433_3435_
2946,2,老虎窗,N,0,1,1,,
2946,2,鋪床,Vi,0,1,1,,
2946,2,熱醒,Vt,0,1,1,,
2946,2,飄散,Vi,0,1,1,,
2946,2,斜頂,N,0,1,1,,
2946,2,直射,Vi,0,1,1,,
2946,2,用去,Vt,0,1,1,,
2946,2,斜坡,N,0,1,1,,
2946,2,爆發,Vt,0,3,3,,3083_3184_
2946,2,水塘,N,0,1,1,,
2947,2,銅臭,N,0,1,1,,
2947,2,天房,N,0,2,2,,3083_
2947,2,扣除,Vt,0,5,5,,3489_3489_3491_3491_
2947,2,氧,N,0,1,1,,
2949,2,誘使,Vt,0,1,1,,
2949,2,目的,N,0,1,1,,
2951,2,血漬,N,0,1,1,,
2951,2,邯鄲,N,0,5,5,,2952_3083_3083_3083_
2951,2,油漬,N,0,1,1,,
2951,2,食慾,N,0,1,1,,
2951,2,碗粥,N,0,1,1,,
2952,2,公德心,N,0,1,1,,
2952,2,睡不,N,0,1,1,,
2952,2,毒死,Vt,0,1,1,,
2953,2,西紅柿,N,0,1,1,,
2953,2,炒蛋,Vi,0,1,1,,
2953,2,超貴,N,0,1,1,,
2953,2,刀,N,0,1,1,,
2953,2,粗心,Vi,0,1,1,,
2953,2,伸展,Vt,0,1,1,,
2954,2,會場,N,0,3,3,,3405_3410_
2954,2,鄉鎮,N,0,1,1,,
2954,2,案頭,N,0,1,1,,
2954,2,家聚,N,0,1,1,,
2954,2,文房四寶,N,0,1,1,,
2954,2,墨寶,N,0,1,1,,
2955,2,駐馬店,N,0,1,1,,
2956,2,迫降,Vi,0,2,2,,2957_
2956,2,打劫,Vt,0,2,2,,2957_
2956,2,無恥,Vi,0,4,4,,2956_2957_2957_
2956,2,這麼個,ADV,0,2,2,,2957_
2956,2,連夜,ADV,0,2,2,,2957_
2956,2,不可抗力,N,0,2,2,,2957_
2958,2,黑名單,N,0,1,1,,
2958,2,害人,N,0,1,1,,
2958,2,扔出去,Vi,0,1,1,,
2958,2,攜程拉入,Vt,0,1,1,,
2958,2,男人,N,0,2,2,,3071_
2959,2,局辦,N,0,1,1,,
2959,2,工商,N,0,2,2,,3269_
2959,2,預定價,N,0,1,1,,
2960,2,業餘,A,0,2,2,,2962_
2960,2,中斷,Vt,0,2,2,,2962_
2960,2,提倡,Vt,0,3,3,,2962_3015_
2960,2,映像,N,0,4,4,,2960_2962_2962_
2964,2,原固,N,0,1,1,,
2964,2,跟,Vt,0,1,1,,
2964,2,食飯,N,0,4,4,,2964_2964_2964_
2964,2,茶位,N,0,2,2,,2964_
2964,2,核算,Vt,0,1,1,,
2964,2,茶位費,N,0,2,2,,2964_
2964,2,茶收,N,0,1,1,,
2967,2,失手,Vi,0,1,1,,
2967,2,硬板,N,0,2,2,,3093_
2967,2,大眼袋,N,0,1,1,,
2967,2,差遠,N,0,2,2,,3020_
2967,2,佣金,N,0,2,2,,3105_
2967,2,褥子,N,0,5,5,,3022_3023_3332_3470_
2967,2,北戴河,N,0,1,1,,
2967,2,灰黑色,N,0,1,1,,
2967,2,路邊店,N,0,1,1,,
2967,2,痛,Vi,0,1,1,,
2967,2,鑽頭聲,N,0,1,1,,
2967,2,潔白,Vi,0,1,1,,
2968,2,摔破,Vt,0,1,1,,
2968,2,蛋,N,0,3,3,,2968_3257_
2968,2,8時,N,0,1,1,,
2968,2,精美,Vi,0,1,1,,
2971,2,冷忽,Vi,0,1,1,,
2971,2,有異,Vi,0,1,1,,
2972,2,本地,N,0,1,1,,
2972,2,不只,ADV,0,1,1,,
2972,2,比紙,N,0,1,1,,
2972,2,奇特,Vi,0,1,1,,
2972,2,偉大,Vi,0,1,1,,
2973,2,路燈,N,0,2,2,,3484_
2973,2,彎,Vi,0,1,1,,
2973,2,走下去,Vi,0,1,1,,
2973,2,給定,Vt,0,1,1,,
2974,2,泥水,N,0,2,2,,3204_
2974,2,樓內,N,0,1,1,,
2974,2,放出來,Vi,0,2,2,,3333_
2975,2,鮮,Vi,0,1,1,,
2975,2,麻,N,0,1,1,,
2975,2,青山,N,0,1,1,,
2975,2,太湖源,N,0,1,1,,
2975,2,目山景區,N,0,1,1,,
2975,2,烏,N,0,1,1,,
2976,2,骨頭,N,0,1,1,,
2976,2,褒,Vt,0,1,1,,
2976,2,醫學,N,0,1,1,,
2976,2,白嫩,N,0,1,1,,
2976,2,直言,Vt,0,1,1,,
2976,2,有辱,Vt,0,1,1,,
2976,2,地鋪,N,0,1,1,,
2976,2,小紅點,N,0,3,3,,2976_2976_
2976,2,取代,Vt,0,1,1,,
2976,2,房產,N,0,1,1,,
2976,2,抓撓,Vi,0,2,2,,2976_
2976,2,燒法,N,0,1,1,,
2976,2,不雅觀,Vi,0,1,1,,
2976,2,點菜員,N,0,1,1,,
2976,2,腳背,N,0,1,1,,
2976,2,毫不,ADV,0,1,1,,
2976,2,拚命,Vi,0,3,3,,2976_3459_
2976,2,頗為,ADV,0,1,1,,
2976,2,妹夫,N,0,1,1,,
2976,2,生物,N,0,1,1,,
2976,2,好朋友,N,0,1,1,,
2976,2,魚缸,N,0,1,1,,
2976,2,泥漿,N,0,1,1,,
2976,2,樓空,N,0,1,1,,
2976,2,妻子,N,0,1,1,,
2976,2,偏激,Vi,0,1,1,,
2976,2,寒心,Vi,0,1,1,,
2976,2,亂堆亂放,Vt,0,1,1,,
2976,2,場地,N,0,1,1,,
2976,2,恕,Vt,0,1,1,,
2976,2,奇癢,Vi,0,2,2,,3418_
2976,2,果斷,Vi,0,1,1,,
2976,2,長出,Vt,0,1,1,,
2976,2,破碎,Vi,0,1,1,,
2976,2,消,Vi,0,1,1,,
2976,2,飛揚,Vi,0,1,1,,
2976,2,毒,Vi,0,4,4,,3108_3109_3276_
2976,2,小害,N,0,1,1,,
2976,2,青山湖,N,0,2,2,,2976_
2976,2,緊閉,Vi,0,1,1,,
2976,2,場景,N,0,1,1,,
2976,2,手臂,N,0,1,1,,
2976,2,雜物,N,0,1,1,,
2976,2,魚類,N,0,1,1,,
2976,2,魚頭,N,0,2,2,,2976_
2976,2,買票,N,0,1,1,,
2976,2,沙鍋,N,0,1,1,,
2976,2,天乞,N,0,1,1,,
2976,2,加之,Vt,0,1,1,,
2976,2,知識,N,0,2,2,,3246_
2977,2,燙痕,N,0,1,1,,
2977,2,煙蒂,N,0,1,1,,
2977,2,鄉,N,0,1,1,,
2977,2,渡假村,N,0,1,1,,
2977,2,訛人,Vi,0,1,1,,
2977,2,就是了,Vi,0,1,1,,
2977,2,得逞,Vi,0,1,1,,
2978,2,嘶叫,Vi,0,1,1,,
2980,2,用剩,Vi,0,1,1,,
2980,2,洗髮水,N,0,3,3,,3495_3497_
2983,2,奇香,N,0,2,2,,2984_
2983,2,緊湊,Vi,0,2,2,,2984_
2983,2,飄溢,Vi,0,2,2,,2984_
2983,2,潔,Vi,0,2,2,,2984_
2983,2,華山,N,0,2,2,,2984_
2987,2,信譽,N,0,4,4,,3005_3009_3010_
2987,2,除外,Vi,0,1,1,,
2987,2,大車店,N,0,1,1,,
2987,2,愚弄,Vt,0,1,1,,
2987,2,合同,N,0,1,1,,
2988,2,擴大,Vt,0,1,1,,
2988,2,眼皮,N,0,1,1,,
2988,2,實施,Vt,0,1,1,,
2993,2,騎,Vt,0,2,2,,2994_
2993,2,綠舟,N,0,2,2,,2994_
2993,2,淘汰,Vt,0,5,5,,2994_3076_3403_3408_
2996,2,全國,N,0,1,1,,
2996,2,歌廳,N,0,2,2,,3472_
2996,2,操場,N,0,1,1,,
2996,2,算出來,Vt,0,1,1,,
2996,2,澳,N,0,1,1,,
2996,2,交房卡,N,0,1,1,,
2996,2,尼斯,N,0,2,2,,2996_
2997,2,住鹽阜,N,0,1,1,,
2997,2,好奇心,N,0,1,1,,
2997,2,鹽城,N,0,2,2,,2999_
2997,2,西瓜,N,0,1,1,,
2998,2,空空,Vi,0,1,1,,
3001,2,想定,Vt,0,1,1,,
3001,2,原封不動,Vi,0,1,1,,
3001,2,領情,Vi,0,1,1,,
3001,2,外幣,N,0,1,1,,
3001,2,雁鳴湖大,N,0,1,1,,
3001,2,打擊,N,0,1,1,,
3001,2,內賊,N,0,4,4,,3001_3001_3001_
3001,2,攝像,Vi,0,1,1,,
3001,2,相機,N,0,1,1,,
3001,2,查房卡,N,0,1,1,,
3001,2,1星,N,0,1,1,,
3001,2,羽絨服,N,0,3,3,,3162_3162_
3001,2,強力,Vi,0,2,2,,3001_
3001,2,報案,Vi,0,3,3,,3001_3296_
3001,2,可恥,Vi,0,1,1,,
3001,2,湊巧,Vi,0,1,1,,
3001,2,同情心,N,0,1,1,,
3001,2,探頭,Vi,0,1,1,,
3001,2,攝像頭,N,0,1,1,,
3007,2,職員,N,0,1,1,,
3007,2,簾子,N,0,1,1,,
3007,2,搭機,Vi,0,1,1,,
3007,2,照明,N,0,1,1,,
3007,2,切斷,Vt,0,1,1,,
3007,2,散戶,N,0,1,1,,
3009,2,廢除,Vt,0,2,2,,3010_
3009,2,受苦,Vi,0,2,2,,3010_
3009,2,白金,N,0,2,2,,3010_
3009,2,反省,Vt,0,2,2,,3010_
3009,2,難熬,Vi,0,2,2,,3010_
3011,2,旅舍,N,0,2,2,,3013_
3011,2,孔府,N,0,1,1,,
3011,2,孔廟,N,0,1,1,,
3011,2,結認,Vt,0,1,1,,
3011,2,同行人,N,0,1,1,,
3012,2,變味,Vi,0,1,1,,
3012,2,叫聲,N,0,1,1,,
3012,2,大雜燴,N,0,1,1,,
3012,2,散漫,Vi,0,1,1,,
3012,2,泡菜,N,0,1,1,,
3013,2,三輪車,N,0,3,3,,3118_3118_
3013,2,曲阜,N,0,5,5,,3013_3013_3013_3015_
3013,2,曲阜城,N,0,1,1,,
3013,2,裕隆,N,0,1,1,,
3013,2,北關,N,0,1,1,,
3013,2,濟寧,N,0,1,1,,
3013,2,黑壓壓,Vi,0,1,1,,
3013,2,售票員,N,0,1,1,,
3013,2,知不知道,Vt,0,1,1,,
3013,2,喋喋不休,Vi,0,1,1,,
3013,2,過路車,N,0,1,1,,
3014,2,著水,N,0,1,1,,
3014,2,汪,ADV,0,1,1,,
3015,2,故鄉,N,0,1,1,,
3015,2,世,N,0,1,1,,
3015,2,是老,N,0,1,1,,
3015,2,接軌,Vi,0,1,1,,
3015,2,悲哀,Vi,0,1,1,,
3015,2,孔老夫子,N,0,1,1,,
3015,2,難忘,Vt,0,1,1,,
3015,2,邊區,N,0,1,1,,
3015,2,義,N,0,1,1,,
3015,2,聞名,Vi,0,2,2,,3253_
3017,2,屬敗相,N,0,2,2,,3018_
3017,2,風水,N,0,2,2,,3018_
3019,2,花果,N,0,1,1,,
3019,2,山景區,N,0,1,1,,
3020,2,爬起來,Vi,0,1,1,,
3020,2,從前台,N,0,1,1,,
3022,2,輕重,N,0,2,2,,3023_
3022,2,偏頗,Vt,0,2,2,,3023_
3022,2,廉價,Vi,0,3,3,,3023_3347_
3022,2,碑打車,N,0,2,2,,3023_
3022,2,熱和,Vi,0,2,2,,3023_
3022,2,石磚地,N,0,2,2,,3023_
3024,2,七星,N,0,2,2,,3026_
3025,2,跡象,N,0,2,2,,3027_
3025,2,買回來,Vt,0,2,2,,3027_
3029,2,洞洞,N,0,1,1,,
3029,2,寧波,N,0,1,1,,
3030,2,惱人,Vi,0,1,1,,
3030,2,音樂聲,N,0,1,1,,
3031,2,置之不理,Vi,0,1,1,,
3031,2,換換,Vt,0,1,1,,
3032,2,重大,Vi,0,2,2,,3033_
3032,2,預報,N,0,2,2,,3033_
3032,2,講價,Vi,0,3,3,,3033_3099_
3032,2,名片,N,0,2,2,,3033_
3032,2,水份,N,0,2,2,,3033_
3032,2,店大,N,0,2,2,,3033_
3032,2,許多,ADV,0,2,2,,3033_
3032,2,回傳,Vt,0,2,2,,3033_
3034,2,二日,N,0,1,1,,
3034,2,遊人,N,0,1,1,,
3034,2,天目湖,N,0,2,2,,3323_
3038,2,室花灑,Vt,0,2,2,,3039_
3038,2,爭搶,Vt,0,2,2,,3039_
3038,2,動物,N,0,3,3,,3039_3254_
3038,2,黑夜,N,0,2,2,,3039_
3038,2,10年,N,0,2,2,,3039_
3038,2,轎車,N,0,2,2,,3039_
3038,2,冷水浴,N,0,2,2,,3039_
3038,2,凍結,Vt,0,2,2,,3039_
3038,2,鮮橙,Vi,0,4,4,,3038_3039_3039_
3038,2,卡車,N,0,2,2,,3039_
3038,2,參與,Vt,0,2,2,,3039_
3038,2,神經質,Vi,0,2,2,,3039_
3038,2,摩托車,N,0,3,3,,3039_3098_
3038,2,行人,N,0,2,2,,3039_
3038,2,讓步,Vi,0,2,2,,3039_
3038,2,買單,Vi,0,2,2,,3039_
3038,2,菜場,N,0,2,2,,3039_
3038,2,報警器,N,0,2,2,,3039_
3038,2,亂竄,Vi,0,2,2,,3039_
3038,2,上下班,Vi,0,5,5,,3038_3039_3039_3149_
3038,2,立交橋,N,0,6,6,,3038_3039_3039_3475_3475_
3038,2,狗屁,N,0,2,2,,3039_
3040,2,金泰海博,N,0,1,1,,
3040,2,公廁,N,0,2,2,,3319_
3040,2,雜草叢生,Vi,0,1,1,,
3040,2,關死,Vt,0,1,1,,
3040,2,窗熱,N,0,1,1,,
3040,2,晚起,Vi,0,1,1,,
3040,2,眼淚,N,0,1,1,,
3040,2,吵吵,Vi,0,1,1,,
3041,2,金元,N,0,1,1,,
3041,2,衛生部,N,0,1,1,,
3041,2,親熱聲,N,0,1,1,,
3043,2,狂妄,Vi,0,1,1,,
3043,2,自以為是,Vi,0,1,1,,
3043,2,切記,Vt,0,1,1,,
3043,2,肆意,ADV,0,1,1,,
3043,2,自大,Vi,0,1,1,,
3044,2,拜託,Vt,0,4,4,,3048_3433_3435_
3044,2,救,Vt,0,2,2,,3048_
3044,2,床板,N,0,2,2,,3048_
3044,2,特此,ADV,0,2,2,,3048_
3047,2,特惠,A,0,2,2,,3051_
3047,2,星座,N,0,6,6,,3049_3049_3049_3049_3051_
3047,2,錦地,N,0,6,6,,3049_3049_3049_3049_3051_
3049,2,變通,Vi,0,2,2,,3049_
3049,2,根據,N,0,1,1,,
3049,2,06年,N,0,1,1,,
3049,2,富仁坊,N,0,1,1,,
3049,2,辦到,Vt,0,1,1,,
3049,2,虛心,Vi,0,1,1,,
3049,2,忠心,Vi,0,1,1,,
3049,2,火冒三丈,Vi,0,1,1,,
3049,2,終歸,ADV,0,1,1,,
3052,2,蓬萊,N,0,4,4,,3053_3205_3205_
3054,2,實話實說,Vi,0,2,2,,3379_
3054,2,調低,Vt,0,1,1,,
3054,2,隱私性,N,0,1,1,,
3055,2,討,Vt,0,1,1,,
3055,2,趨,Vt,0,1,1,,
3055,2,八佰伴,N,0,1,1,,
3055,2,傻,Vi,0,1,1,,
3055,2,日記本,N,0,1,1,,
3055,2,詞典,N,0,1,1,,
3055,2,傻傻,Vi,0,1,1,,
3055,2,查查,Vt,0,3,3,,3433_3435_
3055,2,漏發,N,0,1,1,,
3055,2,說道,Vt,0,1,1,,
3055,2,假人,N,0,1,1,,
3055,2,流程,N,0,2,2,,3329_
3056,2,算得上,Vt,0,3,3,,3423_3424_
3056,2,紫薇,N,0,1,1,,
3056,2,招來,Vt,0,1,1,,
3056,2,打工,Vi,0,1,1,,
3056,2,透氣,Vi,0,1,1,,
3058,2,喧嘩,Vi,0,1,1,,
3058,2,限於,Vt,0,1,1,,
3059,2,收錄,Vt,0,1,1,,
3059,2,贊成,Vt,0,1,1,,
3059,2,玉皇閣,N,0,2,2,,3059_
3062,2,不以為然,Vi,0,1,1,,
3062,2,楷模,N,0,1,1,,
3062,2,團結,Vt,0,1,1,,
3062,2,湖店,N,0,1,1,,
3065,2,六峰,N,0,2,2,,3067_
3065,2,少見多怪,Vi,0,2,2,,3067_
3065,2,繳納,Vt,0,2,2,,3067_
3066,2,三門峽,N,0,2,2,,3068_
3069,2,二星半,N,0,2,2,,3070_
3069,2,空關,N,0,2,2,,3070_
3069,2,大院,N,0,2,2,,3070_
3069,2,泛出,Vt,0,2,2,,3070_
3069,2,計,N,0,2,2,,3070_
3069,2,東翼,N,0,2,2,,3070_
3069,2,宰客,N,0,2,2,,3070_
3069,2,吃素,Vi,0,2,2,,3070_
3069,2,桑塔納,N,0,2,2,,3070_
3069,2,洗髮,N,0,2,2,,3070_
3069,2,西翼,N,0,2,2,,3070_
3069,2,要價,Vt,0,3,3,,3070_3107_
3069,2,自帶洗髮水,N,0,2,2,,3070_
3069,2,平遙,N,0,6,6,,3069_3069_3070_3070_3070_
3069,2,攔車,Vi,0,3,3,,3070_3231_
3069,2,通行費,N,0,2,2,,3070_
3069,2,王家,N,0,2,2,,3070_
3069,2,霉斑,N,0,2,2,,3070_
3069,2,店不,N,0,2,2,,3070_
3069,2,飛來橫禍,N,0,2,2,,3070_
3069,2,浴液,N,0,2,2,,3070_
3069,2,夏利,N,0,2,2,,3070_
3069,2,麗澤,N,0,2,2,,3070_
3071,2,額免單,N,0,1,1,,
3071,2,殘餘物,N,0,2,2,,3073_
3071,2,唱到,Vt,0,1,1,,
3071,2,美容,N,0,2,2,,3132_
3071,2,蹦迪,N,0,1,1,,
3071,2,懷仁,Vi,0,1,1,,
3071,2,甲醛,N,0,1,1,,
3072,2,歌奏家,N,0,1,1,,
3072,2,高音,N,0,1,1,,
3072,2,感化,Vt,0,1,1,,
3072,2,!!!!,Vt,0,1,1,,
3072,2,獻上,Vt,0,1,1,,
3072,2,五彩繽紛,Vi,0,1,1,,
3073,2,硬幣,N,0,1,1,,
3073,2,轉換,Vt,0,1,1,,
3073,2,替換,Vt,0,1,1,,
3073,2,後備,A,0,1,1,,
3073,2,天明,Vi,0,2,2,,3073_
3073,2,應有,A,0,1,1,,
3073,2,呼嚕,N,0,1,1,,
3073,2,水器,N,0,1,1,,
3074,2,感興趣,Vi,0,1,1,,
3074,2,沙子,N,0,1,1,,
3074,2,議價,Vi,0,1,1,,
3074,2,紙筒,N,0,1,1,,
3074,2,軸,N,0,2,2,,3466_
3074,2,依賴症,N,0,1,1,,
3074,2,干飯,N,0,1,1,,
3074,2,不見了,Vi,0,7,7,,3076_3184_3186_3188_3289_3290_
3074,2,阮,N,0,2,2,,3074_
3074,2,卷紙,N,0,1,1,,
3074,2,頭一晚,N,0,1,1,,
3074,2,洱海,N,0,1,1,,
3074,2,患者,N,0,1,1,,
3074,2,歇歇腳,Vi,0,1,1,,
3074,2,煮飯,Vi,0,1,1,,
3074,2,鞋撐,N,0,3,3,,3074_3074_
3074,2,稀飯,N,0,5,5,,3289_3290_3308_3379_
3074,2,停運,N,0,1,1,,
3074,2,下關,N,0,1,1,,
3076,2,螺絲,N,0,1,1,,
3076,2,橫條,N,0,1,1,,
3076,2,遲緩,Vi,0,1,1,,
3076,2,把手,N,0,1,1,,
3076,2,痛心,Vt,0,1,1,,
3076,2,衝鼻,N,0,1,1,,
3076,2,招全,N,0,1,1,,
3076,2,雜音,N,0,1,1,,
3076,2,無異,Vt,0,1,1,,
3076,2,說完,Vt,0,1,1,,
3076,2,伴隨,Vt,0,1,1,,
3076,2,止渴,Vi,0,1,1,,
3076,2,顯像管,N,0,1,1,,
3076,2,飲甄,N,0,1,1,,
3076,2,吹噓,Vt,0,1,1,,
3076,2,暈頭轉向,Vi,0,1,1,,
3078,2,目睹,Vt,0,1,1,,
3078,2,奇跡,N,0,1,1,,
3079,2,硬說,Vt,0,3,3,,3084_3446_
3080,2,比超低,Vi,0,1,1,,
3082,2,攜程定過,Vt,0,1,1,,
3083,2,迎來,Vt,0,1,1,,
3083,2,連通,Vt,0,1,1,,
3083,2,雪花,N,0,1,1,,
3083,2,菜油,N,0,1,1,,
3083,2,殘缺,Vi,0,1,1,,
3083,2,截然,ADV,0,1,1,,
3083,2,邁過,Vt,0,1,1,,
3083,2,怒火,N,0,1,1,,
3083,2,單面,N,0,1,1,,
3083,2,本子,N,0,1,1,,
3083,2,一口咬定,Vt,0,1,1,,
3083,2,大步,N,0,1,1,,
3083,2,拎包,N,0,1,1,,
3083,2,巨鉹,N,0,1,1,,
3083,2,人情,N,0,1,1,,
3083,2,回地,N,0,1,1,,
3083,2,身邊,N,0,3,3,,3083_3103_
3083,2,鈔票,N,0,1,1,,
3083,2,邁出,Vt,0,1,1,,
3083,2,燕趙,N,0,1,1,,
3083,2,婉拒,Vt,0,2,2,,3083_
3083,2,氣暈,Vi,0,1,1,,
3083,2,找給,Vt,0,1,1,,
3083,2,緩台,N,0,1,1,,
3083,2,篩選,Vt,0,1,1,,
3083,2,押金單,N,0,1,1,,
3083,2,外加,Vt,0,2,2,,3360_
3083,2,忠誠,Vi,0,1,1,,
3084,2,提心吊膽,Vi,0,1,1,,
3084,2,洗液,N,0,2,2,,3253_
3084,2,掙錢,Vi,0,1,1,,
3085,2,水泥,N,0,2,2,,3415_
3085,2,退錢,Vi,0,1,1,,
3085,2,丟到,Vt,0,1,1,,
3085,2,奇大,Vi,0,1,1,,
3085,2,消毒水,N,0,1,1,,
3087,2,住久,N,0,1,1,,
3087,2,滅蚊,N,0,1,1,,
3088,2,變價,N,0,1,1,,
3088,2,佳麗,N,0,1,1,,
3088,2,破破,Vi,0,1,1,,
3089,2,雲龍湖,N,0,1,1,,
3089,2,壓住,Vt,0,1,1,,
3090,2,住嘉利,N,0,1,1,,
3090,2,冷清清,Vi,0,1,1,,
3091,2,雲龍,N,0,1,1,,
3095,2,邢台市,N,0,1,1,,
3095,2,水下,N,0,1,1,,
3096,2,毛兒,N,0,1,1,,
3098,2,權力,N,0,1,1,,
3098,2,味精,N,0,1,1,,
3098,2,安吉,N,0,2,2,,3098_
3098,2,叉路,N,0,1,1,,
3098,2,感應到,Vt,0,1,1,,
3098,2,通風機,N,0,1,1,,
3098,2,高架橋,N,0,2,2,,3098_
3098,2,馬力,N,0,2,2,,3270_
3098,2,感應器,N,0,1,1,,
3098,2,加大,Vt,0,2,2,,3146_
3098,2,買一送一,Vi,0,1,1,,
3098,2,抵禦,Vt,0,1,1,,
3098,2,排風,N,0,2,2,,3098_
3098,2,歎為觀止,Vi,0,1,1,,
3099,2,爆滿,Vi,0,1,1,,
3099,2,降價,Vi,0,1,1,,
3099,2,變動,Vt,0,1,1,,
3099,2,定房,N,0,1,1,,
3099,2,拉薩,N,0,4,4,,3100_3448_3453_
3099,2,抽空,ADV,0,1,1,,
3100,2,四川人,N,0,1,1,,
3100,2,初,ADV,0,1,1,,
3100,2,事項,N,0,1,1,,
3101,2,印子,N,0,1,1,,
3101,2,圓珠筆,N,0,1,1,,
3101,2,無效,Vi,0,1,1,,
3101,2,申辯,Vt,0,1,1,,
3101,2,招牌,N,0,2,2,,3345_
3102,2,消滅,Vt,0,1,1,,
3103,2,聯眾打,Vt,0,1,1,,
3103,2,走入,Vt,0,1,1,,
3103,2,嗚嗚,ADV,0,1,1,,
3103,2,奇快,Vi,0,1,1,,
3103,2,長長,Vi,0,1,1,,
3103,2,架,Vt,0,1,1,,
3103,2,效,N,0,1,1,,
3103,2,太空,N,0,1,1,,
3103,2,掌,N,0,1,1,,
3103,2,膽戰心驚,Vi,0,1,1,,
3103,2,口渴,Vi,0,1,1,,
3103,2,腳手,N,0,1,1,,
3103,2,益,N,0,1,1,,
3103,2,庫房,N,0,1,1,,
3103,2,鑽聲,N,0,1,1,,
3103,2,發癢,Vi,0,1,1,,
3103,2,砸,Vt,0,3,3,,3345_3487_
3103,2,為啥,ADV,0,1,1,,
3104,2,譽興,Vi,0,2,2,,3104_
3104,2,黑斑,N,0,1,1,,
3105,2,拋開,Vt,0,1,1,,
3105,2,信任度,N,0,1,1,,
3107,2,弦,N,0,1,1,,
3107,2,收銀台,N,0,1,1,,
3107,2,頭腦,N,0,1,1,,
3107,2,詐騙,Vt,0,1,1,,
3108,2,修身,Vi,0,2,2,,3109_
3108,2,消過,Vt,0,2,2,,3109_
3108,2,養性,Vi,0,2,2,,3109_
3108,2,有利於,Vt,0,2,2,,3109_
3110,2,綠博院,N,0,1,1,,
3110,2,拿回來,Vt,0,1,1,,
3110,2,索福特,N,0,1,1,,
3111,2,６樓,N,0,1,1,,
3111,2,５樓,N,0,1,1,,
3111,2,升降機,N,0,1,1,,
3111,2,嗅到,Vt,0,1,1,,
3111,2,付出,Vt,0,1,1,,
3111,2,阻擋,Vt,0,1,1,,
3111,2,水花,N,0,1,1,,
3111,2,地板處,N,0,1,1,,
3112,2,豐台區,N,0,1,1,,
3113,2,就算,Vi,0,1,1,,
3114,2,泛黃,Vi,0,1,1,,
3114,2,儘是,Vt,0,1,1,,
3114,2,望過去,Vi,0,1,1,,
3114,2,開裂,Vi,0,1,1,,
3115,2,史自終臉,N,0,1,1,,
3115,2,麻將桌,N,0,1,1,,
3115,2,重來,Vi,0,1,1,,
3115,2,擠擠,Vt,0,1,1,,
3115,2,擔任,Vt,0,1,1,,
3115,2,不言而喻,Vi,0,1,1,,
3115,2,惹火,Vi,0,1,1,,
3115,2,按散客,N,0,1,1,,
3115,2,抬起來,Vi,0,2,2,,3115_
3116,2,費解,Vi,0,1,1,,
3117,2,點評區,N,0,1,1,,
3117,2,街面,N,0,1,1,,
3117,2,住戶,N,0,1,1,,
3118,2,故里,N,0,3,3,,3118_3118_
3118,2,窗均,N,0,1,1,,
3118,2,亨,N,0,1,1,,
3118,2,紹興,N,0,1,1,,
3118,2,商販,N,0,1,1,,
3118,2,不復,ADV,0,1,1,,
3118,2,車伕,N,0,1,1,,
3118,2,膽小,Vi,0,1,1,,
3118,2,權衡,Vt,0,1,1,,
3118,2,截然不同,Vi,0,1,1,,
3118,2,魯迅,N,0,1,1,,
3118,2,老宅,N,0,1,1,,
3118,2,計劃好,Vt,0,1,1,,
3118,2,民宅,N,0,2,2,,3274_
3119,2,三思,Vi,0,5,5,,3124_3340_3340_3413_
3119,2,修修,Vt,0,2,2,,3124_
3119,2,碎,Vi,0,2,2,,3124_
3129,2,搞掂,Vt,0,2,2,,3130_
3129,2,發脾氣,Vi,0,6,6,,3129_3129_3130_3130_3130_
3129,2,中午點,N,0,4,4,,3129_3130_3130_
3129,2,搞不好,ADV,0,2,2,,3130_
3129,2,搞好,Vt,0,6,6,,3129_3129_3130_3130_3130_
3129,2,案,N,0,2,2,,3130_
3131,2,有求必應,Vi,0,1,1,,
3131,2,3星半,N,0,1,1,,
3132,2,加熱,Vi,0,1,1,,
3132,2,石沉,N,0,1,1,,
3132,2,敷衍,Vt,0,2,2,,3237_
3132,2,基,N,0,1,1,,
3132,2,試想,Vt,0,2,2,,3246_
3132,2,包場,N,0,1,1,,
3132,2,中學,N,0,1,1,,
3132,2,半天半,N,0,1,1,,
3132,2,偌大,A,0,1,1,,
3132,2,舉辦,Vt,0,1,1,,
3132,2,上飯,N,0,1,1,,
3132,2,放盜鏈,N,0,1,1,,
3132,2,勞累,Vi,0,1,1,,
3133,2,行李車,N,0,1,1,,
3133,2,國是,N,0,1,1,,
3133,2,括號,N,0,1,1,,
3133,2,富陽,N,0,1,1,,
3133,2,奢望,Vt,0,1,1,,
3133,2,遵守,Vt,0,1,1,,
3133,2,常年,ADV,0,1,1,,
3133,2,星號,N,0,1,1,,
3136,2,酒水,N,0,1,1,,
3136,2,備,Vt,0,1,1,,
3136,2,預備,Vt,0,2,2,,3333_
3138,2,晦氣,Vi,0,1,1,,
3139,2,分辨,Vt,0,1,1,,
3139,2,拿起來,Vi,0,3,3,,3170_3172_
3139,2,鮮明,Vi,0,1,1,,
3139,2,撕開,Vt,0,3,3,,3213_3218_
3139,2,標識,N,0,1,1,,
3140,2,改改,Vt,0,1,1,,
3141,2,拆騰,N,0,1,1,,
3141,2,充斥,Vi,0,1,1,,
3141,2,抹布,N,0,1,1,,
3142,2,歸物業管,N,0,1,1,,
3142,2,下車場,N,0,1,1,,
3142,2,自家車,N,0,1,1,,
3142,2,目標,N,0,1,1,,
3142,2,物業,N,0,1,1,,
3142,2,面目全非,Vi,0,1,1,,
3144,2,丈夫,N,0,1,1,,
3144,2,大鬧,Vi,0,1,1,,
3144,2,奸,Vi,0,1,1,,
3144,2,捉,Vt,0,1,1,,
3144,2,少婦,N,0,1,1,,
3146,2,不實,Vi,0,1,1,,
3146,2,前因後果,N,0,1,1,,
3146,2,差評,N,0,1,1,,
3146,2,考核,N,0,1,1,,
3146,2,詳盡,Vi,0,1,1,,
3146,2,網管,N,0,3,3,,3158_3158_
3146,2,衝突,N,0,2,2,,3226_
3146,2,爭執,N,0,2,2,,3331_
3146,2,上網線,N,0,1,1,,
3146,2,斷章,N,0,1,1,,
3146,2,歪曲,Vt,0,1,1,,
3146,2,測試,N,0,1,1,,
3146,2,語調,N,0,1,1,,
3146,2,音程,N,0,1,1,,
3146,2,力度,N,0,1,1,,
3146,2,柔和,Vi,0,1,1,,
3146,2,均衡,Vt,0,1,1,,
3149,2,搖地動,Vi,0,1,1,,
3149,2,中途,N,0,2,2,,3259_
3150,2,證大麗笙,N,0,1,1,,
3150,2,喊,Vt,0,1,1,,
3150,2,連背身,N,0,1,1,,
3150,2,重疊,Vi,0,1,1,,
3150,2,宿州匯源,N,0,1,1,,
3150,2,認認,Vt,0,1,1,,
3150,2,預付權,N,0,1,1,,
3150,2,話題,N,0,1,1,,
3152,2,台板,N,0,1,1,,
3153,2,1窗,N,0,1,1,,
3153,2,汽車聲,N,0,1,1,,
3158,2,兼職,Vi,0,2,2,,3158_
3159,2,放亮,Vt,0,1,1,,
3159,2,花去,Vt,0,1,1,,
3159,2,目錄,N,0,1,1,,
3159,2,污物,N,0,1,1,,
3159,2,產物,N,0,1,1,,
3159,2,大客車,N,0,4,4,,3159_3159_3159_
3159,2,牆角,N,0,2,2,,3409_
3159,2,推薦員,N,0,1,1,,
3159,2,咫尺,N,0,1,1,,
3159,2,斑,N,0,1,1,,
3159,2,遺留下,Vt,0,1,1,,
3159,2,打聽到,Vt,0,1,1,,
3159,2,啟用,Vt,0,1,1,,
3159,2,纍纍,Vi,0,1,1,,
3159,2,最為,ADV,0,1,1,,
3159,2,管理員,N,0,1,1,,
3160,2,墊地,N,0,1,1,,
3161,2,車壞,N,0,1,1,,
3162,2,動彈,Vi,0,3,3,,3289_3290_
3162,2,上算,Vi,0,1,1,,
3162,2,加床,N,0,3,3,,3162_3162_
3163,2,老爺們,N,0,1,1,,
3163,2,千島,N,0,1,1,,
3163,2,現況,N,0,1,1,,
3163,2,半山腰,N,0,1,1,,
3163,2,報以,Vt,0,1,1,,
3163,2,葉君健,N,0,2,2,,3163_
3163,2,弄錯,Vt,0,1,1,,
3163,2,擔誤,Vt,0,1,1,,
3163,2,宋村,N,0,2,2,,3163_
3163,2,耍蠻,Vt,0,1,1,,
3163,2,歉,N,0,1,1,,
3163,2,這廝,N,0,2,2,,3163_
3163,2,方飛,N,0,1,1,,
3163,2,歉疚,Vi,0,2,2,,3163_
3164,2,須,ADV,0,1,1,,
3167,2,檯布,N,0,1,1,,
3170,2,胡亂,ADV,0,2,2,,3172_
3170,2,刪,Vt,0,2,2,,3172_
3170,2,問到,Vt,0,2,2,,3172_
3170,2,默認,Vt,0,4,4,,3170_3172_3172_
3170,2,獲得,Vt,0,2,2,,3172_
3170,2,意,N,0,2,2,,3172_
3170,2,刪掉,Vt,0,2,2,,3172_
3170,2,不需,ADV,0,2,2,,3172_
3171,2,連鎖店,N,0,2,2,,3173_
3171,2,及格,Vi,0,2,2,,3173_
3171,2,老油條,N,0,2,2,,3173_
3174,2,黑印,N,0,1,1,,
3174,2,床品,N,0,1,1,,
3175,2,門童邦,N,0,2,2,,3176_
3175,2,邦,N,0,2,2,,3176_
3175,2,做出來,Vi,0,2,2,,3176_
3175,2,競收,Vt,0,2,2,,3176_
3177,2,蟲蟲,N,0,1,1,,
3179,2,比美,Vt,0,1,1,,
3179,2,惡偏,Vi,0,1,1,,
3180,2,著涼,Vi,0,1,1,,
3180,2,徒,ADV,0,1,1,,
3180,2,鴨絨,N,0,1,1,,
3182,2,設施台,N,0,2,2,,3183_
3184,2,常事,N,0,1,1,,
3184,2,批准,Vt,0,1,1,,
3184,2,拍桌子,Vi,0,1,1,,
3184,2,不了了之,Vi,0,4,4,,3184_3234_3458_
3185,2,古兜,N,0,2,2,,3185_
3185,2,四時,N,0,1,1,,
3185,2,酒店車,N,0,1,1,,
3185,2,新會,N,0,1,1,,
3185,2,崖南,N,0,2,2,,3185_
3186,2,清淨劑,N,0,2,2,,3188_
3186,2,無菸,Vi,0,4,4,,3186_3188_3188_
3186,2,泥巴,N,0,2,2,,3188_
3186,2,噴,Vt,0,5,5,,3186_3188_3188_3266_
3186,2,洗衣機,N,0,4,4,,3187_3188_3189_
3186,2,嚇一跳,Vi,0,2,2,,3188_
3186,2,散掉,Vi,0,2,2,,3188_
3186,2,拿掉,Vt,0,2,2,,3188_
3186,2,錯房卡,N,0,2,2,,3188_
3186,2,菸灰缸,N,0,2,2,,3188_
3187,2,列舉,Vt,0,2,2,,3189_
3187,2,寒冬,N,0,2,2,,3189_
3187,2,呼氣,Vi,0,2,2,,3189_
3187,2,凍死,Vt,0,2,2,,3189_
3187,2,划不來,Vi,0,2,2,,3189_
3187,2,烏龜,N,0,2,2,,3189_
3187,2,強勁,Vi,0,2,2,,3189_
3187,2,事物,N,0,2,2,,3189_
3187,2,弱點,N,0,2,2,,3189_
3190,2,沉沉,Vi,0,1,1,,
3190,2,難說,Vt,0,1,1,,
3190,2,大媽級,N,0,1,1,,
3190,2,倒退,Vi,0,1,1,,
3191,2,這麼著,ADV,0,1,1,,
3193,2,印出來,Vi,0,1,1,,
3193,2,制度,N,0,2,2,,3193_
3193,2,明細單,N,0,1,1,,
3193,2,加蓋,Vt,0,1,1,,
3194,2,複印,Vt,0,1,1,,
3194,2,樹苗,N,0,1,1,,
3194,2,飄楊,N,0,1,1,,
3194,2,氣候,N,0,1,1,,
3194,2,清單,N,0,1,1,,
3194,2,開麼,N,0,1,1,,
3194,2,移動,Vt,0,1,1,,
3195,2,啥年,N,0,1,1,,
3196,2,賤,Vi,0,1,1,,
3196,2,送風,Vi,0,1,1,,
3196,2,禁止,Vt,0,1,1,,
3196,2,機動車,N,0,1,1,,
3196,2,調度,Vt,0,1,1,,
3201,2,燙傷,Vt,0,1,1,,
3202,2,腳印,N,0,1,1,,
3202,2,暈４,Vi,0,1,1,,
3202,2,其實不然,Vi,0,1,1,,
3203,2,圬跡,N,0,1,1,,
3204,2,臨界,A,0,1,1,,
3204,2,觀瞻,N,0,1,1,,
3204,2,泥湯,N,0,1,1,,
3204,2,情話,N,0,1,1,,
3204,2,小販,N,0,1,1,,
3204,2,巨吵,N,0,1,1,,
3205,2,入庫,Vi,0,1,1,,
3205,2,四巾,N,0,1,1,,
3205,2,庫,N,0,1,1,,
3205,2,帶走,Vt,0,1,1,,
3205,2,出聲,Vi,0,1,1,,
3205,2,噴頭水,N,0,1,1,,
3205,2,分區,N,0,1,1,,
3205,2,超時,Vi,0,1,1,,
3205,2,稍加,ADV,0,1,1,,
3205,2,遊覽完,Vt,0,1,1,,
3210,2,姑娘,N,0,2,2,,3215_
3210,2,雙標,N,0,2,2,,3215_
3210,2,抗,Vt,0,2,2,,3215_
3210,2,扛,Vt,0,2,2,,3215_
3210,2,沉,Vi,0,2,2,,3215_
3211,2,電線,N,0,2,2,,3216_
3211,2,裸露,Vt,0,5,5,,3216_3288_3353_3355_
3212,2,蜘蛛,N,0,3,3,,3217_3415_
3213,2,大夫,N,0,2,2,,3218_
3213,2,離春熙路,N,0,2,2,,3218_
3213,2,毛巾袋,N,0,2,2,,3218_
3213,2,扭,Vt,0,2,2,,3218_
3213,2,抗菌,Vi,0,2,2,,3218_
3213,2,突,ADV,0,2,2,,3218_
3214,2,迷你房,N,0,2,2,,3219_
3220,2,尼盛萬麗,N,0,2,2,,3221_
3223,2,新金山,N,0,1,1,,
3223,2,混擾,Vi,0,1,1,,
3224,2,起價,Vt,0,1,1,,
3224,2,提價,N,0,1,1,,
3225,2,包涵,Vt,0,1,1,,
3225,2,院落,N,0,1,1,,
3226,2,定到,Vt,0,3,3,,3289_3290_
3226,2,定過,Vt,0,1,1,,
3226,2,強迫,Vt,0,1,1,,
3226,2,引誘,Vt,0,1,1,,
3226,2,騰房,N,0,1,1,,
3227,2,到期,Vi,0,1,1,,
3231,2,按摩池,N,0,1,1,,
3231,2,不周,Vi,0,1,1,,
3231,2,網線壞,N,0,1,1,,
3231,2,氣瘋,N,0,1,1,,
3231,2,不休,Vi,0,1,1,,
3231,2,勤奮,Vi,0,1,1,,
3231,2,深航,N,0,1,1,,
3231,2,打樁機,N,0,1,1,,
3231,2,不悅,Vi,0,1,1,,
3231,2,香爐,N,0,2,2,,3231_
3231,2,身心,N,0,1,1,,
3231,2,回想,Vt,0,1,1,,
3231,2,包裝好,Vt,0,1,1,,
3231,2,偏巧,ADV,0,1,1,,
3231,2,獲悉,Vt,0,1,1,,
3231,2,捂,Vt,0,1,1,,
3231,2,跑過來,Vi,0,1,1,,
3231,2,髮箍,Vt,0,2,2,,3231_
3231,2,眼睜睜,ADV,0,1,1,,
3231,2,禮拜,N,0,1,1,,
3231,2,橙子,N,0,1,1,,
3231,2,套上,Vt,0,1,1,,
3231,2,處事,Vi,0,1,1,,
3231,2,引到,Vt,0,1,1,,
3232,2,超土,N,0,1,1,,
3232,2,湖畔,N,0,1,1,,
3232,2,看法,N,0,1,1,,
3232,2,搜到,Vt,0,1,1,,
3232,2,尊爵,N,0,1,1,,
3232,2,馬可波羅,N,0,1,1,,
3233,2,重物,N,0,1,1,,
3233,2,惡臭,N,0,1,1,,
3233,2,客房門,N,0,1,1,,
3233,2,電機,N,0,1,1,,
3233,2,作嘔,Vi,0,1,1,,
3233,2,敲擊,Vt,0,1,1,,
3233,2,訂金,N,0,2,2,,3268_
3233,2,住多,N,0,1,1,,
3234,2,短褲,N,0,1,1,,
3234,2,前一天,N,0,1,1,,
3236,2,簽證,N,0,1,1,,
3237,2,燥熱,Vi,0,1,1,,
3237,2,糖霜,N,0,1,1,,
3237,2,發毛,Vi,0,1,1,,
3237,2,笨,Vi,0,1,1,,
3239,2,涼台,N,0,1,1,,
3239,2,費力,Vi,0,1,1,,
3240,2,發大火,N,0,1,1,,
3241,2,宏偉,Vi,0,1,1,,
3242,2,多難,Vi,0,1,1,,
3242,2,受有,Vt,0,1,1,,
3242,2,噴出,Vt,0,1,1,,
3243,2,溫泉票,N,0,3,3,,3243_3246_
3243,2,淡薄,Vi,0,1,1,,
3243,2,怒斥,Vt,0,1,1,,
3243,2,名為,Vt,0,1,1,,
3243,2,按理,ADV,0,1,1,,
3244,2,連車,N,0,1,1,,
3245,2,煞筆,N,0,1,1,,
3245,2,裝傻,Vi,0,1,1,,
3245,2,出言不遜,Vi,0,1,1,,
3245,2,充愣,Vi,0,1,1,,
3245,2,遲早,ADV,0,1,1,,
3245,2,接入,Vt,0,2,2,,3245_
3246,2,沉默,Vi,0,1,1,,
3246,2,操心,Vt,0,1,1,,
3246,2,不善,Vi,0,2,2,,3341_
3246,2,陷阱,N,0,1,1,,
3246,2,踏,Vt,0,1,1,,
3246,2,糟蹋,Vt,0,2,2,,3253_
3246,2,踏米,N,0,1,1,,
3246,2,泡完,Vt,0,1,1,,
3246,2,礦物質,N,0,1,1,,
3246,2,溫泉池飯,N,0,1,1,,
3246,2,不倫不類,Vi,0,1,1,,
3246,2,遮風,Vi,0,1,1,,
3246,2,盤算,Vt,0,1,1,,
3246,2,時日,N,0,1,1,,
3246,2,限時,ADV,0,1,1,,
3246,2,冷颼颼,Vi,0,1,1,,
3246,2,孤棄,Vt,0,1,1,,
3246,2,長此以往,ADV,0,1,1,,
3246,2,溫泉池,N,0,1,1,,
3246,2,澡堂,N,0,1,1,,
3246,2,輕輕,Vi,0,1,1,,
3246,2,措手不及,Vi,0,1,1,,
3246,2,照料,Vt,0,1,1,,
3246,2,葫蘆,N,0,1,1,,
3246,2,毀壞,Vt,0,1,1,,
3246,2,忽閃,Vi,0,1,1,,
3246,2,預算,N,0,1,1,,
3246,2,喝水,Vi,0,1,1,,
3246,2,篷子,N,0,1,1,,
3246,2,估摸,Vt,0,1,1,,
3246,2,簡而言之,ADV,0,1,1,,
3246,2,跑回,Vt,0,1,1,,
3246,2,內涵,N,0,1,1,,
3246,2,維持,Vt,0,1,1,,
3249,2,期望值,N,0,1,1,,
3252,2,縣級市,N,0,1,1,,
3252,2,代客,Vt,0,1,1,,
3252,2,龍巖,N,0,1,1,,
3253,2,爭不過,Vt,0,1,1,,
3253,2,２月,N,0,2,2,,3253_
3253,2,９日,N,0,1,1,,
3253,2,硬實,Vi,0,1,1,,
3253,2,走來,Vi,0,1,1,,
3253,2,芝麻球,N,0,1,1,,
3253,2,住後感,N,0,1,1,,
3253,2,清潔液,N,0,1,1,,
3253,2,１０日,N,0,1,1,,
3253,2,淡黃色,N,0,1,1,,
3253,2,聲吞氣,N,0,1,1,,
3253,2,主持,Vt,0,1,1,,
3253,2,全,N,0,1,1,,
3253,2,眼界,N,0,1,1,,
3253,2,寰島海底,N,0,1,1,,
3253,2,海口,N,0,1,1,,
3253,2,議論,Vt,0,1,1,,
3253,2,領略到,Vt,0,1,1,,
3253,2,爭辨,Vt,0,1,1,,
3253,2,鍋,N,0,1,1,,
3253,2,鍾,N,0,2,2,,3253_
3253,2,納稅人,N,0,1,1,,
3253,2,面目可憎,Vi,0,1,1,,
3253,2,啃人,Vt,0,1,1,,
3253,2,有償,A,0,1,1,,
3253,2,爛人,N,0,1,1,,
3253,2,白粥,N,0,4,4,,3360_3360_3360_
3253,2,污,Vt,0,1,1,,
3253,2,自費品,N,0,1,1,,
3253,2,過日子,Vi,0,1,1,,
3253,2,搾菜,N,0,1,1,,
3253,2,高招,N,0,1,1,,
3253,2,職責,N,0,1,1,,
3253,2,海南省,N,0,1,1,,
3253,2,民宿,N,0,1,1,,
3253,2,競,ADV,0,1,1,,
3253,2,新年,N,0,1,1,,
3253,2,呆住,Vi,0,2,2,,3253_
3254,2,相互,ADV,0,1,1,,
3254,2,簽收,Vt,0,1,1,,
3254,2,交還,Vt,0,1,1,,
3254,2,疊成,Vt,0,1,1,,
3254,2,開出,Vt,0,1,1,,
3254,2,瀑布,N,0,1,1,,
3255,2,副經理,N,0,4,4,,3255_3256_3256_
3255,2,列,Vt,0,2,2,,3256_
3255,2,房帳,N,0,2,2,,3256_
3255,2,結房費,N,0,2,2,,3256_
3255,2,簽署,Vt,0,2,2,,3256_
3255,2,交納,Vt,0,2,2,,3256_
3255,2,管理費,N,0,2,2,,3256_
3255,2,專用車,N,0,2,2,,3256_
3255,2,單據,N,0,2,2,,3256_
3257,2,俱,ADV,0,1,1,,
3257,2,侶,N,0,1,1,,
3257,2,苞,N,0,2,2,,3257_
3257,2,丁?3,N,0,1,1,,
3257,2,唐,N,0,1,1,,
3257,2,崩濾,N,0,1,1,,
3257,2,境,N,0,1,1,,
3257,2,摟,Vt,0,1,1,,
3257,2,丁祑,N,0,1,1,,
3257,2,懶惰,Vi,0,1,1,,
3257,2,丁矯,N,0,1,1,,
3257,2,盡穨,Vt,0,1,1,,
3257,2,大腿,N,0,1,1,,
3257,2,□□,Vi,0,1,1,,
3257,2,砰,ADV,0,1,1,,
3260,2,堵住,Vt,0,1,1,,
3260,2,唱歌聲,N,0,1,1,,
3260,2,修到,Vt,0,1,1,,
3261,2,暈糊糊,Vi,0,1,1,,
3261,2,噪,Vi,0,2,2,,3444_
3261,2,住所,N,0,1,1,,
3261,2,烏合之眾,N,0,1,1,,
3262,2,魚水之歡,N,0,2,2,,3263_
3264,2,電視櫃,N,0,2,2,,3333_
3264,2,打過去,Vi,0,2,2,,3333_
3264,2,見著,Vt,0,1,1,,
3264,2,呆板,Vi,0,1,1,,
3264,2,掛星,N,0,1,1,,
3264,2,列出來,Vi,0,1,1,,
3265,2,粗劣,Vi,0,1,1,,
3265,2,睡袋,N,0,1,1,,
3265,2,寒冷,Vi,0,2,2,,3397_
3265,2,初冬,N,0,1,1,,
3265,2,閒居,Vi,0,1,1,,
3266,2,墓地,N,0,1,1,,
3267,2,亂說,Vt,0,1,1,,
3268,2,房費付,N,0,1,1,,
3269,2,無可,ADV,0,1,1,,
3270,2,南寧,N,0,1,1,,
3270,2,蚊,N,0,1,1,,
3270,2,共舞,Vi,0,1,1,,
3270,2,鼓風機,N,0,1,1,,
3271,2,進駐,Vt,0,1,1,,
3272,2,價超,N,0,1,1,,
3273,2,經濟類,N,0,1,1,,
3274,2,不圖,Vt,0,1,1,,
3274,2,基金,N,0,1,1,,
3274,2,離海,N,0,1,1,,
3276,2,腫,Vi,0,1,1,,
3276,2,屍體,N,0,1,1,,
3276,2,沾,Vt,0,1,1,,
3276,2,連張,N,0,1,1,,
3276,2,鮮血,N,0,1,1,,
3277,2,趕早,ADV,0,1,1,,
3278,2,聽得,Vt,0,1,1,,
3278,2,打手機,N,0,1,1,,
3278,2,對話,N,0,1,1,,
3278,2,背板,N,0,1,1,,
3279,2,睡褲,N,0,1,1,,
3279,2,搞清楚,Vt,0,1,1,,
3279,2,清點,Vt,0,1,1,,
3280,2,撒,Vt,0,3,3,,3369_3370_
3280,2,燙到,Vt,0,1,1,,
3280,2,自停,Vi,0,1,1,,
3282,2,聰明,Vi,0,1,1,,
3282,2,烏煙瘴氣,Vi,0,1,1,,
3282,2,自說自話,Vi,0,1,1,,
3283,2,王道,N,0,1,1,,
3283,2,武漢,N,0,1,1,,
3286,2,肉菜,N,0,1,1,,
3287,2,轉移,Vt,0,1,1,,
3288,2,呼籲,Vt,0,1,1,,
3288,2,隨意性,N,0,1,1,,
3288,2,弊,N,0,1,1,,
3288,2,鏡,N,0,1,1,,
3288,2,一次性紙,N,0,1,1,,
3288,2,平靜,Vi,0,1,1,,
3288,2,遲到,Vi,0,1,1,,
3288,2,蓮蓬,N,0,1,1,,
3288,2,挖掉,Vt,0,1,1,,
3288,2,揚長,Vi,0,1,1,,
3289,2,破書,N,0,2,2,,3290_
3289,2,炸過,Vt,0,2,2,,3290_
3289,2,凶凶,Vi,0,2,2,,3290_
3289,2,黃頁,N,0,6,6,,3289_3289_3290_3290_3290_
3289,2,反胃,Vi,0,2,2,,3290_
3289,2,擦過,Vt,0,2,2,,3290_
3289,2,不能不,ADV,0,2,2,,3290_
3289,2,書,N,0,2,2,,3290_
3289,2,是非,N,0,2,2,,3290_
3289,2,迷你型,N,0,2,2,,3290_
3289,2,漆黑,Vi,0,2,2,,3290_
3289,2,不見了書,N,0,2,2,,3290_
3289,2,壓金,N,0,2,2,,3290_
3289,2,收據,N,0,2,2,,3290_
3289,2,目的性,N,0,2,2,,3290_
3289,2,炮彈,N,0,2,2,,3290_
3291,2,份內,A,0,2,2,,3292_
3291,2,大都,ADV,0,2,2,,3292_
3293,2,枕巾,N,0,1,1,,
3293,2,微波爐,N,0,1,1,,
3294,2,森樺苑,N,0,3,3,,3294_3294_
3294,2,有助於,Vt,0,1,1,,
3294,2,賣超,Vt,0,1,1,,
3294,2,壞事,N,0,1,1,,
3294,2,酒店圖,N,0,1,1,,
3295,2,急切,Vi,0,1,1,,
3295,2,不解,Vt,0,3,3,,3423_3424_
3295,2,前邊,N,0,1,1,,
3295,2,全然,ADV,0,1,1,,
3295,2,評說,Vt,0,1,1,,
3296,2,表明,Vt,0,1,1,,
3296,2,覆轍,N,0,1,1,,
3296,2,房門卡,N,0,1,1,,
3296,2,紀錄,N,0,3,3,,3296_3296_
3296,2,白費,Vt,0,1,1,,
3296,2,傷害,N,0,1,1,,
3296,2,立場,N,0,2,2,,3319_
3296,2,協助,Vt,0,1,1,,
3296,2,不折不扣,A,0,1,1,,
3296,2,報失,Vi,0,1,1,,
3296,2,據,N,0,1,1,,
3296,2,重蹈,Vt,0,1,1,,
3296,2,警方,N,0,4,4,,3296_3296_3296_
3296,2,言之有物,Vi,0,1,1,,
3298,2,上手,Vi,0,2,2,,3301_
3298,2,盤,N,0,2,2,,3301_
3298,2,收下來,Vi,0,2,2,,3301_
3304,2,隔斷,Vt,0,1,1,,
3304,2,要得,Vi,0,1,1,,
3305,2,豪氣萬千,Vi,0,1,1,,
3306,2,讓來讓去,Vi,0,1,1,,
3306,2,有錢人,N,0,1,1,,
3306,2,東湧線,N,0,1,1,,
3307,2,伸,Vt,0,1,1,,
3307,2,有心,Vt,0,1,1,,
3308,2,改口,Vi,0,1,1,,
3308,2,慶祝,Vt,0,1,1,,
3308,2,成果,N,0,1,1,,
3308,2,交易,N,0,1,1,,
3308,2,赫然,ADV,0,1,1,,
3308,2,籠統,Vi,0,1,1,,
3308,2,勝利,Vi,0,1,1,,
3308,2,南平市,N,0,1,1,,
3308,2,看客,N,0,1,1,,
3309,2,來客人,N,0,1,1,,
3309,2,後腳,N,0,1,1,,
3309,2,前腳,N,0,1,1,,
3309,2,牛叉,N,0,1,1,,
3309,2,電開,Vt,0,1,1,,
3309,2,打進來,Vi,0,1,1,,
3309,2,大堂燈,N,0,1,1,,
3310,2,透著,Vt,0,1,1,,
3310,2,分家,Vi,0,1,1,,
3311,2,水泵,N,0,1,1,,
3311,2,風景點,N,0,1,1,,
3311,2,問題房,N,0,1,1,,
3313,2,四捨五入,Vi,0,1,1,,
3313,2,震動,Vt,0,1,1,,
3313,2,差差,Vi,0,3,3,,3440_3442_
3313,2,隨隨便便,Vi,0,1,1,,
3313,2,收2%,Vt,0,1,1,,
3313,2,進位,N,0,1,1,,
3316,2,磁卡,N,0,3,3,,3448_3453_
3316,2,求助,Vt,0,1,1,,
3316,2,大吵,Vi,0,2,2,,3319_
3317,2,嫌疑,N,0,2,2,,3470_
3318,2,多拉,N,0,1,1,,
3318,2,剝脫,Vt,0,1,1,,
3318,2,近街,N,0,1,1,,
3318,2,大標,N,0,2,2,,3319_
3318,2,關燈,Vi,0,1,1,,
3318,2,小標,N,0,1,1,,
3318,2,地磚,N,0,2,2,,3385_
3318,2,漆,N,0,2,2,,3409_
3318,2,美廬,N,0,1,1,,
3318,2,逍夏,N,0,1,1,,
3318,2,乳膠,N,0,1,1,,
3319,2,骨青,N,0,1,1,,
3319,2,會址,N,0,1,1,,
3319,2,員工房,N,0,1,1,,
3319,2,牯嶺街,N,0,1,1,,
3319,2,電站,N,0,1,1,,
3319,2,飄過來,Vi,0,1,1,,
3319,2,敞開,Vt,0,1,1,,
3319,2,廬林,N,0,1,1,,
3319,2,漏掉,Vt,0,1,1,,
3319,2,花徑,N,0,1,1,,
3319,2,梳洗,Vt,0,1,1,,
3319,2,腔調,N,0,1,1,,
3319,2,方骨墊,N,0,1,1,,
3319,2,廬,N,0,2,2,,3319_
3319,2,仙人洞,N,0,1,1,,
3319,2,堅,Vi,0,1,1,,
3319,2,消夏,Vi,0,1,1,,
3319,2,納悶,Vt,0,1,1,,
3319,2,酒店路,N,0,1,1,,
3319,2,爭議,N,0,1,1,,
3319,2,廬林湖,N,0,1,1,,
3319,2,谷工,N,0,1,1,,
3319,2,墊好防滑墊,N,0,1,1,,
3319,2,溪谷,N,0,1,1,,
3319,2,功課,N,0,1,1,,
3319,2,台階,N,0,1,1,,
3319,2,琢磨,Vt,0,1,1,,
3320,2,提供物,N,0,1,1,,
3321,2,衣櫥,N,0,5,5,,3322_3403_3408_3413_
3321,2,摳,Vi,0,2,2,,3322_
3321,2,滅,Vt,0,2,2,,3322_
3323,2,吃吃,Vt,0,1,1,,
3324,2,超超,N,0,1,1,,
3324,2,這樣一來,ADV,0,1,1,,
3325,2,一輩子,N,0,1,1,,
3326,2,際,N,0,1,1,,
3327,2,掉進,Vt,0,1,1,,
3327,2,家商,N,0,1,1,,
3327,2,傳,Vt,0,1,1,,
3327,2,傳家,Vi,0,2,2,,3327_
3327,2,分割為,Vt,0,1,1,,
3327,2,扣下,Vt,0,1,1,,
3327,2,咋象,N,0,1,1,,
3327,2,名單,N,0,1,1,,
3331,2,房頭燈,N,0,1,1,,
3331,2,吊燈,N,0,1,1,,
3331,2,過度,ADV,0,1,1,,
3331,2,老來,ADV,0,1,1,,
3331,2,車水馬龍,Vi,0,1,1,,
3332,2,涼意,N,0,1,1,,
3332,2,拼湊,Vt,0,1,1,,
3333,2,綠洲,N,0,2,2,,3333_
3333,2,立達,N,0,1,1,,
3333,2,紫菜,N,0,1,1,,
3333,2,醉漢,N,0,1,1,,
3333,2,吃起來,ADV,0,1,1,,
3333,2,家常,A,0,1,1,,
3333,2,插,Vt,0,1,1,,
3333,2,受理,Vt,0,1,1,,
3333,2,草魚,N,0,1,1,,
3333,2,棕,Vi,0,1,1,,
3333,2,插孔,N,0,1,1,,
3333,2,憤慨,Vi,0,1,1,,
3333,2,按照,Vt,0,1,1,,
3333,2,紫菜湯,N,0,2,2,,3333_
3333,2,紅燒,Vt,0,1,1,,
3333,2,呻吟聲,N,0,1,1,,
3333,2,絲,N,0,1,1,,
3333,2,土豆,N,0,1,1,,
3336,2,格,N,0,1,1,,
3337,2,解除,Vt,0,1,1,,
3338,2,存心,ADV,0,1,1,,
3339,2,卡進,Vt,0,1,1,,
3339,2,前台價,N,0,1,1,,
3340,2,發言,Vi,0,1,1,,
3340,2,後毀,Vt,0,1,1,,
3340,2,雞窩,N,0,1,1,,
3340,2,酒點,N,0,1,1,,
3341,2,氣結,Vi,0,1,1,,
3341,2,6點多鐘,N,0,1,1,,
3341,2,不勝其煩,Vi,0,1,1,,
3341,2,鑰匙卡,N,0,5,5,,3341_3341_3341_3341_
3341,2,煩人,Vi,0,1,1,,
3341,2,佰富,N,0,2,2,,3341_
3341,2,說盡,Vt,0,1,1,,
3344,2,小巫見大巫,Vi,0,1,1,,
3345,2,衎洵,N,0,1,1,,
3345,2,迎合,Vt,0,1,1,,
3345,2,打架,Vi,0,1,1,,
3345,2,忠懇,Vi,0,1,1,,
3345,2,綠地,N,0,1,1,,
3345,2,國際性,N,0,1,1,,
3345,2,概況,N,0,1,1,,
3347,2,魚蝦,N,0,1,1,,
3347,2,喝喝茶,Vi,0,1,1,,
3347,2,蟹,N,0,1,1,,
3347,2,海蝦,N,0,1,1,,
3347,2,紫光,N,0,1,1,,
3347,2,嘛,ADV,0,1,1,,
3347,2,敗絮,N,0,1,1,,
3347,2,買罪受,Vt,0,1,1,,
3347,2,陽江,N,0,2,2,,3347_
3347,2,檔,N,0,1,1,,
3347,2,亭子,N,0,1,1,,
3347,2,標上,Vt,0,1,1,,
3347,2,紫江,N,0,1,1,,
3347,2,金玉其外,Vi,0,1,1,,
3347,2,華夏,N,0,1,1,,
3347,2,平手,Vi,0,1,1,,
3349,2,忍耐,Vt,0,1,1,,
3351,2,賠錢,Vi,0,1,1,,
3351,2,興沖沖,Vi,0,1,1,,
3352,2,反光,Vi,0,2,2,,3354_
3352,2,五金,N,0,2,2,,3354_
3352,2,態,N,0,2,2,,3354_
3352,2,心跳,Vi,0,2,2,,3354_
3353,2,狂載,Vt,0,2,2,,3355_
3353,2,陰森森,Vi,0,2,2,,3355_
3353,2,陶瓷,N,0,2,2,,3355_
3353,2,九洲路,N,0,2,2,,3355_
3353,2,榻榻米,N,0,2,2,,3355_
3356,2,扭傷,Vt,0,1,1,,
3356,2,特滑,Vi,0,1,1,,
3357,2,捲簾,N,0,1,1,,
3357,2,拉下,Vt,0,1,1,,
3358,2,逃走,Vi,0,1,1,,
3358,2,注入,Vt,0,1,1,,
3359,2,離4星級,N,0,1,1,,
3359,2,擦亮,Vt,0,1,1,,
3359,2,雙眼,N,0,1,1,,
3360,2,韓文,N,0,1,1,,
3360,2,字體,N,0,1,1,,
3360,2,上吐下瀉,Vi,0,1,1,,
3360,2,了,Vt,0,1,1,,
3360,2,後背,N,0,1,1,,
3360,2,前胸,N,0,1,1,,
3360,2,標注,Vt,0,2,2,,3360_
3360,2,晚班,N,0,1,1,,
3360,2,內心,N,0,2,2,,3443_
3360,2,虛弱,Vi,0,1,1,,
3360,2,介紹書,N,0,1,1,,
3360,2,看病,Vi,0,1,1,,
3360,2,切片,N,0,1,1,,
3360,2,配菜,N,0,1,1,,
3360,2,身子,N,0,1,1,,
3360,2,激動,Vi,0,1,1,,
3360,2,怠慢,Vt,0,1,1,,
3360,2,端來,Vt,0,1,1,,
3360,2,蠟黃,N,0,1,1,,
3360,2,發自,Vt,0,1,1,,
3360,2,瀉藥,N,0,1,1,,
3360,2,油膩,Vi,0,1,1,,
3360,2,翻遍,Vt,0,1,1,,
3360,2,吃得了,Vt,0,1,1,,
3360,2,石,N,0,1,1,,
3360,2,比較比較,Vt,0,1,1,,
3360,2,熬,Vt,0,1,1,,
3360,2,墊墊,N,0,1,1,,
3360,2,左等右等,Vi,0,1,1,,
3360,2,太平角,N,0,1,1,,
3360,2,止瀉,Vi,0,2,2,,3360_
3361,2,無緣無故,ADV,0,2,2,,3362_
3361,2,王府,N,0,2,2,,3362_
3361,2,李汪大,N,0,2,2,,3362_
3363,2,60年代,N,0,1,1,,
3364,2,攜程價,N,0,2,2,,3430_
3364,2,海航,N,0,1,1,,
3364,2,華大,N,0,1,1,,
3365,2,餐牌,N,0,1,1,,
3365,2,蹊蹺,N,0,1,1,,
3366,2,幽默,Vi,0,1,1,,
3366,2,堰還,Vt,0,1,1,,
3366,2,燕良大,N,0,1,1,,
3367,2,換去,Vt,0,4,4,,3368_3369_3370_
3369,2,鼎沸,Vi,0,2,2,,3370_
3371,2,無窗,N,0,3,3,,3371_3371_
3371,2,消防,A,0,2,2,,3371_
3371,2,生命,N,0,1,1,,
3372,2,折,Vt,0,3,3,,3423_3424_
3373,2,處推,Vt,0,2,2,,3374_
3373,2,納入,Vt,0,2,2,,3374_
3376,2,拉浴簾,N,0,2,2,,3378_
3376,2,刺耳,Vi,0,2,2,,3378_
3376,2,攝像機,N,0,2,2,,3378_
3376,2,中彩,Vi,0,2,2,,3378_
3376,2,逆向,A,0,2,2,,3378_
3379,2,存檔,Vi,0,1,1,,
3379,2,拍照,Vi,0,1,1,,
3380,2,國際台,N,0,1,1,,
3380,2,瞞,Vt,0,1,1,,
3380,2,南樓,N,0,3,3,,3418_3418_
3382,2,豪標房,N,0,1,1,,
3383,2,華天,N,0,2,2,,3384_
3385,2,挨宰,Vi,0,1,1,,
3385,2,赴,Vt,0,3,3,,3392_3394_
3385,2,戴河,N,0,1,1,,
3385,2,必定,ADV,0,1,1,,
3385,2,扶,Vt,0,1,1,,
3385,2,出手,Vi,0,1,1,,
3386,2,進線,N,0,1,1,,
3387,2,學生,N,0,2,2,,3387_
3387,2,價格系,N,0,1,1,,
3387,2,系,N,0,2,2,,3387_
3388,2,語,N,0,1,1,,
3388,2,繞口令,N,0,1,1,,
3388,2,誠實,Vi,0,2,2,,3446_
3388,2,爬上,Vt,0,1,1,,
3388,2,過問,Vt,0,1,1,,
3388,2,噴血不,N,0,1,1,,
3389,2,塞滿,Vt,0,2,2,,3390_
3389,2,遙控板,N,0,2,2,,3390_
3389,2,單間,N,0,10,10,,3389_3389_3389_3389_3390_3390_3390_3390_3390_
3391,2,鼓動,Vt,0,2,2,,3393_
3391,2,漏下水,N,0,2,2,,3393_
3392,2,菲律賓人,N,0,2,2,,3394_
3392,2,法國人,N,0,2,2,,3394_
3392,2,婚宴人,N,0,2,2,,3394_
3392,2,躲過,Vt,0,2,2,,3394_
3392,2,跳來跳去,Vi,0,2,2,,3394_
3392,2,見怪不怪,Vi,0,2,2,,3394_
3392,2,水坑,N,0,2,2,,3394_
3395,2,雜糧,N,0,1,1,,
3395,2,淮安,N,0,1,1,,
3395,2,霉園,N,0,1,1,,
3395,2,五穀,N,0,1,1,,
3397,2,運行,Vi,0,1,1,,
3397,2,路由器,N,0,1,1,,
3397,2,凍醒,Vt,0,1,1,,
3397,2,奶奶,N,0,1,1,,
3397,2,得罪,Vt,0,1,1,,
3397,2,嗆,Vi,0,1,1,,
3397,2,窒息,Vi,0,1,1,,
3397,2,上星,N,0,1,1,,
3397,2,白酒,N,0,1,1,,
3397,2,求籤,Vi,0,1,1,,
3397,2,弱,Vi,0,1,1,,
3397,2,洗滌劑,N,0,1,1,,
3397,2,甘水味,N,0,1,1,,
3397,2,市府,N,0,1,1,,
3397,2,點滴,N,0,1,1,,
3397,2,染上,Vt,0,1,1,,
3397,2,清潔度,N,0,1,1,,
3397,2,酒精味,N,0,1,1,,
3397,2,祖,N,0,1,1,,
3400,2,紅赤胡臉,N,0,1,1,,
3400,2,中年,N,0,1,1,,
3400,2,成天,ADV,0,1,1,,
3402,2,廠房,N,0,2,2,,3407_
3405,2,協程定房,N,0,2,2,,3410_
3405,2,牆體,N,0,2,2,,3410_
3405,2,鐵板,N,0,3,3,,3409_3410_
3405,2,住人,N,0,2,2,,3410_
3405,2,工棚,N,0,2,2,,3410_
3405,2,咚咚,ADV,0,2,2,,3410_
3405,2,粘著,Vt,0,2,2,,3410_
3409,2,館邊,N,0,1,1,,
3409,2,走起來,ADV,0,1,1,,
3409,2,廊橋,N,0,1,1,,
3409,2,鳥,N,0,1,1,,
3409,2,展,Vt,0,1,1,,
3409,2,房間號,N,0,1,1,,
3409,2,台盆希里,N,0,1,1,,
3409,2,配色,Vi,0,1,1,,
3409,2,晃晃悠悠,ADV,0,1,1,,
3409,2,惡,Vi,0,3,3,,3409_3409_
3409,2,介意,Vt,0,1,1,,
3409,2,天線,N,0,1,1,,
3409,2,塗塗,Vi,0,1,1,,
3409,2,補貼,N,0,2,2,,3409_
3409,2,住錦江,N,0,1,1,,
3409,2,嘩啦,ADV,0,1,1,,
3409,2,長霉,N,0,1,1,,
3413,2,除夕,N,0,1,1,,
3413,2,轉房,N,0,1,1,,
3413,2,梳妝台,N,0,1,1,,
3413,2,次住,N,0,1,1,,
3413,2,諾曼,N,0,2,2,,3413_
3413,2,弟,N,0,2,2,,3413_
3413,2,一氣之下,Vi,0,1,1,,
3413,2,提升為,Vt,0,1,1,,
3414,2,計價器,N,0,1,1,,
3414,2,過路費,N,0,1,1,,
3415,2,修補,Vt,0,1,1,,
3415,2,潿洲島,N,0,1,1,,
3415,2,巨型,N,0,1,1,,
3415,2,洗臉台,N,0,1,1,,
3415,2,零時,N,0,1,1,,
3415,2,弄到,Vt,0,1,1,,
3415,2,斑點,N,0,1,1,,
3416,2,人性,N,0,1,1,,
3417,2,冷卻,Vt,0,1,1,,
3417,2,床背,N,0,1,1,,
3417,2,塔,N,0,3,3,,3488_3490_
3417,2,北邊,N,0,1,1,,
3417,2,低下,Vi,0,1,1,,
3417,2,國脈,N,0,1,1,,
3417,2,椅背,N,0,1,1,,
3417,2,煙道,N,0,1,1,,
3417,2,慈溪定,N,0,1,1,,
3418,2,水泡,N,0,1,1,,
3418,2,機頂盒,N,0,1,1,,
3418,2,房門口,N,0,1,1,,
3418,2,爸媽,N,0,1,1,,
3418,2,生病,Vi,0,1,1,,
3418,2,寫出來,Vi,0,1,1,,
3418,2,千萬千萬,ADV,0,1,1,,
3418,2,開關門,N,0,1,1,,
3418,2,皮炎,N,0,1,1,,
3419,2,貴量,N,0,1,1,,
3421,2,賴,Vt,0,1,1,,
3422,2,一單,N,0,1,1,,
3422,2,分別出,Vt,0,1,1,,
3423,2,成年人,N,0,2,2,,3424_
3423,2,游趣全無,Vt,0,2,2,,3424_
3423,2,半價,N,0,2,2,,3424_
3423,2,想來,ADV,0,2,2,,3424_
3423,2,折價,Vt,0,2,2,,3424_
3423,2,高高興興,Vi,0,2,2,,3424_
3423,2,清明,N,0,2,2,,3424_
3425,2,幫,Vt,0,3,3,,3433_3435_
3425,2,吧檯,N,0,1,1,,
3425,2,保險櫃,N,0,1,1,,
3431,2,廳灌,N,0,2,2,,3432_
3431,2,掩蓋,Vt,0,2,2,,3432_
3431,2,房卡用,N,0,2,2,,3432_
3431,2,辟里,N,0,2,2,,3432_
3431,2,一大早,N,0,3,3,,3432_3487_
3431,2,啪啦,ADV,0,2,2,,3432_
3431,2,開發票,N,0,2,2,,3432_
3431,2,採納,Vt,0,3,3,,3432_3487_
3431,2,火花,N,0,2,2,,3432_
3431,2,閉上,Vt,0,2,2,,3432_
3431,2,熬到,Vt,0,2,2,,3432_
3433,2,檢驗,Vt,0,2,2,,3435_
3433,2,闡明,Vt,0,2,2,,3435_
3433,2,好轉,Vi,0,2,2,,3435_
3433,2,述說,Vt,0,2,2,,3435_
3433,2,友人,N,0,2,2,,3435_
3433,2,明知,Vt,0,2,2,,3435_
3433,2,喚回,Vt,0,2,2,,3435_
3433,2,心不甘情不願,Vi,0,2,2,,3435_
3433,2,蒙,Vt,0,2,2,,3435_
3433,2,不下,ADV,0,2,2,,3435_
3433,2,呆立,Vi,0,2,2,,3435_
3433,2,調和,Vi,0,2,2,,3435_
3433,2,抵賴,Vi,0,2,2,,3435_
3433,2,沉澱,Vi,0,2,2,,3435_
3433,2,2號樓,N,0,8,8,,3433_3433_3433_3435_3435_3435_3435_
3433,2,沉澱物,N,0,2,2,,3435_
3433,2,找事,Vi,0,2,2,,3435_
3433,2,工程隊,N,0,2,2,,3435_
3433,2,毛骨悚然,Vi,0,2,2,,3435_
3433,2,打回,Vt,0,2,2,,3435_
3433,2,木板門,N,0,2,2,,3435_
3433,2,百般,ADV,0,2,2,,3435_
3433,2,鼓浪,N,0,4,4,,3433_3435_3435_
3433,2,陰森,Vi,0,2,2,,3435_
3433,2,斷水,Vi,0,2,2,,3435_
3433,2,照本宣科,Vi,0,2,2,,3435_
3433,2,會會,Vt,0,2,2,,3435_
3433,2,言下之意,N,0,2,2,,3435_
3433,2,少不了,Vt,0,2,2,,3435_
3433,2,黃水,N,0,4,4,,3433_3435_3435_
3433,2,事理,N,0,2,2,,3435_
3433,2,利害,N,0,4,4,,3433_3435_3435_
3433,2,三者,N,0,2,2,,3435_
3433,2,質疑,Vt,0,2,2,,3435_
3434,2,小心翼翼,Vi,0,2,2,,3436_
3434,2,浴霸,N,0,2,2,,3436_
3434,2,掃乾淨,Vi,0,2,2,,3436_
3434,2,跑進去,Vt,0,2,2,,3436_
3438,2,京倫,N,0,1,1,,
3443,2,利索,Vi,0,1,1,,
3443,2,惡意,ADV,0,1,1,,
3443,2,奰藿猁滬,N,0,1,1,,
3443,2,散去,Vi,0,1,1,,
3443,2,紅薯,N,0,1,1,,
3443,2,巨川,N,0,4,4,,3443_3443_3443_
3443,2,偎,Vt,0,1,1,,
3443,2,污蔑,Vt,0,1,1,,
3443,2,大型車,N,0,1,1,,
3443,2,清新劑,N,0,2,2,,3443_
3443,2,上訴,Vt,0,1,1,,
3443,2,塘沽,N,0,2,2,,3443_
3443,2,暈菜,N,0,1,1,,
3443,2,腐爛,Vi,0,1,1,,
3443,2,整晚,N,0,1,1,,
3446,2,本質,N,0,1,1,,
3446,2,有情,Vi,0,1,1,,
3446,2,陷害,Vt,0,1,1,,
3446,2,絕然,Vi,0,1,1,,
3446,2,糊糊,Vi,0,1,1,,
3447,2,酷,Vi,0,1,1,,
3447,2,酷酷,Vi,0,1,1,,
3447,2,滿口答應,Vt,0,1,1,,
3447,2,轟隆隆,ADV,0,1,1,,
3448,2,全開,Vi,0,2,2,,3453_
3448,2,放完,Vt,0,2,2,,3453_
3448,2,垮垮,Vi,0,2,2,,3453_
3448,2,預訂單,N,0,2,2,,3453_
3448,2,垂下,Vt,0,2,2,,3453_
3448,2,別扣,N,0,2,2,,3453_
3448,2,閉路,N,0,2,2,,3453_
3448,2,鎖自帶,N,0,2,2,,3453_
3448,2,鬆鬆,Vi,0,2,2,,3453_
3448,2,鉛管,N,0,2,2,,3453_
3448,2,盆浴,N,0,4,4,,3448_3453_3453_
3451,2,怕死,Vi,0,2,2,,3456_
3451,2,加劇,Vt,0,2,2,,3456_
3451,2,提起來,Vi,0,2,2,,3456_
3451,2,鐵絲,N,0,2,2,,3456_
3451,2,歪,Vi,0,2,2,,3456_
3451,2,床架,N,0,2,2,,3456_
3451,2,缺氧,Vi,0,2,2,,3456_
3454,2,升空,Vi,0,1,1,,
3454,2,嫦娥,N,0,1,1,,
3458,2,變質,Vi,0,1,1,,
3458,2,委辦,Vt,0,1,1,,
3458,2,武岳,N,0,4,4,,3458_3458_3458_
3458,2,貴州,N,0,1,1,,
3458,2,想清楚,Vt,0,1,1,,
3458,2,財富,N,0,2,2,,3458_
3458,2,拋離,Vt,0,1,1,,
3458,2,貴州省,N,0,1,1,,
3458,2,綠豆,N,0,1,1,,
3458,2,酒店房,N,0,1,1,,
3459,2,安全性,N,0,1,1,,
3459,2,房奇,N,0,1,1,,
3460,2,列為,Vt,0,1,1,,
3460,2,總總台,N,0,1,1,,
3460,2,匯報,N,0,1,1,,
3460,2,住國,N,0,1,1,,
3462,2,吉,Vi,0,1,1,,
3462,2,誣陷,Vt,0,1,1,,
3462,2,查證,Vt,0,1,1,,
3462,2,搞出,Vt,0,1,1,,
3462,2,慶幸,Vt,0,1,1,,
3462,2,言論,N,0,1,1,,
3463,2,好傢伙,N,0,1,1,,
3463,2,不光,ADV,0,1,1,,
3463,2,住上,Vt,0,1,1,,
3465,2,洗澡盆,N,0,1,1,,
3465,2,電子,N,0,1,1,,
3466,2,一針見血,Vi,0,1,1,,
3466,2,黑屏,N,0,1,1,,
3466,2,維修工,N,0,2,2,,3466_
3466,2,流風,N,0,1,1,,
3466,2,彈,Vt,0,1,1,,
3466,2,和柏,N,0,1,1,,
3466,2,香漁,N,0,1,1,,
3466,2,淹,Vt,0,1,1,,
3466,2,小黑,Vi,0,1,1,,
3466,2,靈武,N,0,1,1,,
3466,2,修復,Vt,0,1,1,,
3466,2,閥門,N,0,1,1,,
3466,2,機還,N,0,1,1,,
3470,2,鋪墊物,N,0,1,1,,
3470,2,傘拉,N,0,1,1,,
3470,2,兼,Vt,0,1,1,,
3470,2,排氣口,N,0,1,1,,
3470,2,近日,N,0,1,1,,
3471,2,從頭到尾,ADV,0,1,1,,
3471,2,拉腸,N,0,1,1,,
3471,2,尤為,ADV,0,1,1,,
3472,2,唱歌,Vi,0,1,1,,
3473,2,溫馨2,N,0,1,1,,
3475,2,吃膩,Vt,0,1,1,,
3475,2,轉轉,Vt,0,1,1,,
3475,2,禁,Vt,0,1,1,,
3475,2,堵死,Vt,0,1,1,,
3476,2,火車聲,N,0,1,1,,
3476,2,臊味,N,0,1,1,,
3477,2,股長,N,0,1,1,,
3478,2,海德,N,0,1,1,,
3479,2,相國,N,0,2,2,,3481_
3479,2,寺近,N,0,2,2,,3481_
3480,2,狂吠,Vi,0,2,2,,3482_
3480,2,爬層高,Vi,0,2,2,,3482_
3480,2,濃郁,Vi,0,2,2,,3482_
3480,2,大相國寺,N,0,2,2,,3482_
3483,2,座機,N,0,1,1,,
3483,2,鍵通,N,0,1,1,,
3484,2,上方,N,0,1,1,,
3484,2,照到,Vt,0,1,1,,
3487,2,低頻,N,0,1,1,,
3487,2,刮,Vt,0,1,1,,
3487,2,燈箱,N,0,1,1,,
3487,2,電流,N,0,1,1,,
3487,2,兌獎處,N,0,1,1,,
3488,2,石油,N,0,2,2,,3490_
3488,2,門可羅雀,Vi,0,2,2,,3490_
3488,2,管理局,N,0,2,2,,3490_
3488,2,煩瑣,Vi,0,2,2,,3490_
3488,2,喀什,N,0,8,8,,3488_3488_3489_3490_3490_3490_3491_
3488,2,猜,Vt,0,2,2,,3490_
3488,2,漢人區,N,0,2,2,,3490_
3489,2,相仿,Vi,0,2,2,,3491_
3489,2,高出,Vt,0,2,2,,3491_
3489,2,西亞,N,0,2,2,,3491_
3493,2,夜深人靜,Vi,0,1,1,,
3493,2,心事,N,0,1,1,,
3493,2,滾滾,Vi,0,1,1,,
3493,2,陝西,N,0,1,1,,
3495,2,輩,N,0,2,2,,3497_
3495,2,順手牽羊,Vi,0,2,2,,3497_
3495,2,巾,N,0,2,2,,3497_
3495,2,無德,N,0,2,2,,3497_
3495,2,外包,Vt,0,2,2,,3497_
